Term,pmi,freq_pos,freq_neg,VAD original,VAD extended,valence,arousal,dominance,frequency
abracadabra,4.6,477,6,1,1,0.673,0.632,0.434,483
lodge,4.057,3134,78,1,1,0.656,0.356,0.474,3212
inadmissible,4.02,152,3,1,1,0.188,0.636,0.389,155
swinger,3.804,153,4,1,1,0.459,0.778,0.482,157
incidental,3.71,532,18,1,1,0.281,0.61,0.404,550
porno,3.672,2078,76,1,1,0.302,0.923,0.519,2154
sergeant,3.519,879,37,1,1,0.408,0.6,0.833,916
flatbed,3.372,39,1,1,1,0.49,0.25,0.38,40
furrow,3.354,333,16,1,1,0.408,0.42,0.345,349
hitchhiker,3.306,261,13,1,1,0.594,0.626,0.603,274
austere,3.235,156,8,1,1,0.5,0.39,0.422,164
allowance,3.226,2988,172,1,1,0.673,0.382,0.591,3160
plume,3.124,77,4,1,1,0.469,0.323,0.375,81
nigger,3.055,1091,74,1,1,0.24,0.347,0.398,1165
honeysuckle,3.05,28,1,1,1,0.597,0.451,0.517,29
unauthorized,3.038,314,21,1,1,0.26,0.448,0.259,335
steeple,3.015,41,2,1,1,0.625,0.519,0.5,43
sparrow,3.004,968,69,1,1,0.583,0.46,0.327,1037
woodpecker,2.999,123,8,1,1,0.52,0.482,0.445,131
contentious,2.969,520,38,1,1,0.422,0.573,0.637,558
coed,2.912,100,7,1,1,0.469,0.531,0.481,107
whale,2.862,4694,390,1,1,0.582,0.398,0.509,5084
thunderbolt,2.833,69,5,1,1,0.418,0.719,0.642,74
castaway,2.819,632,54,1,1,0.208,0.646,0.422,686
disused,2.743,31,2,1,1,0.25,0.302,0.186,33
gaiety,2.743,31,2,1,1,0.854,0.759,0.72,33
pantyhose,2.662,117,11,1,1,0.57,0.539,0.25,128
ferment,2.645,28,2,1,1,0.375,0.531,0.418,30
revolver,2.57,295,32,1,1,0.194,0.796,0.75,327
painstaking,2.556,114,12,1,1,0.396,0.335,0.386,126
recline,2.516,101,11,1,1,0.46,0.404,0.418,112
neutron,2.513,160,18,1,1,0.469,0.44,0.679,178
hourglass,2.512,126,14,1,1,0.542,0.284,0.492,140
tackling,2.505,1301,154,1,1,0.48,0.694,0.613,1455
storehouse,2.487,32,3,1,1,0.57,0.25,0.491,35
spleen,2.478,89,10,1,1,0.448,0.255,0.396,99
petunia,2.456,111,13,1,1,0.583,0.26,0.356,124
plaintive,2.43,38,4,1,1,0.292,0.529,0.306,42
cleanliness,2.426,589,75,1,1,0.816,0.363,0.609,664
supermodel,2.4,120,15,1,1,0.88,0.663,0.698,135
rapture,2.385,677,90,1,1,0.439,0.883,0.567,767
hooky,2.384,66,8,1,1,0.468,0.5,0.452,74
growl,2.383,810,108,1,1,0.194,0.764,0.482,918
richness,2.344,228,31,1,1,0.896,0.833,0.922,259
moonlight,2.337,3197,449,1,1,0.865,0.264,0.409,3646
obesity,2.322,720,102,1,1,0.215,0.37,0.328,822
crouch,2.314,117,16,1,1,0.281,0.606,0.312,133
cowboy,2.29,1625,239,1,1,0.594,0.625,0.695,1864
electron,2.286,26,3,1,1,0.52,0.455,0.56,29
corduroy,2.273,39,5,1,1,0.57,0.324,0.357,44
breakable,2.271,112,16,1,1,0.194,0.667,0.408,128
outpost,2.271,112,16,1,1,0.635,0.571,0.675,128
aristocrat,2.263,32,4,1,1,0.583,0.413,0.811,36
supernova,2.259,137,20,1,1,0.729,0.673,0.827,157
midland,2.257,117,17,1,1,0.521,0.402,0.456,134
avenue,2.248,1331,204,1,1,0.677,0.36,0.377,1535
horny,2.241,14621,2264,1,1,0.49,0.908,0.56,16885
sweetener,2.237,732,113,1,1,0.67,0.333,0.33,845
zeppelin,2.227,260,40,1,1,0.542,0.55,0.472,300
climber,2.222,37,5,1,1,0.573,0.716,0.735,42
squirt,2.208,205,32,1,1,0.406,0.46,0.255,237
tambourine,2.201,30,4,1,1,0.622,0.548,0.348,34
amateur,2.201,619,99,1,1,0.469,0.5,0.409,718
shire,2.199,98,15,1,1,0.479,0.257,0.609,113
pretender,2.196,215,34,1,1,0.5,0.683,0.574,249
goblin,2.195,1096,177,1,1,0.333,0.542,0.377,1273
idleness,2.182,72,11,1,1,0.308,0.33,0.228,83
twain,2.179,272,44,1,1,0.541,0.255,0.37,316
boredom,2.17,4387,729,1,1,0.167,0.139,0.255,5116
turnaround,2.168,173,28,1,1,0.56,0.654,0.407,201
clod,2.168,29,4,1,1,0.375,0.404,0.365,33
vacancy,2.145,251,42,1,1,0.643,0.311,0.418,293
carnation,2.144,81,13,1,1,0.653,0.357,0.431,94
ploughed,2.144,40,6,1,1,0.438,0.42,0.431,46
tun,2.136,336,57,1,1,0.386,0.413,0.364,393
wistful,2.132,161,27,1,1,0.323,0.451,0.312,188
indemnity,2.13,51,8,1,1,0.47,0.607,0.692,59
wino,2.126,22,3,1,1,0.406,0.535,0.349,25
pepper,2.123,4411,768,1,1,0.4,0.539,0.328,5179
sedentary,2.117,56,9,1,1,0.292,0.185,0.273,65
racetrack,2.104,44,7,1,1,0.708,0.808,0.624,51
unbroken,2.095,211,37,1,1,0.55,0.224,0.602,248
housewife,2.088,719,129,1,1,0.656,0.361,0.449,848
halt,2.084,611,110,1,1,0.167,0.36,0.432,721
nude,2.083,2291,415,1,1,0.49,0.915,0.2,2706
guidebook,2.075,81,14,1,1,0.677,0.26,0.427,95
tumbleweed,2.075,81,14,1,1,0.312,0.471,0.427,95
interlude,2.055,267,49,1,1,0.47,0.417,0.377,316
stave,2.055,315,58,1,1,0.417,0.333,0.424,373
bloodstream,2.05,31,5,1,1,0.552,0.53,0.528,36
untitled,2.032,177,33,1,1,0.213,0.24,0.24,210
island,2.026,27541,5291,1,1,0.745,0.347,0.432,32832
reverie,2.025,77,14,1,1,0.667,0.413,0.471,91
lovesick,2.016,133,25,1,1,0.796,0.842,0.5,158
barnyard,2.014,71,13,1,1,0.51,0.353,0.336,84
dweller,2.013,112,21,1,1,0.615,0.304,0.5,133
downpour,2.006,300,58,1,1,0.328,0.602,0.481,358
disconnection,2.004,335,65,1,1,0.167,0.283,0.277,400
arouse,2.004,55,10,1,1,0.74,0.491,0.58,65
painter,1.994,256,50,1,1,0.677,0.366,0.487,306
undefined,1.993,135,26,1,1,0.26,0.418,0.35,161
gigolo,1.986,44,8,1,1,0.4,0.706,0.528,52
aeroplane,1.986,94,18,1,1,0.714,0.642,0.644,112
cohesion,1.986,109,21,1,1,0.604,0.536,0.555,130
relevancy,1.986,44,8,1,1,0.724,0.481,0.673,52
bash,1.984,1537,307,1,1,0.385,0.546,0.463,1844
widower,1.97,373,75,1,1,0.184,0.406,0.325,448
enchanting,1.966,146,29,1,1,0.917,0.681,0.708,175
bored,1.961,53039,10873,1,1,0.153,0.167,0.196,63912
sugar,1.96,6921,1419,1,1,0.896,0.382,0.402,8340
honeymoon,1.96,1139,233,1,1,0.979,0.678,0.526,1372
gossip,1.956,1824,375,1,1,0.173,0.765,0.245,2199
quartet,1.952,57,11,1,1,0.479,0.377,0.472,68
shears,1.94,42,8,1,1,0.429,0.527,0.254,50
mournful,1.94,85,17,1,1,0.18,0.441,0.188,102
hardcore,1.934,2045,430,1,1,0.25,0.721,0.585,2475
gilded,1.927,65,13,1,1,0.719,0.471,0.455,78
runner,1.924,996,211,1,1,0.459,0.747,0.632,1207
fisherman,1.922,135,28,1,1,0.656,0.461,0.546,163
greedy,1.921,2370,505,1,1,0.125,0.66,0.476,2875
throb,1.917,41,8,1,1,0.5,0.673,0.556,49
abbey,1.917,419,89,1,1,0.58,0.367,0.444,508
thankless,1.908,184,39,1,1,0.146,0.5,0.497,223
foreword,1.906,59,12,1,1,0.59,0.314,0.551,71
nightingale,1.906,119,25,1,1,0.74,0.34,0.496,144
commissary,1.902,22,4,1,1,0.385,0.5,0.788,26
blackbird,1.902,91,19,1,1,0.52,0.34,0.405,110
moor,1.896,95,20,1,1,0.311,0.464,0.378,115
ballroom,1.892,254,55,1,1,0.847,0.635,0.448,309
ebony,1.888,330,72,1,1,0.49,0.317,0.4,402
troll,1.887,3633,801,1,1,0.378,0.627,0.327,4434
dazed,1.878,210,46,1,1,0.3,0.697,0.277,256
vineyard,1.878,183,40,1,1,0.806,0.382,0.595,223
saxophone,1.876,102,22,1,1,0.688,0.444,0.482,124
contaminate,1.868,39,8,1,1,0.14,0.611,0.426,47
caprice,1.858,21,4,1,1,0.333,0.64,0.43,25
gentry,1.858,21,4,1,1,0.56,0.48,0.625,25
maiden,1.857,298,67,1,1,0.755,0.396,0.461,365
erotic,1.854,433,98,1,1,0.625,0.946,0.683,531
watchtower,1.852,34,7,1,1,0.5,0.415,0.647,41
catapult,1.852,34,7,1,1,0.48,0.83,0.649,41
forlorn,1.847,282,64,1,1,0.316,0.571,0.217,346
band,1.844,10997,2534,1,1,0.648,0.552,0.525,13531
turtleneck,1.843,90,20,1,1,0.583,0.398,0.327,110
honky,1.835,42,9,1,1,0.458,0.632,0.425,51
trucker,1.834,115,26,1,1,0.494,0.609,0.5,141
cure,1.83,8538,1994,1,1,0.719,0.377,0.623,10532
astonishing,1.829,704,164,1,1,0.844,0.802,0.821,868
monsoon,1.827,63,14,1,1,0.358,0.6,0.481,77
roar,1.827,724,169,1,1,0.427,0.816,0.675,893
mister,1.826,1393,326,1,1,0.604,0.406,0.663,1719
hunger,1.821,2328,548,1,1,0.083,0.554,0.328,2876
cougar,1.82,215,50,1,1,0.438,0.588,0.538,265
shifty,1.817,151,35,1,1,0.365,0.687,0.483,186
synthetic,1.814,138,32,1,1,0.396,0.35,0.519,170
gleam,1.811,83,19,1,1,0.781,0.52,0.741,102
thug,1.81,1655,394,1,1,0.24,0.882,0.667,2049
flexin,1.809,87,20,1,1,0.552,0.559,0.366,107
neon,1.807,1107,264,1,1,0.594,0.48,0.38,1371
reprise,1.802,153,36,1,1,0.459,0.5,0.464,189
evermore,1.799,111,26,1,1,0.677,0.45,0.403,137
wanderer,1.798,256,61,1,1,0.458,0.519,0.396,317
stockings,1.784,142,34,1,1,0.458,0.365,0.382,176
catfish,1.784,432,105,1,1,0.458,0.337,0.296,537
heiress,1.783,48,11,1,1,0.827,0.571,0.676,59
gape,1.78,113,27,1,1,0.493,0.651,0.287,140
velvet,1.78,1163,285,1,1,0.663,0.226,0.304,1448
epidemic,1.779,1817,446,1,1,0.092,0.83,0.611,2263
tackle,1.779,1878,461,1,1,0.365,0.686,0.569,2339
overreact,1.778,190,46,1,1,0.306,0.912,0.471,236
lesbian,1.777,5431,1337,1,1,0.385,0.66,0.415,6768
hertz,1.77,128,31,1,1,0.396,0.417,0.506,159
bulletproof,1.769,168,41,1,1,0.75,0.721,0.779,209
confess,1.767,3292,819,1,1,0.36,0.712,0.431,4111
choosy,1.763,251,62,1,1,0.28,0.76,0.712,313
downhearted,1.763,47,11,1,1,0.119,0.461,0.255,58
verve,1.763,31,7,1,1,0.724,0.84,0.693,38
rendezvous,1.763,75,18,1,1,0.75,0.49,0.658,93
etching,1.763,23,5,1,1,0.567,0.491,0.575,28
plaything,1.763,43,10,1,1,0.708,0.602,0.277,53
wintertime,1.763,23,5,1,1,0.76,0.516,0.404,28
noir,1.763,327,81,1,1,0.375,0.394,0.365,408
anal,1.759,577,144,1,1,0.333,0.798,0.334,721
submarine,1.756,146,36,1,1,0.572,0.481,0.549,182
parched,1.749,74,18,1,1,0.25,0.235,0.255,92
playmate,1.747,125,31,1,1,0.878,0.509,0.398,156
lethargic,1.746,239,60,1,1,0.214,0.245,0.375,299
runes,1.745,54,13,1,1,0.438,0.3,0.304,67
owner,1.744,4600,1171,1,1,0.776,0.449,0.92,5771
tiredness,1.738,487,124,1,1,0.387,0.408,0.242,611
voyeur,1.737,38,9,1,1,0.479,0.615,0.466,47
loveliness,1.733,100,25,1,1,0.959,0.509,0.75,125
snowman,1.733,197,50,1,1,0.776,0.291,0.323,247
crippling,1.732,4877,1257,1,1,0.156,0.598,0.391,6134
dignify,1.731,30,7,1,1,0.854,0.588,0.735,37
pelican,1.731,30,7,1,1,0.573,0.391,0.38,37
impersonate,1.731,30,7,1,1,0.51,0.632,0.591,37
popper,1.728,111,28,1,1,0.42,0.509,0.411,139
astronaut,1.727,331,85,1,1,0.792,0.601,0.761,416
mitten,1.726,26,6,1,1,0.531,0.33,0.408,32
habitation,1.726,26,6,1,1,0.781,0.231,0.538,32
weekly,1.726,3515,911,1,1,0.622,0.288,0.38,4426
testicle,1.723,49,12,1,1,0.458,0.651,0.41,61
weightless,1.723,49,12,1,1,0.46,0.426,0.375,61
alluring,1.722,168,43,1,1,0.837,0.745,0.843,211
ransom,1.719,202,52,1,1,0.582,0.8,0.565,254
combat,1.717,2667,697,1,1,0.302,0.846,0.833,3364
starved,1.715,1014,265,1,1,0.097,0.689,0.219,1279
aphrodisiac,1.708,52,13,1,1,0.75,0.846,0.667,65
autobiographical,1.708,52,13,1,1,0.909,0.462,0.582,65
emptiness,1.707,7007,1851,1,1,0.177,0.173,0.184,8858
jukebox,1.693,137,36,1,1,0.699,0.54,0.429,173
spinster,1.692,517,138,1,1,0.357,0.368,0.345,655
uneventful,1.691,133,35,1,1,0.51,0.343,0.41,168
payphone,1.689,25,6,1,1,0.469,0.36,0.37,31
cooling,1.688,281,75,1,1,0.469,0.324,0.392,356
hearts,1.687,19898,5362,1,1,0.948,0.592,0.634,25260
beak,1.683,84,22,1,1,0.375,0.363,0.411,106
cashmere,1.681,58,15,1,1,0.653,0.452,0.439,73
squire,1.68,69,18,1,1,0.479,0.459,0.71,87
porn,1.677,6845,1864,1,1,0.344,0.915,0.421,8709
alleviate,1.677,667,181,1,1,0.869,0.27,0.528,848
redhead,1.676,410,111,1,1,0.677,0.549,0.518,521
winch,1.676,21,5,1,1,0.385,0.434,0.449,26
disengagement,1.676,21,5,1,1,0.327,0.373,0.395,26
timeless,1.674,515,140,1,1,0.408,0.468,0.583,655
spotted,1.673,1052,287,1,1,0.354,0.472,0.295,1339
alienation,1.661,830,229,1,1,0.378,0.53,0.462,1059
tasting,1.653,465,129,1,1,0.781,0.603,0.6,594
disaffected,1.651,67,18,1,1,0.176,0.41,0.291,85
surfer,1.651,92,25,1,1,0.704,0.701,0.554,117
immaterial,1.649,24,6,1,1,0.296,0.309,0.295,30
revere,1.649,49,13,1,1,0.75,0.562,0.608,62
pedestal,1.648,395,110,1,1,0.735,0.284,0.579,505
seagull,1.648,81,22,1,1,0.635,0.245,0.314,103
sunbeam,1.645,31,8,1,1,0.729,0.44,0.505,39
dot,1.639,1473,416,1,1,0.434,0.29,0.391,1889
phony,1.639,1052,297,1,1,0.115,0.592,0.202,1349
ennui,1.639,105,29,1,1,0.406,0.461,0.316,134
erotica,1.637,126,35,1,1,0.781,0.87,0.579,161
ode,1.634,372,105,1,1,0.604,0.269,0.519,477
ledger,1.634,108,30,1,1,0.51,0.362,0.609,138
bitterness,1.632,1221,347,1,1,0.115,0.633,0.27,1568
cookery,1.629,27,7,1,1,0.633,0.368,0.345,34
pothole,1.629,55,15,1,1,0.344,0.294,0.283,70
blowfish,1.629,20,5,1,1,0.344,0.42,0.389,25
scarecrow,1.629,104,29,1,1,0.219,0.274,0.349,133
trawl,1.629,20,5,1,1,0.255,0.59,0.464,25
blackjack,1.629,34,9,1,1,0.419,0.679,0.452,43
friendless,1.629,2308,659,1,1,0.102,0.36,0.204,2967
hookup,1.627,446,127,1,1,0.625,0.529,0.683,573
hag,1.626,669,191,1,1,0.188,0.695,0.411,860
junction,1.621,176,50,1,1,0.49,0.481,0.364,226
cavern,1.621,58,16,1,1,0.323,0.36,0.365,74
desolation,1.62,318,91,1,1,0.073,0.481,0.273,409
wrinkled,1.619,148,42,1,1,0.271,0.402,0.2,190
orgy,1.619,245,70,1,1,0.346,0.962,0.536,315
drake,1.615,1624,470,1,1,0.467,0.411,0.452,2094
antidote,1.615,344,99,1,1,0.541,0.49,0.629,443
simile,1.613,30,8,1,1,0.615,0.363,0.464,38
dispossessed,1.613,30,8,1,1,0.354,0.577,0.331,38
greasy,1.611,336,97,1,1,0.399,0.442,0.294,433
statuette,1.608,23,6,1,1,0.677,0.433,0.518,29
lethargy,1.606,129,37,1,1,0.194,0.302,0.316,166
club,1.606,18600,5438,1,1,0.646,0.618,0.393,24038
intoxication,1.605,40,11,1,1,0.323,0.71,0.4,51
sparse,1.602,91,26,1,1,0.24,0.367,0.209,117
reaper,1.6,390,114,1,1,0.34,0.565,0.464,504
kazoo,1.6,33,9,1,1,0.503,0.462,0.411,42
rink,1.594,168,49,1,1,0.551,0.392,0.392,217
unhappiness,1.594,729,215,1,1,0.083,0.63,0.222,944
quench,1.594,97,28,1,1,0.385,0.344,0.333,125
stairway,1.594,97,28,1,1,0.562,0.51,0.407,125
heifer,1.593,26,7,1,1,0.439,0.443,0.321,33
obscenity,1.589,36,10,1,1,0.083,0.843,0.418,46
churchyard,1.589,36,10,1,1,0.296,0.444,0.347,46
wintry,1.589,36,10,1,1,0.448,0.434,0.445,46
beluga,1.587,46,13,1,1,0.51,0.333,0.482,59
prostitution,1.587,160,47,1,1,0.125,0.843,0.475,207
bitter,1.584,11088,3315,1,1,0.218,0.627,0.411,14403
hyphen,1.58,29,8,1,1,0.552,0.356,0.381,37
longing,1.576,3141,946,1,1,0.604,0.434,0.56,4087
lusty,1.574,52,15,1,1,0.469,0.941,0.673,67
enslave,1.574,148,44,1,1,0.073,0.8,0.481,192
foolproof,1.568,55,16,1,1,0.479,0.484,0.5,71
heartbreaker,1.568,190,57,1,1,0.265,0.685,0.58,247
azure,1.566,114,34,1,1,0.62,0.256,0.339,148
bonsai,1.562,35,10,1,1,0.714,0.235,0.375,45
desperate,1.56,13635,4172,1,1,0.083,0.842,0.337,17807
fits,1.56,3024,925,1,1,0.571,0.363,0.58,3949
grove,1.56,195,59,1,1,0.604,0.245,0.417,254
traces,1.56,244,74,1,1,0.482,0.448,0.389,318
untrue,1.558,693,212,1,1,0.031,0.5,0.188,905
playboy,1.557,240,73,1,1,0.646,0.9,0.519,313
plankton,1.555,25,7,1,1,0.552,0.321,0.371,32
potato,1.553,2199,677,1,1,0.541,0.235,0.265,2876
spoil,1.549,2835,877,1,1,0.146,0.723,0.328,3712
oak,1.548,296,91,1,1,0.583,0.245,0.536,387
adieu,1.546,28,8,1,1,0.25,0.471,0.342,36
armory,1.546,28,8,1,1,0.448,0.663,0.8,36
chipmunk,1.543,60,18,1,1,0.573,0.562,0.409,78
tulip,1.539,47,14,1,1,0.73,0.189,0.356,61
sonata,1.539,31,9,1,1,0.643,0.406,0.425,40
gimp,1.539,47,14,1,1,0.469,0.442,0.342,61
befriend,1.536,1762,552,1,1,0.93,0.624,0.471,2314
boner,1.53,354,111,1,1,0.344,0.612,0.393,465
dashboard,1.529,151,47,1,1,0.51,0.371,0.595,198
walrus,1.529,56,17,1,1,0.521,0.327,0.361,73
priory,1.525,40,12,1,1,0.561,0.413,0.629,52
vandal,1.525,40,12,1,1,0.135,0.792,0.473,52
leprosy,1.524,62,19,1,1,0.13,0.67,0.349,81
boyhood,1.521,21,6,1,1,0.729,0.745,0.5,27
backwoods,1.52,112,35,1,1,0.541,0.35,0.482,147
nonce,1.519,137,43,1,1,0.422,0.37,0.377,180
cloud,1.516,3292,1052,1,1,0.74,0.133,0.342,4344
chimpanzee,1.516,24,7,1,1,0.5,0.633,0.387,31
melancholic,1.514,439,140,1,1,0.181,0.306,0.277,579
graze,1.514,77,24,1,1,0.56,0.255,0.371,101
serenade,1.513,161,51,1,1,0.875,0.57,0.491,212
percussion,1.511,27,8,1,1,0.622,0.635,0.642,35
desertion,1.511,27,8,1,1,0.122,0.63,0.289,35
shroud,1.511,223,71,1,1,0.417,0.457,0.389,294
playa,1.51,260,83,1,1,0.724,0.51,0.575,343
revue,1.508,30,9,1,1,0.594,0.35,0.42,39
fronting,1.505,203,65,1,1,0.5,0.48,0.509,268
gratis,1.505,33,10,1,1,0.796,0.51,0.417,43
isolation,1.503,13357,4330,1,1,0.198,0.338,0.339,17687
remedy,1.501,1175,381,1,1,0.625,0.283,0.491,1556
gravitational,1.5,39,12,1,1,0.528,0.51,0.691,51
magician,1.499,168,54,1,1,0.714,0.657,0.551,222
gothic,1.493,167,54,1,1,0.197,0.333,0.475,221
desolate,1.492,728,238,1,1,0.104,0.32,0.228,966
masturbation,1.49,669,219,1,1,0.542,0.961,0.509,888
cowgirl,1.488,75,24,1,1,0.541,0.566,0.554,99
entrepreneur,1.487,488,160,1,1,0.885,0.704,0.92,648
desperation,1.485,1960,646,1,1,0.125,0.904,0.419,2606
stallion,1.485,99,32,1,1,0.628,0.596,0.779,131
unfulfilled,1.483,649,214,1,1,0.184,0.426,0.268,863
seventeen,1.48,1437,476,1,1,0.585,0.296,0.321,1913
hungry,1.479,10165,3375,1,1,0.083,0.69,0.254,13540
road,1.478,26246,8718,1,1,0.656,0.404,0.404,34964
genie,1.478,309,102,1,1,0.76,0.6,0.908,411
brokenhearted,1.475,413,137,1,1,0.13,0.598,0.227,550
starship,1.475,110,36,1,1,0.74,0.719,0.704,146
ballad,1.475,527,175,1,1,0.792,0.284,0.424,702
imperfect,1.475,887,295,1,1,0.173,0.527,0.202,1182
amino,1.475,68,22,1,1,0.551,0.402,0.433,90
stately,1.475,20,6,1,1,0.83,0.728,0.915,26
drudgery,1.475,32,10,1,1,0.094,0.522,0.241,42
afflict,1.475,35,11,1,1,0.302,0.555,0.293,46
fiver,1.475,32,10,1,1,0.458,0.469,0.517,42
bleu,1.475,32,10,1,1,0.46,0.354,0.379,42
masochism,1.475,44,14,1,1,0.194,0.845,0.483,58
bookish,1.475,47,15,1,1,0.604,0.236,0.43,62
poverty,1.473,2746,916,1,1,0.071,0.519,0.183,3662
exile,1.471,483,161,1,1,0.184,0.63,0.483,644
assuage,1.464,94,31,1,1,0.745,0.255,0.5,125
hilltop,1.463,85,28,1,1,0.688,0.643,0.787,113
sleepless,1.462,1592,537,1,1,0.213,0.41,0.207,2129
wanker,1.458,238,80,1,1,0.29,0.569,0.446,318
impotence,1.458,58,19,1,1,0.198,0.689,0.224,77
teen,1.457,4753,1612,1,1,0.729,0.531,0.568,6365
mistletoe,1.457,164,55,1,1,0.542,0.47,0.324,219
dreadfully,1.457,108,36,1,1,0.246,0.806,0.306,144
pensive,1.456,105,35,1,1,0.54,0.22,0.529,140
fugitive,1.456,52,17,1,1,0.104,0.922,0.388,69
com,1.455,2142,728,1,1,0.396,0.382,0.382,2870
unrequited,1.454,381,129,1,1,0.143,0.441,0.179,510
diver,1.452,43,14,1,1,0.594,0.52,0.564,57
impassioned,1.452,43,14,1,1,0.74,0.78,0.802,57
chateau,1.452,43,14,1,1,0.615,0.464,0.702,57
crane,1.452,128,43,1,1,0.396,0.417,0.589,171
gammon,1.451,81,27,1,1,0.51,0.418,0.442,108
gaping,1.45,198,67,1,1,0.408,0.668,0.242,265
flowering,1.449,37,12,1,1,0.906,0.627,0.5,49
oriental,1.447,34,11,1,1,0.592,0.409,0.598,45
campfire,1.446,206,70,1,1,0.677,0.509,0.436,276
bluegrass,1.444,31,10,1,1,0.573,0.441,0.395,41
adjective,1.443,124,42,1,1,0.57,0.316,0.569,166
dusty,1.442,725,249,1,1,0.406,0.294,0.255,974
killing,1.442,13338,4594,1,1,0.08,0.959,0.696,17932
wintery,1.441,28,9,1,1,0.388,0.512,0.463,37
crayon,1.44,83,28,1,1,0.604,0.26,0.185,111
raincoat,1.437,25,8,1,1,0.458,0.3,0.525,33
arsenic,1.437,25,8,1,1,0.281,0.472,0.447,33
laden,1.433,140,48,1,1,0.392,0.478,0.554,188
rebellious,1.433,232,80,1,1,0.344,0.88,0.663,312
gull,1.432,45,15,1,1,0.594,0.317,0.378,60
anagram,1.432,22,7,1,1,0.552,0.327,0.449,29
parson,1.432,22,7,1,1,0.583,0.25,0.615,29
gust,1.429,85,29,1,1,0.49,0.755,0.556,114
cuddle,1.427,10016,3501,1,1,0.885,0.559,0.475,13517
dollhouse,1.426,19,6,1,1,0.643,0.245,0.363,25
bogey,1.426,19,6,1,1,0.38,0.519,0.368,25
coiled,1.426,39,13,1,1,0.378,0.518,0.389,52
shopkeeper,1.426,19,6,1,1,0.677,0.51,0.73,25
oasis,1.425,290,101,1,1,0.796,0.283,0.429,391
romanticism,1.424,56,19,1,1,0.854,0.521,0.593,75
tumult,1.422,36,12,1,1,0.271,0.64,0.636,48
wreak,1.422,73,25,1,1,0.375,0.622,0.498,98
bowler,1.422,36,12,1,1,0.552,0.633,0.481,48
pathos,1.421,53,18,1,1,0.35,0.449,0.462,71
pothead,1.418,33,11,1,1,0.378,0.51,0.375,44
hopelessness,1.417,1197,422,1,1,0.052,0.402,0.223,1619
homely,1.415,194,68,1,1,0.745,0.157,0.399,262
cuff,1.414,589,208,1,1,0.469,0.453,0.387,797
spaceman,1.412,30,10,1,1,0.688,0.577,0.848,40
succubus,1.412,92,32,1,1,0.417,0.647,0.509,124
marooned,1.41,44,15,1,1,0.229,0.48,0.16,59
enlarged,1.406,41,14,1,1,0.673,0.49,0.518,55
weariness,1.406,97,34,1,1,0.104,0.333,0.226,131
porky,1.406,41,14,1,1,0.234,0.483,0.333,55
jackal,1.402,52,18,1,1,0.333,0.582,0.436,70
shipwreck,1.401,38,13,1,1,0.268,0.768,0.373,51
tramp,1.401,155,55,1,1,0.108,0.51,0.182,210
titty,1.401,297,106,1,1,0.561,0.548,0.294,403
backdrop,1.399,88,31,1,1,0.32,0.309,0.444,119
harbinger,1.398,24,8,1,1,0.49,0.389,0.692,32
teens,1.398,3268,1176,1,1,0.653,0.66,0.44,4444
inhabiting,1.395,35,12,1,1,0.458,0.44,0.598,47
roadhouse,1.395,35,12,1,1,0.5,0.62,0.458,47
sneer,1.394,82,29,1,1,0.133,0.755,0.345,111
drifter,1.393,140,50,1,1,0.449,0.512,0.391,190
nymph,1.393,46,16,1,1,0.542,0.529,0.472,62
absorption,1.392,57,20,1,1,0.609,0.422,0.446,77
barren,1.392,496,179,1,1,0.173,0.373,0.221,675
pianist,1.392,68,24,1,1,0.806,0.491,0.573,92
top,1.389,29662,10779,1,1,0.76,0.4,0.554,40441
highway,1.388,1592,578,1,1,0.64,0.583,0.425,2170
synapse,1.388,21,7,1,1,0.66,0.471,0.491,28
gopher,1.388,21,7,1,1,0.449,0.44,0.421,28
picturesque,1.388,43,15,1,1,0.802,0.491,0.483,58
thirsty,1.386,1753,638,1,1,0.281,0.66,0.31,2391
spur,1.385,147,53,1,1,0.378,0.545,0.34,200
sock,1.382,748,273,1,1,0.5,0.167,0.29,1021
drunkard,1.382,40,14,1,1,0.24,0.873,0.25,54
alligator,1.381,100,36,1,1,0.354,0.704,0.645,136
dugout,1.38,29,10,1,1,0.49,0.37,0.463,39
playwright,1.38,29,10,1,1,0.672,0.55,0.667,39
hobbit,1.378,176,64,1,1,0.479,0.489,0.472,240
pornography,1.377,173,63,1,1,0.323,0.921,0.481,236
blooming,1.376,317,116,1,1,0.86,0.452,0.593,433
distrust,1.375,496,182,1,1,0.06,0.67,0.276,678
autumn,1.375,952,350,1,1,0.765,0.204,0.45,1302
solitaire,1.375,227,83,1,1,0.365,0.227,0.279,310
inactivity,1.373,83,30,1,1,0.135,0.143,0.227,113
llama,1.37,153,56,1,1,0.49,0.59,0.519,209
spunky,1.37,26,9,1,1,0.646,0.879,0.755,35
yonder,1.37,53,19,1,1,0.615,0.33,0.318,72
passivity,1.37,26,9,1,1,0.241,0.115,0.246,35
hypnotize,1.37,53,19,1,1,0.469,0.507,0.508,72
crushing,1.369,3016,1117,1,1,0.219,0.755,0.411,4133
flop,1.367,942,349,1,1,0.081,0.642,0.196,1291
fiend,1.367,131,48,1,1,0.146,0.903,0.608,179
cavalier,1.367,69,25,1,1,0.735,0.462,0.713,94
stillness,1.366,505,187,1,1,0.729,0.125,0.339,692
clap,1.365,1045,388,1,1,0.779,0.731,0.529,1433
melancholy,1.365,1160,431,1,1,0.188,0.26,0.237,1591
dildo,1.364,485,180,1,1,0.536,0.587,0.491,665
crusader,1.364,50,18,1,1,0.439,0.588,0.548,68
aimless,1.362,133,49,1,1,0.15,0.267,0.183,182
hunter,1.361,2435,909,1,1,0.292,0.817,0.817,3344
tower,1.359,1476,552,1,1,0.606,0.38,0.644,2028
ivory,1.357,199,74,1,1,0.625,0.235,0.566,273
roomy,1.357,47,17,1,1,0.76,0.342,0.736,64
divorcee,1.357,79,29,1,1,0.153,0.61,0.481,108
weatherman,1.357,23,8,1,1,0.66,0.413,0.643,31
beggar,1.357,103,38,1,1,0.24,0.402,0.116,141
sax,1.354,100,37,1,1,0.573,0.465,0.409,137
feat,1.352,1846,695,1,1,0.75,0.706,0.849,2541
bop,1.35,1559,588,1,1,0.429,0.49,0.426,2147
woo,1.347,1311,496,1,1,0.646,0.729,0.43,1807
skyscraper,1.347,94,35,1,1,0.622,0.696,0.798,129
lml,1.346,57,21,1,1,0.448,0.519,0.385,78
morsel,1.346,28,10,1,1,0.49,0.296,0.4,38
venomous,1.343,112,42,1,1,0.159,0.841,0.636,154
reek,1.343,112,42,1,1,0.177,0.48,0.311,154
bloodline,1.342,309,117,1,1,0.51,0.657,0.604,426
bugle,1.341,20,7,1,1,0.479,0.588,0.391,27
rosy,1.341,167,63,1,1,0.94,0.528,0.755,230
hilly,1.341,20,7,1,1,0.643,0.479,0.603,27
simulate,1.34,75,28,1,1,0.551,0.375,0.417,103
sullen,1.34,75,28,1,1,0.25,0.407,0.263,103
tit,1.339,308,117,1,1,0.402,0.539,0.388,425
slide,1.339,2599,992,1,1,0.615,0.435,0.432,3591
withered,1.338,122,46,1,1,0.188,0.292,0.16,168
spoof,1.336,46,17,1,1,0.49,0.594,0.381,63
harmonica,1.335,59,22,1,1,0.847,0.235,0.51,81
perpetual,1.334,554,212,1,1,0.625,0.438,0.741,766
geezer,1.332,64,24,1,1,0.458,0.374,0.414,88
deluxe,1.332,155,59,1,1,0.792,0.612,0.755,214
carp,1.332,38,14,1,1,0.531,0.324,0.375,52
froggy,1.332,25,9,1,1,0.5,0.56,0.425,34
cornball,1.332,38,14,1,1,0.479,0.378,0.325,52
flower,1.332,3082,1185,1,1,0.802,0.189,0.254,4267
smooch,1.33,217,83,1,1,0.796,0.731,0.491,300
jazzy,1.329,82,31,1,1,0.725,0.431,0.389,113
marmalade,1.328,56,21,1,1,0.729,0.37,0.288,77
placid,1.328,56,21,1,1,0.64,0.317,0.491,77
hippo,1.328,100,38,1,1,0.49,0.404,0.477,138
impersonal,1.327,87,33,1,1,0.316,0.356,0.472,120
kite,1.325,216,83,1,1,0.643,0.5,0.573,299
deprived,1.323,1133,439,1,1,0.354,0.506,0.536,1572
lowly,1.323,200,77,1,1,0.562,0.294,0.417,277
novelist,1.322,84,32,1,1,0.34,0.343,0.529,116
hoe,1.318,4877,1902,1,1,0.302,0.48,0.418,6779
rotary,1.317,40,15,1,1,0.573,0.462,0.528,55
underworld,1.316,173,67,1,1,0.177,0.676,0.613,240
snail,1.315,265,103,1,1,0.48,0.104,0.296,368
frog,1.315,692,270,1,1,0.439,0.311,0.15,962
ness,1.315,385,150,1,1,0.396,0.48,0.392,535
trinket,1.315,22,8,1,1,0.521,0.352,0.368,30
sheik,1.315,22,8,1,1,0.521,0.579,0.708,30
afire,1.315,22,8,1,1,0.367,0.904,0.675,30
unbound,1.315,22,8,1,1,0.354,0.402,0.283,30
escort,1.314,602,235,1,1,0.729,0.48,0.608,837
exclusion,1.313,267,104,1,1,0.24,0.53,0.389,371
smith,1.311,2131,836,1,1,0.677,0.333,0.529,2967
cuckold,1.311,55,21,1,1,0.21,0.573,0.23,76
tad,1.31,861,338,1,1,0.459,0.24,0.25,1199
herb,1.309,182,71,1,1,0.643,0.418,0.353,253
cognition,1.308,32,12,1,1,0.635,0.344,0.706,44
clitoris,1.308,32,12,1,1,0.625,0.844,0.464,44
oink,1.308,32,12,1,1,0.5,0.45,0.289,44
bygone,1.306,37,14,1,1,0.229,0.31,0.315,51
loser,1.304,7418,2932,1,1,0.083,0.51,0.155,10350
vega,1.304,42,16,1,1,0.51,0.333,0.434,58
roundabout,1.303,95,37,1,1,0.49,0.425,0.495,132
friendliness,1.303,95,37,1,1,0.981,0.27,0.611,132
miner,1.302,52,20,1,1,0.408,0.594,0.644,72
guinea,1.302,559,221,1,1,0.521,0.44,0.396,780
colorless,1.301,57,22,1,1,0.354,0.34,0.25,79
frisbee,1.301,62,24,1,1,0.706,0.543,0.364,86
fondle,1.293,34,13,1,1,0.823,0.485,0.355,47
invisibility,1.293,94,37,1,1,0.438,0.461,0.382,131
prelude,1.293,54,21,1,1,0.544,0.392,0.556,75
necromancer,1.293,39,15,1,1,0.333,0.625,0.536,54
futility,1.293,109,43,1,1,0.125,0.32,0.176,152
pearly,1.293,39,15,1,1,0.635,0.337,0.373,54
striptease,1.293,19,7,1,1,0.607,0.918,0.608,26
matador,1.293,19,7,1,1,0.224,0.88,0.667,26
clothe,1.293,94,37,1,1,0.797,0.33,0.481,131
abate,1.293,34,13,1,1,0.255,0.696,0.604,47
reggae,1.293,139,55,1,1,0.698,0.52,0.5,194
inadequacy,1.291,316,126,1,1,0.286,0.5,0.297,442
diamond,1.291,1484,594,1,1,0.91,0.606,0.769,2078
cruising,1.29,166,66,1,1,0.886,0.58,0.56,232
cuddles,1.289,3317,1331,1,1,0.847,0.382,0.5,4648
homey,1.288,116,46,1,1,0.769,0.278,0.5,162
wreckage,1.288,111,44,1,1,0.082,0.353,0.333,155
reduce,1.288,1771,711,1,1,0.219,0.304,0.336,2482
captivity,1.286,143,57,1,1,0.225,0.493,0.387,200
shaker,1.285,66,26,1,1,0.52,0.728,0.518,92
requiem,1.285,61,24,1,1,0.475,0.382,0.426,85
gerbil,1.282,46,18,1,1,0.453,0.306,0.398,64
millionaire,1.282,412,166,1,1,0.917,0.755,0.85,578
connoisseur,1.281,41,16,1,1,0.76,0.461,0.769,57
sultry,1.281,41,16,1,1,0.735,0.696,0.627,57
babble,1.28,115,46,1,1,0.552,0.441,0.204,161
drape,1.279,36,14,1,1,0.417,0.439,0.404,50
bony,1.279,36,14,1,1,0.445,0.462,0.33,50
captive,1.276,294,119,1,1,0.235,0.558,0.411,413
smudge,1.276,58,23,1,1,0.327,0.429,0.245,81
carpenter,1.276,235,95,1,1,0.521,0.55,0.519,330
glider,1.274,80,32,1,1,0.618,0.548,0.59,112
armchair,1.274,161,65,1,1,0.646,0.164,0.339,226
whiz,1.274,26,10,1,1,0.896,0.627,0.82,36
pornographic,1.274,26,10,1,1,0.23,0.896,0.5,36
anemone,1.274,26,10,1,1,0.552,0.538,0.327,36
spire,1.274,26,10,1,1,0.354,0.358,0.389,36
motte,1.274,26,10,1,1,0.481,0.389,0.37,36
mahogany,1.274,26,10,1,1,0.602,0.225,0.393,36
brooding,1.273,205,83,1,1,0.327,0.367,0.333,288
sadness,1.273,19378,7906,1,1,0.052,0.288,0.164,27284
asphalt,1.272,48,19,1,1,0.479,0.264,0.439,67
thrill,1.272,555,226,1,1,0.888,0.837,0.711,781
pathetic,1.272,11682,4769,1,1,0.088,0.464,0.139,16451
slutty,1.272,190,77,1,1,0.224,0.81,0.371,267
plump,1.272,70,28,1,1,0.385,0.48,0.387,98
repairman,1.272,70,28,1,1,0.582,0.426,0.707,98
coldness,1.271,295,120,1,1,0.093,0.47,0.427,415
grange,1.27,21,8,1,1,0.531,0.34,0.391,29
clamor,1.27,21,8,1,1,0.438,0.643,0.36,29
nourish,1.268,243,99,1,1,0.878,0.46,0.639,342
quell,1.268,121,49,1,1,0.388,0.696,0.434,170
mystic,1.268,282,115,1,1,0.643,0.52,0.535,397
restlessness,1.267,133,54,1,1,0.083,0.794,0.397,187
adventurer,1.266,55,22,1,1,0.781,0.839,0.868,77
creature,1.266,2345,963,1,1,0.669,0.625,0.62,3308
hustler,1.266,72,29,1,1,0.26,0.821,0.627,101
boy,1.264,39287,16171,1,1,0.646,0.392,0.445,55458
abject,1.264,237,97,1,1,0.354,0.59,0.417,334
swan,1.262,324,133,1,1,0.781,0.225,0.357,457
parakeet,1.261,45,18,1,1,0.576,0.387,0.227,63
sex,1.259,24363,10078,1,1,0.803,0.939,0.704,34441
clientele,1.259,28,11,1,1,0.625,0.577,0.508,39
superstore,1.259,28,11,1,1,0.719,0.6,0.64,39
saucer,1.257,40,16,1,1,0.51,0.327,0.337,56
monotony,1.256,105,43,1,1,0.398,0.135,0.353,148
straits,1.256,52,21,1,1,0.408,0.269,0.41,73
winding,1.255,259,107,1,1,0.398,0.582,0.361,366
titular,1.252,23,9,1,1,0.704,0.385,0.76,32
rippling,1.252,23,9,1,1,0.5,0.48,0.327,32
fatal,1.251,529,220,1,1,0.061,0.775,0.509,749
parlor,1.249,78,32,1,1,0.5,0.327,0.366,110
salty,1.249,1325,553,1,1,0.388,0.531,0.288,1878
pilgrim,1.249,133,55,1,1,0.531,0.404,0.569,188
hopper,1.248,207,86,1,1,0.396,0.491,0.442,293
moonshine,1.245,30,12,1,1,0.633,0.389,0.491,42
insomniac,1.245,216,90,1,1,0.231,0.367,0.329,306
untold,1.245,552,231,1,1,0.24,0.367,0.191,783
innumerable,1.244,80,33,1,1,0.667,0.445,0.704,113
heartsick,1.244,49,20,1,1,0.24,0.388,0.208,69
luscious,1.241,37,15,1,1,0.885,0.552,0.545,52
enchantment,1.241,18,7,1,1,0.816,0.775,0.647,25
chinchilla,1.241,37,15,1,1,0.48,0.45,0.286,52
treatise,1.241,18,7,1,1,0.604,0.407,0.613,25
greenwood,1.241,18,7,1,1,0.531,0.382,0.491,25
sorrowful,1.241,234,98,1,1,0.049,0.422,0.163,332
prod,1.24,139,58,1,1,0.48,0.479,0.426,197
undivided,1.24,139,58,1,1,0.51,0.38,0.49,197
palette,1.238,186,78,1,1,0.59,0.333,0.205,264
teeny,1.237,200,84,1,1,0.427,0.418,0.216,284
hark,1.237,25,10,1,1,0.571,0.5,0.398,35
juke,1.237,25,10,1,1,0.5,0.491,0.41,35
rejection,1.235,3179,1347,1,1,0.08,0.704,0.33,4526
glacier,1.234,32,13,1,1,0.573,0.396,0.554,45
woozy,1.234,32,13,1,1,0.177,0.452,0.306,45
prototype,1.232,39,16,1,1,0.673,0.33,0.657,55
sloth,1.23,168,71,1,1,0.198,0.14,0.125,239
helplessness,1.229,487,207,1,1,0.087,0.48,0.25,694
drummer,1.228,163,69,1,1,0.646,0.7,0.564,232
skater,1.227,88,37,1,1,0.633,0.774,0.652,125
matchmaker,1.227,95,40,1,1,0.615,0.509,0.519,135
ass,1.227,67535,28849,1,1,0.323,0.75,0.345,96384
sire,1.226,130,55,1,1,0.854,0.452,0.808,185
negro,1.226,137,58,1,1,0.354,0.368,0.461,195
townspeople,1.224,20,8,1,1,0.677,0.466,0.569,28
teriyaki,1.224,20,8,1,1,0.646,0.449,0.431,28
ravioli,1.224,69,29,1,1,0.656,0.281,0.308,98
screenwriter,1.224,41,17,1,1,0.571,0.5,0.712,58
predictor,1.224,34,14,1,1,0.646,0.615,0.738,48
satellite,1.221,362,155,1,1,0.562,0.409,0.764,517
smokey,1.221,106,45,1,1,0.494,0.462,0.43,151
regretful,1.22,171,73,1,1,0.167,0.48,0.188,244
inflatable,1.219,64,27,1,1,0.51,0.51,0.4,91
prism,1.219,64,27,1,1,0.52,0.429,0.343,91
robotics,1.218,57,24,1,1,0.592,0.6,0.763,81
lollipop,1.216,87,37,1,1,0.628,0.483,0.357,124
displacement,1.216,43,18,1,1,0.276,0.531,0.481,61
lush,1.216,212,91,1,1,0.74,0.783,0.833,303
stalker,1.216,786,339,1,1,0.177,0.93,0.639,1125
unholy,1.216,205,88,1,1,0.327,0.56,0.445,293
fucktard,1.214,66,28,1,1,0.214,0.643,0.364,94
pomp,1.213,29,12,1,1,0.448,0.491,0.413,41
exalt,1.213,29,12,1,1,0.656,0.75,0.745,41
speck,1.212,285,123,1,1,0.418,0.245,0.343,408
balding,1.212,112,48,1,1,0.302,0.363,0.368,160
peak,1.212,2088,905,1,1,0.5,0.345,0.431,2993
violinist,1.209,22,9,1,1,0.804,0.302,0.538,31
spruce,1.209,22,9,1,1,0.604,0.288,0.38,31
croc,1.209,45,19,1,1,0.327,0.452,0.451,64
spastic,1.209,22,9,1,1,0.24,0.541,0.491,31
lesbianism,1.209,45,19,1,1,0.327,0.725,0.44,64
vinyl,1.209,383,166,1,1,0.49,0.241,0.44,549
mortality,1.209,415,180,1,1,0.229,0.726,0.518,595
perch,1.205,70,30,1,1,0.531,0.3,0.314,100
projecting,1.205,711,310,1,1,0.635,0.564,0.786,1021
bean,1.205,1439,628,1,1,0.667,0.269,0.264,2067
archetype,1.203,63,27,1,1,0.448,0.52,0.569,90
bustling,1.201,88,38,1,1,0.49,0.85,0.528,126
materialism,1.201,88,38,1,1,0.22,0.39,0.556,126
farmer,1.201,510,223,1,1,0.677,0.432,0.464,733
scrabble,1.201,56,24,1,1,0.625,0.412,0.399,80
unsatisfied,1.198,297,130,1,1,0.2,0.547,0.241,427
disguise,1.198,722,317,1,1,0.573,0.694,0.431,1039
expectancy,1.197,124,54,1,1,0.581,0.622,0.558,178
expressway,1.197,24,10,1,1,0.633,0.635,0.587,34
cactus,1.197,299,131,1,1,0.439,0.412,0.284,430
teacup,1.197,49,21,1,1,0.633,0.135,0.277,70
robot,1.196,1651,727,1,1,0.441,0.337,0.543,2378
chasm,1.195,126,55,1,1,0.265,0.579,0.5,181
acorn,1.195,33,14,1,1,0.448,0.198,0.192,47
dweeb,1.194,110,48,1,1,0.354,0.446,0.327,158
mirage,1.194,196,86,1,1,0.546,0.487,0.562,282
bellow,1.193,42,18,1,1,0.248,0.337,0.212,60
highlands,1.193,94,41,1,1,0.735,0.431,0.596,135
tiller,1.192,51,22,1,1,0.448,0.41,0.29,73
pie,1.192,1351,597,1,1,0.88,0.402,0.368,1948
obscurity,1.191,200,88,1,1,0.208,0.392,0.38,288
leaf,1.19,626,277,1,1,0.583,0.156,0.294,903
mud,1.189,700,310,1,1,0.333,0.26,0.185,1010
ache,1.188,1776,788,1,1,0.146,0.76,0.312,2564
famished,1.187,26,11,1,1,0.177,0.654,0.282,37
hunchback,1.187,26,11,1,1,0.208,0.39,0.259,37
obscured,1.187,26,11,1,1,0.115,0.356,0.298,37
bastard,1.185,1962,873,1,1,0.094,0.692,0.289,2835
raindrops,1.185,255,113,1,1,0.698,0.337,0.311,368
frailty,1.184,82,36,1,1,0.385,0.4,0.218,118
dyke,1.184,221,98,1,1,0.438,0.396,0.566,319
dock,1.184,212,94,1,1,0.49,0.409,0.481,306
flashy,1.182,102,45,1,1,0.704,0.6,0.827,147
nostalgia,1.182,713,318,1,1,0.417,0.337,0.339,1031
bedrock,1.181,37,16,1,1,0.561,0.34,0.598,53
lagoon,1.18,66,29,1,1,0.66,0.231,0.373,95
wharf,1.179,28,12,1,1,0.469,0.24,0.472,40
outback,1.179,57,25,1,1,0.5,0.324,0.43,82
exhilaration,1.179,28,12,1,1,0.792,0.868,0.783,40
truthfulness,1.179,28,12,1,1,0.92,0.549,0.808,40
loveless,1.178,583,261,1,1,0.102,0.365,0.216,844
haw,1.178,184,82,1,1,0.406,0.426,0.431,266
shag,1.176,137,61,1,1,0.417,0.462,0.34,198
pussycat,1.175,39,17,1,1,0.541,0.29,0.196,56
dejected,1.175,219,98,1,1,0.104,0.654,0.347,317
turnpike,1.175,19,8,1,1,0.459,0.434,0.462,27
skit,1.173,121,54,1,1,0.438,0.434,0.421,175
goat,1.173,1061,478,1,1,0.448,0.304,0.364,1539
cinematography,1.17,114,51,1,1,0.781,0.571,0.625,165
narration,1.17,83,37,1,1,0.622,0.408,0.551,120
fur,1.169,1380,624,1,1,0.583,0.392,0.315,2004
liven,1.169,52,23,1,1,0.708,0.713,0.673,75
caress,1.167,387,175,1,1,0.833,0.418,0.509,562
heartache,1.166,1607,729,1,1,0.088,0.75,0.291,2336
needy,1.166,3943,1790,1,1,0.36,0.451,0.245,5733
pandemonium,1.165,32,14,1,1,0.229,0.885,0.5,46
lumber,1.165,21,9,1,1,0.517,0.184,0.373,30
fragrant,1.165,32,14,1,1,0.615,0.598,0.613,46
unopened,1.165,153,69,1,1,0.542,0.34,0.265,222
thistle,1.165,21,9,1,1,0.427,0.423,0.357,30
goalie,1.165,87,39,1,1,0.573,0.389,0.455,126
wizard,1.164,496,225,1,1,0.656,0.43,0.526,721
homesick,1.163,1156,526,1,1,0.436,0.304,0.347,1682
bravado,1.162,78,35,1,1,0.479,0.51,0.527,113
booty,1.162,771,351,1,1,0.663,0.587,0.784,1122
reconstruction,1.161,56,25,1,1,0.625,0.719,0.667,81
collide,1.161,159,72,1,1,0.271,0.892,0.557,231
pecker,1.16,45,20,1,1,0.459,0.509,0.375,65
jealousy,1.16,1427,651,1,1,0.146,0.783,0.481,2078
envy,1.16,1593,727,1,1,0.24,0.704,0.427,2320
unread,1.16,266,121,1,1,0.458,0.24,0.214,387
carat,1.159,233,106,1,1,0.823,0.604,0.676,339
buss,1.158,93,42,1,1,0.469,0.5,0.391,135
compilation,1.158,294,134,1,1,0.53,0.512,0.606,428
bookworm,1.158,58,26,1,1,0.563,0.337,0.316,84
nostalgic,1.158,709,324,1,1,0.458,0.351,0.184,1033
ceaseless,1.156,47,21,1,1,0.378,0.704,0.658,68
inversely,1.156,23,10,1,1,0.286,0.418,0.351,33
lamppost,1.156,23,10,1,1,0.42,0.337,0.455,33
cutthroat,1.156,23,10,1,1,0.11,0.823,0.663,33
shallows,1.156,23,10,1,1,0.388,0.368,0.368,33
threesome,1.156,204,93,1,1,0.49,0.676,0.56,297
hillside,1.155,60,27,1,1,0.625,0.292,0.458,87
lapse,1.154,134,61,1,1,0.42,0.316,0.281,195
winter,1.154,7378,3388,1,1,0.663,0.355,0.5,10766
cavernous,1.154,36,16,1,1,0.354,0.548,0.462,52
sentinel,1.154,36,16,1,1,0.531,0.602,0.845,52
duet,1.154,221,101,1,1,0.694,0.693,0.527,322
roadside,1.154,73,33,1,1,0.5,0.569,0.472,106
horned,1.154,36,16,1,1,0.316,0.61,0.375,52
sleeplessness,1.153,49,22,1,1,0.104,0.604,0.202,71
showdown,1.153,49,22,1,1,0.302,0.95,0.692,71
bookshop,1.15,103,47,1,1,0.688,0.291,0.389,150
pouty,1.15,90,41,1,1,0.333,0.48,0.393,131
dissipated,1.15,38,17,1,1,0.281,0.421,0.231,55
penguin,1.148,356,164,1,1,0.615,0.296,0.307,520
codeine,1.148,92,42,1,1,0.375,0.582,0.436,134
pony,1.147,470,217,1,1,0.812,0.413,0.315,687
roads,1.146,1586,734,1,1,0.677,0.448,0.496,2320
jagged,1.145,81,37,1,1,0.082,0.462,0.213,118
faggot,1.145,273,126,1,1,0.219,0.643,0.292,399
smoky,1.145,68,31,1,1,0.459,0.42,0.327,99
lively,1.145,400,185,1,1,0.847,0.81,0.642,585
succulent,1.144,55,25,1,1,0.823,0.538,0.556,80
toad,1.144,195,90,1,1,0.302,0.452,0.196,285
siren,1.143,240,111,1,1,0.57,0.627,0.5,351
psychedelic,1.141,57,26,1,1,0.45,0.63,0.482,83
wolf,1.141,3697,1721,1,1,0.448,0.712,0.63,5418
acoustic,1.14,641,298,1,1,0.542,0.462,0.536,939
pyramid,1.14,145,67,1,1,0.74,0.39,0.635,212
tinge,1.14,87,40,1,1,0.469,0.292,0.264,127
corral,1.138,29,13,1,1,0.606,0.662,0.422,42
somber,1.138,196,91,1,1,0.184,0.5,0.38,287
warm,1.137,13312,6223,1,1,0.76,0.312,0.585,19535
bondage,1.136,215,100,1,1,0.146,0.705,0.355,315
minister,1.136,1906,891,1,1,0.547,0.441,0.892,2797
tavern,1.135,93,43,1,1,0.516,0.577,0.475,136
pale,1.135,759,355,1,1,0.281,0.259,0.245,1114
melodrama,1.134,127,59,1,1,0.378,0.83,0.446,186
wight,1.134,31,14,1,1,0.542,0.404,0.395,45
correspond,1.134,31,14,1,1,0.71,0.452,0.545,45
gout,1.134,31,14,1,1,0.354,0.314,0.17,45
polka,1.134,31,14,1,1,0.604,0.451,0.426,45
glamorous,1.134,208,97,1,1,0.918,0.63,0.791,305
crucify,1.133,48,22,1,1,0.146,0.878,0.573,70
sailor,1.132,344,161,1,1,0.5,0.588,0.5,505
mannequin,1.131,150,70,1,1,0.427,0.302,0.295,220
clout,1.13,760,357,1,1,0.584,0.636,0.704,1117
wilted,1.13,33,15,1,1,0.245,0.375,0.186,48
composition,1.129,120,56,1,1,0.765,0.408,0.652,176
bitch,1.128,49224,23220,1,1,0.276,0.74,0.343,72444
duo,1.127,749,353,1,1,0.51,0.5,0.447,1102
hapless,1.127,35,16,1,1,0.271,0.442,0.193,51
ladylike,1.127,35,16,1,1,0.592,0.559,0.538,51
duckling,1.126,90,42,1,1,0.602,0.353,0.263,132
evergreen,1.125,128,60,1,1,0.729,0.471,0.546,188
wildfire,1.124,113,53,1,1,0.14,0.929,0.552,166
ringer,1.124,132,62,1,1,0.573,0.604,0.347,194
dragonfly,1.124,18,8,1,1,0.571,0.373,0.357,26
matron,1.124,18,8,1,1,0.52,0.519,0.555,26
hunky,1.124,37,17,1,1,0.469,0.571,0.438,54
turquoise,1.124,37,17,1,1,0.786,0.226,0.357,54
soreness,1.124,18,8,1,1,0.113,0.843,0.302,26
sprout,1.124,75,35,1,1,0.582,0.565,0.443,110
shimmering,1.124,56,26,1,1,0.844,0.648,0.904,82
hologram,1.124,75,35,1,1,0.615,0.461,0.575,110
landscape,1.123,459,217,1,1,0.719,0.176,0.423,676
beck,1.123,366,173,1,1,0.58,0.375,0.418,539
wallow,1.123,676,320,1,1,0.286,0.878,0.491,996
overworked,1.123,212,100,1,1,0.133,0.67,0.387,312
inbred,1.122,77,36,1,1,0.397,0.52,0.473,113
brothel,1.122,58,27,1,1,0.255,0.886,0.418,85
portrait,1.121,357,169,1,1,0.698,0.186,0.467,526
degradation,1.121,79,37,1,1,0.16,0.608,0.315,116
captor,1.118,20,9,1,1,0.347,0.625,0.612,29
mathematician,1.118,20,9,1,1,0.541,0.418,0.773,29
seaman,1.118,20,9,1,1,0.52,0.51,0.672,29
setter,1.118,20,9,1,1,0.541,0.455,0.473,29
aftershave,1.118,20,9,1,1,0.406,0.384,0.415,29
swindle,1.118,20,9,1,1,0.122,0.74,0.439,29
foiled,1.118,20,9,1,1,0.235,0.47,0.144,29
knockoff,1.118,20,9,1,1,0.35,0.606,0.24,29
loch,1.118,41,19,1,1,0.449,0.235,0.425,60
slag,1.117,85,40,1,1,0.266,0.6,0.254,125
acquainted,1.116,242,115,1,1,0.906,0.358,0.632,357
fulfillment,1.115,489,233,1,1,0.833,0.528,0.683,722
dung,1.115,66,31,1,1,0.104,0.549,0.149,97
paltry,1.114,22,10,1,1,0.333,0.491,0.32,32
tinsel,1.114,45,21,1,1,0.663,0.521,0.473,66
jealous,1.113,5213,2496,1,1,0.173,0.855,0.345,7709
oft,1.111,97,46,1,1,0.5,0.308,0.474,143
painfully,1.111,1054,505,1,1,0.156,0.72,0.407,1559
inception,1.111,122,58,1,1,0.604,0.425,0.561,180
rainy,1.111,1754,841,1,1,0.61,0.451,0.433,2595
pilgrimage,1.11,74,35,1,1,0.708,0.522,0.625,109
moonlit,1.11,74,35,1,1,0.873,0.269,0.508,109
amorous,1.11,24,11,1,1,0.844,0.67,0.636,35
tedium,1.11,24,11,1,1,0.224,0.331,0.298,35
lunchbox,1.11,24,11,1,1,0.663,0.346,0.346,35
cunt,1.108,1941,933,1,1,0.135,0.673,0.377,2874
banger,1.108,448,215,1,1,0.378,0.54,0.538,663
volunteering,1.107,597,287,1,1,0.844,0.614,0.603,884
adaptation,1.106,167,80,1,1,0.663,0.365,0.609,247
discord,1.106,2946,1420,1,1,0.115,0.882,0.465,4366
despair,1.105,4899,2363,1,1,0.115,0.794,0.245,7262
handout,1.105,57,27,1,1,0.56,0.33,0.545,84
effeminate,1.105,28,13,1,1,0.337,0.619,0.291,41
foreground,1.105,28,13,1,1,0.708,0.491,0.59,41
mitigating,1.105,28,13,1,1,0.551,0.52,0.6,41
seduction,1.105,57,27,1,1,0.51,0.891,0.618,84
dolphin,1.104,175,84,1,1,0.776,0.35,0.414,259
tourism,1.104,148,71,1,1,0.823,0.531,0.545,219
bimbo,1.103,59,28,1,1,0.396,0.37,0.3,87
listless,1.103,59,28,1,1,0.219,0.35,0.231,87
deranged,1.103,390,188,1,1,0.376,0.868,0.357,578
lust,1.102,1175,568,1,1,0.469,0.944,0.518,1743
promiscuity,1.102,61,29,1,1,0.219,0.96,0.396,90
elderly,1.102,4577,2215,1,1,0.615,0.212,0.283,6792
pang,1.101,255,123,1,1,0.146,0.595,0.455,378
pare,1.101,96,46,1,1,0.5,0.356,0.309,142
deco,1.1,32,15,1,1,0.625,0.274,0.356,47
heady,1.1,32,15,1,1,0.448,0.806,0.565,47
underrated,1.099,2068,1003,1,1,0.208,0.52,0.333,3071
scavenger,1.099,67,32,1,1,0.177,0.578,0.408,99
cuddling,1.099,2042,991,1,1,0.917,0.562,0.433,3033
crater,1.098,34,16,1,1,0.45,0.647,0.529,50
orgies,1.098,34,16,1,1,0.388,0.953,0.433,50
poet,1.098,736,357,1,1,0.827,0.35,0.556,1093
vengeful,1.098,141,68,1,1,0.15,0.84,0.561,209
sky,1.098,14009,6810,1,1,0.958,0.234,0.401,20819
mistrust,1.097,108,52,1,1,0.135,0.657,0.231,160
christmassy,1.097,36,17,1,1,0.875,0.698,0.602,53
vert,1.097,73,35,1,1,0.49,0.375,0.434,108
sausage,1.097,299,145,1,1,0.542,0.429,0.3,444
ensue,1.094,40,19,1,1,0.698,0.363,0.332,59
disco,1.094,538,262,1,1,0.71,0.806,0.575,800
cold,1.092,34437,16834,1,1,0.398,0.538,0.348,51271
exploration,1.092,314,153,1,1,0.594,0.65,0.773,467
unsuspecting,1.091,91,44,1,1,0.302,0.509,0.413,135
touchdown,1.091,46,22,1,1,0.667,0.77,0.586,68
chatty,1.09,244,119,1,1,0.594,0.548,0.345,363
depraved,1.09,146,71,1,1,0.031,0.837,0.395,217
frosty,1.089,154,75,1,1,0.427,0.48,0.381,229
jag,1.089,52,25,1,1,0.408,0.44,0.427,77
grapefruit,1.088,54,26,1,1,0.521,0.281,0.282,80
eleven,1.088,386,189,1,1,0.449,0.25,0.43,575
virgin,1.088,2712,1331,1,1,0.622,0.433,0.462,4043
perpetually,1.087,404,198,1,1,0.51,0.473,0.868,602
twinkle,1.087,174,85,1,1,0.719,0.724,0.61,259
traveler,1.086,371,182,1,1,0.837,0.571,0.7,553
munch,1.085,129,63,1,1,0.541,0.277,0.434,192
yearning,1.085,935,460,1,1,0.709,0.51,0.537,1395
latex,1.085,66,32,1,1,0.479,0.413,0.325,98
metaphor,1.084,427,210,1,1,0.562,0.28,0.47,637
striped,1.083,72,35,1,1,0.344,0.373,0.385,107
crab,1.083,305,150,1,1,0.421,0.396,0.33,455
bereavement,1.082,238,117,1,1,0.265,0.677,0.5,355
thirst,1.082,799,394,1,1,0.298,0.519,0.307,1193
stalk,1.081,507,250,1,1,0.436,0.272,0.395,757
reindeer,1.081,90,44,1,1,0.592,0.336,0.396,134
lament,1.079,205,101,1,1,0.198,0.398,0.352,306
foxy,1.079,104,51,1,1,0.552,0.642,0.679,155
plush,1.079,322,159,1,1,0.625,0.265,0.318,481
dull,1.079,1188,588,1,1,0.194,0.12,0.185,1776
crimson,1.077,257,127,1,1,0.667,0.385,0.37,384
volcano,1.076,146,72,1,1,0.24,0.844,0.787,218
wannabe,1.076,323,160,1,1,0.602,0.547,0.337,483
nipple,1.075,176,87,1,1,0.48,0.786,0.415,263
terribly,1.075,2054,1021,1,1,0.061,0.731,0.43,3075
voodoo,1.075,194,96,1,1,0.188,0.6,0.453,290
symphony,1.075,194,96,1,1,0.765,0.49,0.6,290
contagious,1.074,465,231,1,1,0.184,0.725,0.4,696
creeping,1.074,995,495,1,1,0.292,0.613,0.282,1490
correlation,1.073,288,143,1,1,0.596,0.462,0.571,431
mansion,1.072,1329,662,1,1,0.847,0.49,0.717,1991
vengeance,1.072,398,198,1,1,0.103,0.927,0.719,596
rich,1.071,7774,3880,1,1,0.882,0.627,0.905,11654
engulf,1.069,83,41,1,1,0.398,0.573,0.5,124
scrawny,1.069,49,24,1,1,0.276,0.422,0.245,73
sepia,1.069,17,8,1,1,0.448,0.27,0.345,25
hangar,1.069,17,8,1,1,0.49,0.456,0.481,25
vanquished,1.069,39,19,1,1,0.496,0.529,0.176,58
preoccupation,1.069,21,10,1,1,0.375,0.694,0.38,31
chestnut,1.069,39,19,1,1,0.714,0.21,0.294,58
magnolia,1.069,39,19,1,1,0.558,0.343,0.379,58
languishing,1.069,43,21,1,1,0.308,0.459,0.353,64
tapestry,1.069,43,21,1,1,0.52,0.176,0.362,64
publicist,1.069,23,11,1,1,0.562,0.531,0.676,34
opal,1.069,33,16,1,1,0.623,0.479,0.379,49
filly,1.069,17,8,1,1,0.479,0.564,0.519,25
bayou,1.069,33,16,1,1,0.469,0.431,0.324,49
thicket,1.069,19,9,1,1,0.385,0.373,0.324,28
elk,1.069,43,21,1,1,0.439,0.337,0.34,64
blackness,1.069,215,107,1,1,0.26,0.48,0.406,322
flamboyant,1.069,33,16,1,1,0.615,0.794,0.705,49
freebie,1.069,23,11,1,1,0.796,0.596,0.5,34
theorem,1.069,17,8,1,1,0.5,0.296,0.615,25
unsanitary,1.069,19,9,1,1,0.063,0.592,0.269,28
bankroll,1.069,31,15,1,1,0.469,0.57,0.509,46
conceit,1.069,27,13,1,1,0.354,0.625,0.309,40
quadrant,1.069,33,16,1,1,0.5,0.269,0.482,49
wench,1.069,57,28,1,1,0.469,0.519,0.352,85
masterful,1.069,57,28,1,1,0.854,0.51,0.96,85
motley,1.069,31,15,1,1,0.48,0.398,0.412,46
rider,1.067,356,178,1,1,0.635,0.627,0.574,534
lethal,1.066,316,158,1,1,0.156,0.8,0.745,474
pained,1.066,282,141,1,1,0.112,0.5,0.25,423
palpable,1.066,254,127,1,1,0.552,0.343,0.611,381
spam,1.065,1070,537,1,1,0.188,0.354,0.304,1607
breed,1.065,819,411,1,1,0.49,0.441,0.578,1230
bottomless,1.064,198,99,1,1,0.31,0.47,0.368,297
sorrow,1.064,2984,1500,1,1,0.052,0.235,0.164,4484
pinnacle,1.063,142,71,1,1,0.633,0.39,0.508,213
frigid,1.061,118,59,1,1,0.219,0.481,0.395,177
heartbreak,1.061,3021,1523,1,1,0.208,0.61,0.245,4544
roulette,1.061,112,56,1,1,0.326,0.69,0.422,168
premium,1.059,595,300,1,1,0.786,0.59,0.769,895
imaginative,1.059,90,45,1,1,0.78,0.541,0.593,135
fragility,1.058,86,43,1,1,0.316,0.306,0.2,129
clover,1.058,341,172,1,1,0.605,0.34,0.364,513
resentful,1.058,254,128,1,1,0.12,0.608,0.324,382
postman,1.058,82,41,1,1,0.643,0.482,0.455,123
depicting,1.056,72,36,1,1,0.49,0.566,0.602,108
orc,1.056,72,36,1,1,0.24,0.51,0.388,108
freelancer,1.056,143,72,1,1,0.614,0.564,0.553,215
werewolf,1.055,212,107,1,1,0.235,0.811,0.591,319
towering,1.055,70,35,1,1,0.5,0.69,0.806,105
splendor,1.055,68,34,1,1,0.927,0.612,0.85,102
samurai,1.055,137,69,1,1,0.562,0.736,0.838,206
gratification,1.055,202,102,1,1,0.867,0.643,0.755,304
fruitless,1.054,64,32,1,1,0.26,0.58,0.311,96
combination,1.054,1545,784,1,1,0.708,0.48,0.726,2329
expedition,1.054,62,31,1,1,0.735,0.802,0.62,93
juxtaposition,1.054,62,31,1,1,0.427,0.5,0.46,93
homicidal,1.053,58,29,1,1,0.02,0.912,0.573,87
frisk,1.052,56,28,1,1,0.49,0.547,0.377,84
attention,1.052,28267,14383,1,1,0.74,0.599,0.774,42650
sack,1.052,722,367,1,1,0.385,0.337,0.264,1089
affection,1.052,5466,2782,1,1,0.898,0.559,0.696,8248
bird,1.051,3934,2004,1,1,0.729,0.357,0.364,5938
brunette,1.051,366,186,1,1,0.802,0.528,0.529,552
spank,1.05,103,52,1,1,0.112,0.882,0.642,155
voyager,1.05,103,52,1,1,0.684,0.596,0.627,155
magpie,1.05,50,25,1,1,0.5,0.458,0.327,75
finder,1.049,48,24,1,1,0.36,0.55,0.63,72
tailor,1.049,97,49,1,1,0.573,0.206,0.45,146
harmony,1.049,632,322,1,1,0.949,0.23,0.509,954
diamonds,1.049,726,370,1,1,0.927,0.684,0.917,1096
hooker,1.049,191,97,1,1,0.214,0.889,0.373,288
asteroid,1.048,93,47,1,1,0.43,0.721,0.623,140
basement,1.048,2542,1298,1,1,0.388,0.5,0.268,3840
glove,1.048,224,114,1,1,0.5,0.23,0.382,338
diva,1.047,177,90,1,1,0.66,0.657,0.596,267
star,1.047,8904,4552,1,1,0.833,0.418,0.56,13456
lard,1.046,42,21,1,1,0.427,0.239,0.179,63
biography,1.046,85,43,1,1,0.698,0.229,0.718,128
explorer,1.046,126,64,1,1,0.729,0.663,0.714,190
gay,1.045,14742,7550,1,1,0.388,0.587,0.429,22292
existence,1.045,7637,3912,1,1,0.76,0.513,0.771,11549
freestyle,1.044,155,79,1,1,0.765,0.652,0.52,234
pimp,1.044,231,118,1,1,0.146,0.7,0.536,349
blonde,1.044,1609,825,1,1,0.698,0.545,0.412,2434
void,1.043,6435,3303,1,1,0.135,0.163,0.13,9738
corrosive,1.043,36,18,1,1,0.14,0.618,0.57,54
saloon,1.043,36,18,1,1,0.63,0.3,0.364,54
flaccid,1.043,36,18,1,1,0.156,0.4,0.151,54
sprawl,1.043,36,18,1,1,0.6,0.596,0.672,54
eclectic,1.043,36,18,1,1,0.646,0.542,0.508,54
satisfy,1.043,957,491,1,1,0.867,0.79,0.705,1448
perish,1.043,365,187,1,1,0.296,0.57,0.415,552
aurora,1.042,318,163,1,1,0.817,0.306,0.537,481
hummingbird,1.041,34,17,1,1,0.75,0.37,0.273,51
bamboo,1.041,69,35,1,1,0.646,0.222,0.356,104
lorry,1.041,34,17,1,1,0.521,0.481,0.402,51
hardness,1.04,32,16,1,1,0.417,0.58,0.745,48
shrew,1.038,61,31,1,1,0.306,0.463,0.39,92
amiable,1.038,61,31,1,1,0.847,0.29,0.483,92
symbolize,1.037,59,30,1,1,0.633,0.327,0.673,89
superstition,1.037,59,30,1,1,0.177,0.64,0.418,89
weep,1.036,1003,518,1,1,0.053,0.621,0.164,1521
endowed,1.036,28,14,1,1,0.755,0.51,0.769,42
trombone,1.036,28,14,1,1,0.562,0.5,0.5,42
bison,1.036,28,14,1,1,0.573,0.433,0.557,42
prog,1.035,84,43,1,1,0.448,0.412,0.397,127
oozing,1.034,55,28,1,1,0.238,0.515,0.427,83
tenderness,1.034,221,114,1,1,0.949,0.276,0.367,335
mariner,1.033,26,13,1,1,0.652,0.491,0.676,39
dwarf,1.033,213,110,1,1,0.37,0.34,0.288,323
flirt,1.032,1507,782,1,1,0.792,0.79,0.538,2289
sheep,1.032,1757,912,1,1,0.604,0.206,0.161,2669
seaside,1.031,76,39,1,1,0.887,0.52,0.508,115
sap,1.031,226,117,1,1,0.47,0.298,0.258,343
sensuality,1.03,24,12,1,1,0.844,0.84,0.632,36
paisley,1.03,49,25,1,1,0.531,0.327,0.347,74
coyote,1.03,124,64,1,1,0.459,0.471,0.387,188
scour,1.03,24,12,1,1,0.388,0.602,0.632,36
rascal,1.03,49,25,1,1,0.169,0.706,0.445,74
flex,1.029,881,458,1,1,0.604,0.378,0.33,1339
cellmate,1.029,97,50,1,1,0.167,0.684,0.349,147
vixen,1.029,47,24,1,1,0.367,0.615,0.414,71
pint,1.028,379,197,1,1,0.686,0.333,0.321,576
materialistic,1.028,260,135,1,1,0.42,0.506,0.589,395
homo,1.027,369,192,1,1,0.531,0.368,0.415,561
cosmic,1.027,530,276,1,1,0.663,0.538,0.692,806
crypt,1.027,45,23,1,1,0.156,0.431,0.386,68
steakhouse,1.027,22,11,1,1,0.802,0.379,0.547,33
coupe,1.027,45,23,1,1,0.479,0.46,0.482,68
suburbia,1.027,45,23,1,1,0.438,0.49,0.421,68
caper,1.027,22,11,1,1,0.51,0.37,0.326,33
paucity,1.027,22,11,1,1,0.153,0.453,0.175,33
exquisitely,1.027,22,11,1,1,0.849,0.728,0.723,33
prey,1.025,749,391,1,1,0.378,0.5,0.306,1140
undesired,1.025,43,22,1,1,0.156,0.441,0.235,65
nerd,1.025,1328,694,1,1,0.408,0.481,0.315,2022
lyrical,1.024,171,89,1,1,0.708,0.451,0.618,260
highland,1.023,41,21,1,1,0.615,0.481,0.611,62
concerto,1.023,20,10,1,1,0.613,0.759,0.679,30
flammable,1.023,20,10,1,1,0.216,0.8,0.715,30
baroness,1.023,20,10,1,1,0.625,0.453,0.755,30
trapper,1.023,20,10,1,1,0.296,0.654,0.491,30
barrack,1.023,20,10,1,1,0.378,0.5,0.455,30
steamboat,1.023,20,10,1,1,0.708,0.5,0.633,30
aged,1.023,1549,811,1,1,0.135,0.365,0.236,2360
curse,1.023,3870,2027,1,1,0.033,0.72,0.375,5897
kitten,1.023,1356,710,1,1,0.816,0.343,0.26,2066
lingerie,1.022,289,151,1,1,0.543,0.463,0.308,440
liberation,1.022,348,182,1,1,0.745,0.614,0.857,530
obese,1.021,344,180,1,1,0.133,0.427,0.25,524
sad,1.021,209131,109784,1,1,0.225,0.333,0.149,318915
cock,1.021,1559,818,1,1,0.418,0.562,0.392,2377
piped,1.021,39,20,1,1,0.36,0.529,0.379,59
pussy,1.02,4255,2234,1,1,0.323,0.759,0.409,6489
fucker,1.02,1033,542,1,1,0.094,0.788,0.357,1575
vampire,1.02,1137,597,1,1,0.271,0.802,0.545,1734
insatiable,1.019,115,60,1,1,0.375,0.656,0.558,175
locale,1.018,18,9,1,1,0.449,0.387,0.352,27
pensioner,1.018,113,59,1,1,0.44,0.245,0.442,172
lustful,1.018,75,39,1,1,0.427,0.896,0.643,114
newlywed,1.018,18,9,1,1,0.847,0.706,0.57,27
raffle,1.018,75,39,1,1,0.64,0.51,0.454,114
gully,1.018,18,9,1,1,0.316,0.519,0.394,27
gloomy,1.018,863,454,1,1,0.107,0.41,0.287,1317
shore,1.017,1179,621,1,1,0.542,0.304,0.204,1800
twat,1.016,585,308,1,1,0.292,0.459,0.404,893
amnesty,1.016,90,47,1,1,0.551,0.451,0.814,137
toy,1.016,1673,882,1,1,0.878,0.42,0.275,2555
compensate,1.016,416,219,1,1,0.612,0.429,0.762,635
stout,1.015,35,18,1,1,0.656,0.657,0.817,53
grime,1.015,35,18,1,1,0.198,0.5,0.225,53
bouquet,1.015,179,94,1,1,0.724,0.352,0.306,273
atmospheric,1.015,107,56,1,1,0.531,0.42,0.594,163
slut,1.015,844,445,1,1,0.071,0.808,0.309,1289
oldie,1.015,88,46,1,1,0.363,0.363,0.342,134
confines,1.014,86,45,1,1,0.396,0.386,0.542,131
climax,1.013,188,99,1,1,0.735,0.853,0.667,287
keyboard,1.013,995,526,1,1,0.573,0.279,0.349,1521
prostitute,1.013,222,117,1,1,0.167,0.86,0.427,339
farewell,1.013,477,252,1,1,0.13,0.5,0.591,729
anchorage,1.012,33,17,1,1,0.5,0.325,0.639,50
eddy,1.012,84,44,1,1,0.5,0.394,0.35,128
parody,1.012,420,222,1,1,0.561,0.651,0.375,642
flirting,1.011,1393,738,1,1,0.59,0.773,0.491,2131
ghostly,1.011,131,69,1,1,0.26,0.764,0.43,200
incompleteness,1.01,48,25,1,1,0.271,0.451,0.234,73
loot,1.01,391,207,1,1,0.604,0.711,0.537,598
auction,1.01,80,42,1,1,0.594,0.702,0.519,122
cloudy,1.009,370,196,1,1,0.281,0.28,0.202,566
feller,1.009,31,16,1,1,0.406,0.622,0.617,47
filling,1.009,1497,795,1,1,0.51,0.382,0.525,2292
operator,1.008,142,75,1,1,0.612,0.63,0.726,217
console,1.008,1112,591,1,1,0.625,0.398,0.415,1703
grandeur,1.008,93,49,1,1,0.885,0.796,0.839,142
spiteful,1.007,249,132,1,1,0.073,0.71,0.33,381
adulthood,1.007,1388,738,1,1,0.541,0.454,0.652,2126
rebel,1.007,467,248,1,1,0.235,0.83,0.555,715
sheen,1.007,76,40,1,1,0.812,0.51,0.712,116
smoking,1.006,4027,2144,1,1,0.176,0.557,0.384,6171
paradise,1.006,1606,855,1,1,0.875,0.54,0.796,2461
tempest,1.005,59,31,1,1,0.245,0.843,0.653,90
magnifying,1.005,44,23,1,1,0.594,0.265,0.406,67
sadist,1.005,74,39,1,1,0.042,0.918,0.5,113
flamingo,1.005,59,31,1,1,0.667,0.451,0.482,90
ravenous,1.005,29,15,1,1,0.406,0.7,0.509,44
sleepy,1.004,1799,960,1,1,0.604,0.125,0.25,2759
chaser,1.004,102,54,1,1,0.375,0.83,0.645,156
insular,1.001,70,37,1,1,0.531,0.426,0.465,107
swipe,1.001,505,270,1,1,0.573,0.45,0.266,775
gruff,1,27,14,1,1,0.323,0.611,0.472,41
bosom,1,55,29,1,1,0.612,0.588,0.404,84
idyllic,1,27,14,1,1,0.571,0.394,0.593,41
spud,1,27,14,1,1,0.403,0.423,0.349,41
kooky,1,27,14,1,1,0.418,0.582,0.366,41
rabbit,1,1746,935,1,1,0.685,0.33,0.241,2681
oral,1,292,156,1,1,0.53,0.448,0.375,448
pauper,0.999,40,21,1,1,0.26,0.347,0.151,61
crawfish,0.999,40,21,1,1,0.51,0.427,0.342,61
overplayed,0.998,53,28,1,1,0.224,0.798,0.586,81
lullaby,0.998,511,274,1,1,0.796,0.156,0.339,785
aquarium,0.998,133,71,1,1,0.663,0.327,0.393,204
waitress,0.997,330,177,1,1,0.646,0.531,0.352,507
eternal,0.996,2197,1182,1,1,0.854,0.409,0.843,3379
pitiful,0.996,887,477,1,1,0.219,0.49,0.232,1364
gravity,0.995,519,279,1,1,0.51,0.635,0.538,798
sprinkling,0.995,25,13,1,1,0.677,0.51,0.466,38
cosmopolitan,0.995,25,13,1,1,0.823,0.51,0.76,38
sledgehammer,0.995,38,20,1,1,0.449,0.479,0.482,58
salami,0.995,38,20,1,1,0.667,0.36,0.339,58
snuggle,0.994,986,531,1,1,0.781,0.39,0.35,1517
acutely,0.994,127,68,1,1,0.417,0.543,0.491,195
lure,0.994,190,102,1,1,0.439,0.565,0.3,292
sympathy,0.993,3115,1680,1,1,0.827,0.497,0.634,4795
fat,0.993,7388,3987,1,1,0.198,0.353,0.237,11375
anguished,0.993,49,26,1,1,0.135,0.72,0.307,75
trampoline,0.993,49,26,1,1,0.604,0.69,0.391,75
ghoul,0.993,149,80,1,1,0.26,0.561,0.43,229
beneath,0.991,1523,823,1,1,0.354,0.173,0.233,2346
momentary,0.991,171,92,1,1,0.562,0.271,0.33,263
hollow,0.991,1097,593,1,1,0.3,0.337,0.222,1690
boomerang,0.99,108,58,1,1,0.531,0.625,0.5,166
rhapsody,0.99,276,149,1,1,0.708,0.49,0.46,425
opus,0.989,23,12,1,1,0.458,0.368,0.391,35
arson,0.989,23,12,1,1,0.133,0.904,0.567,35
lager,0.989,47,25,1,1,0.584,0.48,0.353,72
trapping,0.989,106,57,1,1,0.333,0.621,0.491,163
redneck,0.988,117,63,1,1,0.401,0.5,0.348,180
charmer,0.987,34,18,1,1,0.882,0.683,0.782,52
partridge,0.987,34,18,1,1,0.583,0.415,0.25,52
miserable,0.987,16615,9020,1,1,0.062,0.461,0.188,25635
landing,0.987,581,315,1,1,0.552,0.696,0.596,896
priesthood,0.985,56,30,1,1,0.622,0.304,0.649,86
afflicted,0.985,284,154,1,1,0.271,0.5,0.167,438
gullible,0.985,363,197,1,1,0.44,0.442,0.318,560
fame,0.984,1610,876,1,1,0.896,0.755,0.852,2486
canvas,0.984,258,140,1,1,0.719,0.09,0.364,398
radioactive,0.984,89,48,1,1,0.19,0.798,0.741,137
insecurity,0.984,1490,811,1,1,0.094,0.647,0.35,2301
uninspired,0.984,133,72,1,1,0.163,0.243,0.26,205
sea,0.983,6431,3505,1,1,0.833,0.353,0.589,9936
sculpture,0.982,65,35,1,1,0.75,0.346,0.49,100
stardom,0.982,65,35,1,1,0.844,0.786,0.689,100
pernicious,0.982,32,17,1,1,0.229,0.6,0.382,49
vanquish,0.982,21,11,1,1,0.708,0.76,0.804,32
helix,0.982,32,17,1,1,0.521,0.462,0.509,49
strikingly,0.982,21,11,1,1,0.69,0.684,0.811,32
knotted,0.982,21,11,1,1,0.226,0.412,0.294,32
perennial,0.982,32,17,1,1,0.527,0.358,0.5,49
sanctum,0.982,43,23,1,1,0.521,0.438,0.657,66
cobra,0.982,54,29,1,1,0.312,0.712,0.6,83
omen,0.982,76,41,1,1,0.39,0.657,0.583,117
grandiose,0.982,32,17,1,1,0.9,0.682,0.864,49
acrylic,0.982,76,41,1,1,0.582,0.279,0.42,117
blues,0.982,1339,730,1,1,0.469,0.22,0.287,2069
pentagon,0.982,250,136,1,1,0.49,0.636,0.774,386
exquisite,0.981,151,82,1,1,0.892,0.644,0.604,233
album,0.981,11029,6022,1,1,0.635,0.349,0.453,17051
devoid,0.981,345,188,1,1,0.219,0.436,0.3,533
buzzed,0.98,149,81,1,1,0.583,0.549,0.448,230
sup,0.98,255,139,1,1,0.551,0.358,0.385,394
foreplay,0.979,52,28,1,1,0.724,0.627,0.474,80
rocket,0.979,686,375,1,1,0.664,0.824,0.774,1061
margarita,0.979,136,74,1,1,0.75,0.438,0.42,210
imaginary,0.979,1336,731,1,1,0.56,0.424,0.31,2067
feathered,0.979,41,22,1,1,0.438,0.288,0.214,63
shopper,0.979,41,22,1,1,0.646,0.615,0.741,63
smithereens,0.979,41,22,1,1,0.281,0.561,0.409,63
evanescence,0.978,72,39,1,1,0.527,0.519,0.458,111
bass,0.977,515,282,1,1,0.427,0.206,0.268,797
billionaire,0.976,398,218,1,1,0.806,0.667,0.923,616
lifeless,0.976,449,246,1,1,0.042,0.333,0.163,695
fill,0.976,10073,5529,1,1,0.729,0.449,0.637,15602
mixture,0.976,356,195,1,1,0.546,0.36,0.481,551
depressed,0.976,37516,20600,1,1,0.024,0.445,0.136,58116
eighth,0.976,121,66,1,1,0.531,0.226,0.38,187
slowly,0.976,12373,6795,1,1,0.427,0.185,0.295,19168
telegram,0.975,212,116,1,1,0.561,0.542,0.55,328
lofty,0.975,70,38,1,1,0.755,0.306,0.569,108
shaggy,0.975,70,38,1,1,0.51,0.302,0.321,108
itchy,0.975,230,126,1,1,0.334,0.726,0.296,356
prick,0.974,721,396,1,1,0.323,0.764,0.269,1117
potion,0.974,79,43,1,1,0.5,0.4,0.417,122
headmaster,0.974,19,10,1,1,0.604,0.564,0.865,29
flan,0.974,19,10,1,1,0.604,0.304,0.198,29
playtime,0.974,59,32,1,1,0.76,0.596,0.566,91
snitch,0.974,159,87,1,1,0.3,0.598,0.333,246
accessory,0.973,88,48,1,1,0.562,0.292,0.445,136
drift,0.973,985,542,1,1,0.316,0.52,0.375,1527
edition,0.972,957,527,1,1,0.542,0.455,0.564,1484
vibrator,0.972,291,160,1,1,0.479,0.798,0.5,451
sprinkle,0.972,106,58,1,1,0.635,0.404,0.38,164
whimsical,0.971,57,31,1,1,0.449,0.637,0.371,88
cheerfulness,0.971,28,15,1,1,0.969,0.802,0.675,43
disc,0.971,202,111,1,1,0.622,0.41,0.426,313
eccentric,0.971,153,84,1,1,0.531,0.806,0.721,237
toothless,0.97,95,52,1,1,0.312,0.541,0.272,147
epitome,0.97,363,200,1,1,0.51,0.5,0.667,563
guitarist,0.97,66,36,1,1,0.827,0.74,0.549,102
tomato,0.97,372,205,1,1,0.55,0.183,0.275,577
sentimental,0.97,448,247,1,1,0.583,0.378,0.312,695
poignant,0.97,332,183,1,1,0.646,0.444,0.518,515
shimmer,0.969,37,20,1,1,0.745,0.562,0.656,57
dick,0.969,7339,4056,1,1,0.208,0.5,0.462,11395
hurry,0.969,2100,1161,1,1,0.422,0.735,0.481,3261
ephemeral,0.968,55,30,1,1,0.5,0.312,0.377,85
feeder,0.967,73,40,1,1,0.604,0.452,0.713,113
pan,0.967,1237,685,1,1,0.734,0.182,0.364,1922
postcard,0.966,100,55,1,1,0.822,0.292,0.39,155
figment,0.966,109,60,1,1,0.552,0.316,0.533,169
dopamine,0.965,190,105,1,1,0.548,0.469,0.426,295
equivalence,0.964,17,9,1,1,0.663,0.25,0.582,26
irritability,0.964,80,44,1,1,0.146,0.853,0.283,124
armada,0.964,17,9,1,1,0.408,0.74,0.868,26
peasant,0.964,134,74,1,1,0.53,0.275,0.407,208
thyme,0.964,17,9,1,1,0.561,0.255,0.325,26
shelved,0.964,17,9,1,1,0.306,0.166,0.321,26
bodega,0.964,26,14,1,1,0.573,0.307,0.398,40
roadie,0.964,17,9,1,1,0.5,0.566,0.455,26
distilled,0.964,17,9,1,1,0.427,0.573,0.5,26
siphon,0.964,17,9,1,1,0.354,0.333,0.435,26
motif,0.964,35,19,1,1,0.688,0.481,0.527,54
misdemeanor,0.964,17,9,1,1,0.21,0.64,0.364,26
grinder,0.964,62,34,1,1,0.459,0.615,0.561,96
morbidity,0.964,17,9,1,1,0.37,0.63,0.443,26
albatross,0.964,35,19,1,1,0.5,0.445,0.527,54
protagonist,0.963,303,168,1,1,0.765,0.704,0.877,471
bereft,0.963,177,98,1,1,0.229,0.49,0.336,275
musty,0.962,87,48,1,1,0.354,0.367,0.267,135
vacuous,0.962,78,43,1,1,0.354,0.267,0.304,121
tourist,0.961,252,140,1,1,0.745,0.48,0.43,392
impressionable,0.96,94,52,1,1,0.827,0.72,0.645,146
banished,0.96,137,76,1,1,0.052,0.713,0.37,213
rum,0.96,266,148,1,1,0.561,0.377,0.451,414
limp,0.959,171,95,1,1,0.393,0.44,0.172,266
inmate,0.959,76,42,1,1,0.235,0.663,0.398,118
detachment,0.959,187,104,1,1,0.243,0.7,0.443,291
enchanted,0.959,144,80,1,1,0.917,0.633,0.687,224
merchant,0.958,67,37,1,1,0.675,0.5,0.62,104
drab,0.958,33,18,1,1,0.327,0.3,0.242,51
swami,0.958,33,18,1,1,0.51,0.547,0.491,51
spunk,0.958,33,18,1,1,0.438,0.632,0.473,51
splat,0.958,33,18,1,1,0.51,0.433,0.385,51
drunkenness,0.958,33,18,1,1,0.214,0.774,0.336,51
edgy,0.958,754,421,1,1,0.281,0.895,0.306,1175
spree,0.957,260,145,1,1,0.564,0.663,0.474,405
pho,0.957,83,46,1,1,0.541,0.37,0.384,129
uncharted,0.957,108,60,1,1,0.188,0.406,0.413,168
vista,0.956,74,41,1,1,0.698,0.39,0.45,115
satirical,0.956,24,13,1,1,0.323,0.615,0.538,37
snare,0.956,49,27,1,1,0.229,0.85,0.466,76
turntable,0.956,24,13,1,1,0.531,0.455,0.406,37
bunny,0.956,1268,710,1,1,0.74,0.325,0.194,1978
overweight,0.956,397,222,1,1,0.052,0.5,0.389,619
susceptible,0.955,156,87,1,1,0.438,0.449,0.304,243
messy,0.954,2313,1297,1,1,0.26,0.635,0.14,3610
causation,0.954,40,22,1,1,0.562,0.48,0.567,62
muse,0.954,498,279,1,1,0.76,0.36,0.509,777
eighteen,0.954,195,109,1,1,0.523,0.34,0.404,304
railroad,0.954,56,31,1,1,0.591,0.592,0.5,87
fateful,0.954,56,31,1,1,0.29,0.583,0.402,87
relevance,0.953,202,113,1,1,0.71,0.599,0.791,315
rubber,0.953,364,204,1,1,0.46,0.217,0.315,568
notification,0.953,752,422,1,1,0.604,0.461,0.671,1174
pirate,0.952,289,162,1,1,0.156,0.74,0.559,451
girlfriend,0.952,11880,6682,1,1,0.712,0.763,0.604,18562
chauffeur,0.952,31,17,1,1,0.5,0.353,0.471,48
naughty,0.952,703,395,1,1,0.451,0.857,0.371,1098
servitude,0.952,31,17,1,1,0.25,0.49,0.25,48
macaroni,0.952,111,62,1,1,0.816,0.41,0.382,173
cruelly,0.952,47,26,1,1,0.146,0.79,0.471,73
specter,0.952,47,26,1,1,0.265,0.723,0.54,73
vibrant,0.952,303,170,1,1,0.771,0.824,0.782,473
giveaway,0.951,237,133,1,1,0.865,0.618,0.437,370
render,0.951,118,66,1,1,0.541,0.395,0.448,184
glimmer,0.95,219,123,1,1,0.615,0.462,0.427,342
constellation,0.949,77,43,1,1,0.719,0.533,0.775,120
silo,0.949,38,21,1,1,0.4,0.365,0.357,59
cuddled,0.949,956,539,1,1,0.906,0.547,0.567,1495
plough,0.948,100,56,1,1,0.677,0.427,0.458,156
illustration,0.948,208,117,1,1,0.74,0.441,0.64,325
prescribe,0.948,107,60,1,1,0.459,0.55,0.618,167
aching,0.947,868,490,1,1,0.053,0.88,0.348,1358
resembling,0.947,45,25,1,1,0.592,0.25,0.529,70
vitality,0.947,45,25,1,1,0.923,0.565,0.869,70
dippy,0.947,22,12,1,1,0.43,0.402,0.34,34
pebble,0.947,68,38,1,1,0.354,0.353,0.287,106
download,0.946,1150,650,1,1,0.602,0.49,0.503,1800
companionship,0.945,3177,1798,1,1,0.833,0.438,0.792,4975
tractor,0.945,82,46,1,1,0.449,0.58,0.619,128
puppy,0.945,3401,1926,1,1,0.908,0.461,0.324,5327
bohemian,0.945,292,165,1,1,0.622,0.5,0.407,457
meandering,0.943,36,20,1,1,0.427,0.644,0.539,56
expanse,0.943,110,62,1,1,0.594,0.529,0.689,172
platonic,0.943,628,356,1,1,0.49,0.461,0.469,984
turnip,0.943,36,20,1,1,0.561,0.183,0.254,56
sod,0.942,154,87,1,1,0.427,0.383,0.333,241
riddle,0.942,117,66,1,1,0.521,0.583,0.543,183
lighthouse,0.941,284,161,1,1,0.622,0.24,0.51,445
matrimony,0.941,50,28,1,1,0.85,0.637,0.843,78
gal,0.941,1337,760,1,1,0.5,0.469,0.337,2097
curve,0.94,742,422,1,1,0.48,0.375,0.307,1164
dripping,0.94,273,155,1,1,0.302,0.257,0.267,428
twats,0.939,150,85,1,1,0.406,0.588,0.383,235
nintendo,0.939,531,302,1,1,0.802,0.571,0.464,833
idealism,0.939,78,44,1,1,0.635,0.436,0.689,122
dwelling,0.939,378,215,1,1,0.765,0.33,0.481,593
stargazing,0.938,99,56,1,1,0.802,0.461,0.709,155
resentment,0.938,483,275,1,1,0.163,0.745,0.528,758
unending,0.938,269,153,1,1,0.385,0.519,0.454,422
stripper,0.937,197,112,1,1,0.625,0.848,0.453,309
faded,0.937,768,438,1,1,0.302,0.275,0.194,1206
deprivation,0.937,281,160,1,1,0.194,0.61,0.413,441
amalgamation,0.936,20,11,1,1,0.406,0.47,0.531,31
bolster,0.936,62,35,1,1,0.708,0.471,0.569,97
deuce,0.936,27,15,1,1,0.479,0.338,0.425,42
nerdy,0.936,356,203,1,1,0.296,0.255,0.292,559
abstraction,0.936,20,11,1,1,0.469,0.439,0.525,31
airman,0.936,20,11,1,1,0.587,0.716,0.721,31
figurine,0.936,34,19,1,1,0.76,0.283,0.258,53
origami,0.936,27,15,1,1,0.684,0.276,0.294,42
veranda,0.936,20,11,1,1,0.743,0.343,0.439,31
tentacle,0.936,34,19,1,1,0.37,0.559,0.398,53
scruffy,0.936,41,23,1,1,0.194,0.435,0.176,64
sash,0.936,34,19,1,1,0.48,0.298,0.333,53
okra,0.936,20,11,1,1,0.469,0.4,0.362,31
patented,0.936,20,11,1,1,0.571,0.422,0.685,31
dew,0.935,207,118,1,1,0.604,0.225,0.464,325
shin,0.935,186,106,1,1,0.459,0.5,0.231,292
exotic,0.935,172,98,1,1,0.84,0.711,0.727,270
autobiography,0.933,191,109,1,1,0.735,0.284,0.629,300
bang,0.933,2009,1151,1,1,0.265,0.951,0.74,3160
dropout,0.933,74,42,1,1,0.253,0.55,0.481,116
romance,0.932,3122,1791,1,1,0.98,0.682,0.587,4913
orchid,0.931,53,30,1,1,0.84,0.345,0.382,83
maggot,0.931,53,30,1,1,0.235,0.5,0.235,83
deadly,0.931,840,482,1,1,0.143,0.849,0.554,1322
leisurely,0.93,39,22,1,1,0.806,0.25,0.367,61
wee,0.929,1365,785,1,1,0.663,0.452,0.315,2150
boo,0.929,6828,3930,1,1,0.153,0.676,0.309,10758
metamorphosis,0.928,32,18,1,1,0.541,0.571,0.613,50
aquatic,0.928,32,18,1,1,0.677,0.51,0.463,50
graveyard,0.928,329,189,1,1,0.041,0.441,0.272,518
whiskey,0.928,914,526,1,1,0.612,0.706,0.441,1440
undercover,0.928,124,71,1,1,0.388,0.627,0.483,195
monotonous,0.928,91,52,1,1,0.354,0.221,0.4,143
soundtrack,0.927,1073,618,1,1,0.63,0.559,0.518,1691
reminiscent,0.927,84,48,1,1,0.5,0.481,0.611,132
arctic,0.927,318,183,1,1,0.615,0.352,0.546,501
tortuous,0.926,25,14,1,1,0.194,0.755,0.382,39
gluttony,0.926,51,29,1,1,0.5,0.702,0.412,80
discontent,0.926,129,74,1,1,0.24,0.53,0.263,203
absinthe,0.926,25,14,1,1,0.481,0.51,0.462,39
locket,0.926,25,14,1,1,0.615,0.327,0.616,39
rooster,0.926,77,44,1,1,0.459,0.385,0.275,121
wail,0.925,70,40,1,1,0.418,0.724,0.393,110
soothe,0.924,409,236,1,1,0.817,0.194,0.412,645
goose,0.924,300,173,1,1,0.479,0.283,0.265,473
wandering,0.923,1537,889,1,1,0.323,0.471,0.357,2426
intrepid,0.923,18,10,1,1,0.753,0.696,0.637,28
overpowering,0.923,94,54,1,1,0.392,0.779,0.589,148
salamander,0.923,18,10,1,1,0.41,0.362,0.309,28
florist,0.923,37,21,1,1,0.771,0.41,0.388,58
slaughterhouse,0.923,18,10,1,1,0.146,0.794,0.472,28
suave,0.923,37,21,1,1,0.724,0.265,0.269,58
subplot,0.923,18,10,1,1,0.469,0.413,0.446,28
captivating,0.923,94,54,1,1,0.895,0.594,0.816,148
brisket,0.923,18,10,1,1,0.552,0.378,0.222,28
affair,0.922,741,429,1,1,0.52,0.459,0.657,1170
profound,0.922,929,538,1,1,0.755,0.546,0.736,1467
tuning,0.922,294,170,1,1,0.719,0.39,0.635,464
cannibal,0.922,68,39,1,1,0.122,0.824,0.48,107
soppy,0.922,68,39,1,1,0.51,0.355,0.297,107
bebop,0.921,49,28,1,1,0.482,0.49,0.358,77
scorching,0.921,49,28,1,1,0.406,0.635,0.464,77
exodus,0.921,192,111,1,1,0.286,0.663,0.567,303
must,0.92,49335,28635,1,1,0.408,0.382,0.441,77970
topical,0.92,30,17,1,1,0.561,0.34,0.5,47
reef,0.92,30,17,1,1,0.583,0.49,0.456,47
huntress,0.92,30,17,1,1,0.357,0.717,0.765,47
turd,0.92,321,186,1,1,0.24,0.519,0.383,507
immortality,0.92,228,132,1,1,0.688,0.635,0.861,360
tree,0.92,4067,2362,1,1,0.67,0.118,0.442,6429
intimacy,0.92,1643,954,1,1,0.857,0.802,0.558,2597
sideline,0.919,73,42,1,1,0.44,0.382,0.517,115
prisoner,0.919,443,257,1,1,0.071,0.654,0.308,700
numbness,0.919,276,160,1,1,0.306,0.398,0.265,436
mime,0.919,42,24,1,1,0.455,0.235,0.302,66
delirious,0.919,85,49,1,1,0.219,0.774,0.538,134
nihilism,0.918,109,63,1,1,0.367,0.51,0.364,172
dab,0.917,351,204,1,1,0.51,0.337,0.34,555
brass,0.916,126,73,1,1,0.5,0.32,0.49,199
moose,0.916,174,101,1,1,0.648,0.373,0.318,275
unavoidable,0.916,210,122,1,1,0.35,0.58,0.445,332
erectile,0.915,35,20,1,1,0.542,0.796,0.625,55
languish,0.915,35,20,1,1,0.235,0.408,0.382,55
perishing,0.915,23,13,1,1,0.229,0.423,0.148,36
hickey,0.915,47,27,1,1,0.448,0.529,0.345,74
timber,0.915,23,13,1,1,0.332,0.202,0.386,36
toga,0.915,59,34,1,1,0.698,0.393,0.373,93
kinky,0.915,316,184,1,1,0.449,0.558,0.361,500
tale,0.914,939,548,1,1,0.663,0.3,0.336,1487
ghetto,0.913,300,175,1,1,0.302,0.63,0.482,475
hedonism,0.912,40,23,1,1,0.51,0.5,0.608,63
dancer,0.912,496,290,1,1,0.74,0.768,0.545,786
leads,0.911,3238,1897,1,1,0.53,0.471,0.615,5135
briar,0.91,28,16,1,1,0.493,0.375,0.407,44
offset,0.91,195,114,1,1,0.719,0.394,0.704,309
kicker,0.909,120,70,1,1,0.427,0.711,0.614,190
crow,0.909,333,195,1,1,0.224,0.439,0.363,528
lancer,0.909,45,26,1,1,0.417,0.528,0.519,71
stfu,0.909,1729,1015,1,1,0.292,0.5,0.39,2744
stud,0.908,142,83,1,1,0.564,0.531,0.509,225
curved,0.908,285,167,1,1,0.542,0.407,0.337,452
broke,0.908,17716,10410,1,1,0.245,0.59,0.37,28126
acute,0.908,227,133,1,1,0.427,0.652,0.534,360
orgasm,0.907,317,186,1,1,0.844,0.863,0.676,503
staph,0.907,16,9,1,1,0.375,0.48,0.412,25
twerp,0.907,33,19,1,1,0.408,0.443,0.384,52
resin,0.907,16,9,1,1,0.284,0.308,0.4,25
unknowable,0.907,33,19,1,1,0.347,0.54,0.396,52
scoreboard,0.907,16,9,1,1,0.667,0.484,0.472,25
hydrant,0.907,16,9,1,1,0.57,0.413,0.367,25
grouse,0.907,16,9,1,1,0.448,0.401,0.412,25
exuberance,0.907,16,9,1,1,0.698,0.816,0.787,25
criterion,0.907,33,19,1,1,0.396,0.41,0.736,52
mosey,0.907,16,9,1,1,0.521,0.402,0.33,25
loathing,0.906,653,384,1,1,0.083,0.796,0.368,1037
exacerbate,0.906,89,52,1,1,0.323,0.776,0.58,141
snuggles,0.905,403,237,1,1,0.67,0.34,0.287,640
intensify,0.905,55,32,1,1,0.604,0.87,0.737,87
prowl,0.905,55,32,1,1,0.312,0.542,0.396,87
stony,0.905,55,32,1,1,0.356,0.494,0.525,87
golden,0.905,2252,1327,1,1,0.802,0.491,0.609,3579
bard,0.905,94,55,1,1,0.47,0.41,0.439,149
enigma,0.905,94,55,1,1,0.513,0.7,0.5,149
masochist,0.904,77,45,1,1,0.164,0.784,0.353,122
geriatric,0.904,60,35,1,1,0.479,0.247,0.436,95
gnome,0.903,82,48,1,1,0.429,0.479,0.38,130
summons,0.903,82,48,1,1,0.552,0.604,0.598,130
birch,0.903,82,48,1,1,0.562,0.346,0.382,130
prized,0.902,43,25,1,1,0.906,0.53,0.714,68
haggard,0.902,65,38,1,1,0.115,0.51,0.246,103
stunted,0.902,109,64,1,1,0.194,0.472,0.275,173
intercourse,0.902,87,51,1,1,0.551,0.608,0.557,138
maroon,0.902,175,103,1,1,0.469,0.358,0.336,278
sentimentality,0.902,21,12,1,1,0.771,0.548,0.319,33
baldy,0.902,21,12,1,1,0.398,0.385,0.396,33
swordsman,0.902,21,12,1,1,0.395,0.857,0.696,33
visor,0.902,21,12,1,1,0.396,0.49,0.265,33
talons,0.902,21,12,1,1,0.32,0.698,0.525,33
transfixed,0.902,21,12,1,1,0.427,0.66,0.528,33
header,0.902,229,135,1,1,0.56,0.398,0.74,364
particle,0.901,48,28,1,1,0.521,0.265,0.438,76
pillow,0.9,3034,1796,1,1,0.663,0.128,0.195,4830
vicar,0.9,26,15,1,1,0.531,0.37,0.555,41
riff,0.9,134,79,1,1,0.521,0.551,0.343,213
rhythmic,0.9,26,15,1,1,0.714,0.642,0.664,41
cassette,0.9,80,47,1,1,0.49,0.334,0.355,127
missing,0.899,14958,8868,1,1,0.306,0.418,0.222,23826
decrepit,0.899,85,50,1,1,0.156,0.49,0.225,135
resurrection,0.899,203,120,1,1,0.708,0.74,0.759,323
celibacy,0.898,208,123,1,1,0.302,0.276,0.509,331
vagabond,0.898,90,53,1,1,0.384,0.531,0.144,143
prune,0.898,31,18,1,1,0.531,0.311,0.382,49
novel,0.897,1393,827,1,1,0.702,0.352,0.439,2220
nugget,0.897,206,122,1,1,0.602,0.34,0.348,328
seduce,0.897,174,103,1,1,0.462,0.864,0.689,277
seductive,0.897,105,62,1,1,0.771,0.821,0.667,167
eel,0.896,36,21,1,1,0.292,0.564,0.487,57
lumberjack,0.896,36,21,1,1,0.5,0.66,0.726,57
reflex,0.896,189,112,1,1,0.583,0.46,0.538,301
muffin,0.896,152,90,1,1,0.684,0.43,0.306,242
sands,0.896,115,68,1,1,0.646,0.304,0.377,183
sipping,0.896,584,347,1,1,0.469,0.349,0.377,931
column,0.896,278,165,1,1,0.48,0.25,0.67,443
dirt,0.895,1842,1096,1,1,0.112,0.5,0.236,2938
villager,0.895,41,24,1,1,0.71,0.387,0.509,65
outdoor,0.895,308,183,1,1,0.814,0.256,0.447,491
urban,0.895,585,348,1,1,0.561,0.528,0.644,933
gallery,0.894,417,248,1,1,0.659,0.433,0.569,665
narcissism,0.894,281,167,1,1,0.214,0.639,0.54,448
maternity,0.894,187,111,1,1,0.865,0.48,0.622,298
cod,0.894,301,179,1,1,0.51,0.321,0.304,480
glum,0.894,51,30,1,1,0.244,0.337,0.123,81
bootleg,0.894,51,30,1,1,0.357,0.519,0.466,81
silver,0.893,1417,845,1,1,0.684,0.451,0.615,2262
isle,0.893,237,141,1,1,0.667,0.39,0.443,378
drunk,0.893,11662,6958,1,1,0.194,0.8,0.25,18620
proportional,0.893,61,36,1,1,0.729,0.38,0.621,97
solemn,0.893,185,110,1,1,0.708,0.37,0.709,295
extra,0.892,8869,5293,1,1,0.656,0.551,0.745,14162
frank,0.891,1612,963,1,1,0.625,0.358,0.604,2575
peaked,0.891,173,103,1,1,0.677,0.704,0.857,276
premature,0.889,151,90,1,1,0.281,0.416,0.277,241
shepherd,0.889,475,284,1,1,0.656,0.304,0.61,759
exhibition,0.889,226,135,1,1,0.698,0.59,0.531,361
chili,0.888,286,171,1,1,0.592,0.566,0.433,457
gracious,0.887,264,158,1,1,0.918,0.634,0.637,422
infirm,0.887,44,26,1,1,0.115,0.521,0.21,70
romp,0.887,24,14,1,1,0.61,0.64,0.417,38
padre,0.887,59,35,1,1,0.684,0.407,0.647,94
depict,0.887,99,59,1,1,0.663,0.529,0.723,158
frost,0.887,229,137,1,1,0.449,0.455,0.385,366
shilling,0.887,29,17,1,1,0.521,0.342,0.43,46
perm,0.887,34,20,1,1,0.667,0.465,0.741,54
causal,0.887,54,32,1,1,0.562,0.367,0.491,86
nightfall,0.887,54,32,1,1,0.49,0.436,0.426,86
assortment,0.887,29,17,1,1,0.694,0.36,0.526,46
vending,0.887,84,50,1,1,0.417,0.565,0.549,134
transformer,0.887,44,26,1,1,0.582,0.582,0.723,70
baboon,0.887,29,17,1,1,0.357,0.41,0.429,46
fireside,0.887,19,11,1,1,0.684,0.377,0.394,30
dreamer,0.887,389,233,1,1,0.82,0.394,0.455,622
omitted,0.887,24,14,1,1,0.26,0.235,0.211,38
fluorescent,0.887,44,26,1,1,0.602,0.595,0.5,70
closeness,0.887,304,182,1,1,0.796,0.237,0.45,486
drizzle,0.887,44,26,1,1,0.521,0.353,0.319,70
reminiscing,0.887,394,236,1,1,0.688,0.431,0.418,630
insomnia,0.887,1390,834,1,1,0.198,0.611,0.373,2224
adrift,0.886,337,202,1,1,0.398,0.486,0.23,539
guild,0.886,247,148,1,1,0.58,0.459,0.729,395
robotic,0.884,122,73,1,1,0.417,0.602,0.657,195
delude,0.884,122,73,1,1,0.143,0.627,0.353,195
banter,0.884,343,206,1,1,0.594,0.677,0.464,549
planet,0.884,8883,5346,1,1,0.698,0.404,0.832,14229
shelf,0.884,798,480,1,1,0.561,0.202,0.366,1278
prairie,0.884,97,58,1,1,0.673,0.183,0.415,155
saturated,0.884,92,55,1,1,0.474,0.7,0.442,147
summon,0.883,346,208,1,1,0.521,0.56,0.664,554
stardust,0.883,150,90,1,1,0.843,0.41,0.549,240
tenacious,0.883,72,43,1,1,0.724,0.658,0.692,115
lewd,0.882,367,221,1,1,0.188,0.673,0.412,588
turtle,0.882,488,294,1,1,0.291,0.102,0.271,782
pier,0.882,120,72,1,1,0.583,0.279,0.445,192
voyage,0.882,178,107,1,1,0.816,0.714,0.58,285
vanished,0.881,385,232,1,1,0.208,0.566,0.255,617
stagnation,0.881,52,31,1,1,0.276,0.324,0.396,83
discouragement,0.88,191,115,1,1,0.112,0.319,0.206,306
hearth,0.88,90,54,1,1,0.76,0.275,0.536,144
amour,0.88,90,54,1,1,0.865,0.48,0.652,144
lake,0.88,1478,893,1,1,0.694,0.196,0.425,2371
tasteless,0.88,133,80,1,1,0.146,0.196,0.148,213
orphan,0.88,616,372,1,1,0.133,0.388,0.14,988
peacock,0.879,42,25,1,1,0.786,0.449,0.458,67
ineffectual,0.879,42,25,1,1,0.163,0.412,0.2,67
puppet,0.879,680,411,1,1,0.459,0.433,0.298,1091
perverted,0.878,189,114,1,1,0.062,0.918,0.436,303
airhead,0.878,37,22,1,1,0.271,0.481,0.276,59
plum,0.878,70,42,1,1,0.724,0.306,0.17,112
grueling,0.878,70,42,1,1,0.18,0.763,0.704,112
eagle,0.878,283,171,1,1,0.604,0.594,0.679,454
senorita,0.877,32,19,1,1,0.765,0.55,0.5,51
gallant,0.877,32,19,1,1,0.908,0.539,0.679,51
doting,0.877,32,19,1,1,0.888,0.415,0.426,51
allegory,0.877,32,19,1,1,0.615,0.58,0.509,51
rawr,0.876,60,36,1,1,0.457,0.635,0.406,96
anthem,0.875,900,546,1,1,0.78,0.343,0.729,1446
stratosphere,0.875,27,16,1,1,0.604,0.583,0.636,43
wretch,0.875,55,33,1,1,0.04,0.667,0.25,88
deduce,0.875,27,16,1,1,0.49,0.51,0.466,43
mew,0.875,106,64,1,1,0.418,0.481,0.38,170
inferno,0.875,78,47,1,1,0.051,0.857,0.463,125
ensemble,0.874,73,44,1,1,0.697,0.418,0.586,117
drought,0.873,216,131,1,1,0.133,0.353,0.267,347
spy,0.873,433,263,1,1,0.26,0.686,0.53,696
rusty,0.873,188,114,1,1,0.271,0.345,0.231,302
burlesque,0.873,22,13,1,1,0.327,0.615,0.343,35
penetrating,0.873,45,27,1,1,0.469,0.792,0.782,72
luminous,0.873,45,27,1,1,0.918,0.392,0.783,72
stinging,0.873,68,41,1,1,0.26,0.73,0.459,109
wooing,0.873,22,13,1,1,0.74,0.73,0.702,35
catalogue,0.873,68,41,1,1,0.647,0.327,0.533,109
pantheon,0.873,22,13,1,1,0.144,0.41,0.61,35
arid,0.873,22,13,1,1,0.323,0.333,0.379,35
milkman,0.873,22,13,1,1,0.75,0.38,0.304,35
lumpy,0.873,22,13,1,1,0.271,0.378,0.365,35
bushy,0.873,22,13,1,1,0.562,0.321,0.427,35
gloom,0.873,316,192,1,1,0.135,0.404,0.196,508
flirty,0.872,201,122,1,1,0.714,0.721,0.491,323
wiz,0.872,109,66,1,1,0.467,0.545,0.441,175
frontier,0.872,86,52,1,1,0.438,0.55,0.65,138
juicy,0.872,191,116,1,1,0.823,0.529,0.49,307
emit,0.871,40,24,1,1,0.638,0.445,0.51,64
snipe,0.871,40,24,1,1,0.198,0.915,0.491,64
aesthetic,0.871,609,371,1,1,0.708,0.442,0.526,980
fallout,0.87,507,309,1,1,0.428,0.356,0.373,816
goodbye,0.87,4913,2998,1,1,0.24,0.389,0.328,7911
crystalline,0.869,17,10,1,1,0.765,0.235,0.534,27
miser,0.869,17,10,1,1,0.208,0.633,0.311,27
squawk,0.869,17,10,1,1,0.265,0.48,0.245,27
boooo,0.869,35,21,1,1,0.271,0.549,0.255,56
mutt,0.869,53,32,1,1,0.418,0.408,0.387,85
admittance,0.869,17,10,1,1,0.69,0.451,0.598,27
dutiful,0.869,17,10,1,1,0.724,0.245,0.585,27
lubricant,0.869,17,10,1,1,0.656,0.55,0.454,27
zealous,0.869,17,10,1,1,0.292,0.829,0.347,27
goldfish,0.868,241,147,1,1,0.786,0.296,0.317,388
pine,0.867,267,163,1,1,0.583,0.225,0.312,430
motherhood,0.867,548,335,1,1,0.844,0.546,0.667,883
gorilla,0.867,115,70,1,1,0.565,0.72,0.648,185
anguish,0.867,677,414,1,1,0.153,0.792,0.265,1091
pasty,0.867,48,29,1,1,0.479,0.363,0.375,77
synonymous,0.866,252,154,1,1,0.48,0.323,0.4,406
pear,0.866,61,37,1,1,0.677,0.158,0.241,98
rancher,0.866,30,18,1,1,0.51,0.52,0.543,48
infatuated,0.865,136,83,1,1,0.729,0.764,0.417,219
seeker,0.865,485,297,1,1,0.646,0.464,0.553,782
ocean,0.865,3885,2382,1,1,0.823,0.308,0.642,6267
behavior,0.865,4675,2868,1,1,0.594,0.442,0.813,7543
nomadic,0.865,43,26,1,1,0.427,0.519,0.422,69
vintage,0.863,204,125,1,1,0.68,0.39,0.481,329
rift,0.863,108,66,1,1,0.246,0.519,0.289,174
soulful,0.862,129,79,1,1,0.755,0.331,0.5,208
flirtation,0.862,25,15,1,1,0.653,0.719,0.482,40
ferry,0.861,111,68,1,1,0.604,0.509,0.389,179
tackled,0.861,98,60,1,1,0.438,0.612,0.569,158
town,0.86,10740,6618,1,1,0.551,0.299,0.627,17358
crippled,0.86,218,134,1,1,0.035,0.358,0.236,352
lion,0.86,1374,847,1,1,0.532,0.717,0.682,2221
existential,0.859,1612,994,1,1,0.583,0.51,0.638,2606
inactive,0.859,469,289,1,1,0.271,0.167,0.159,758
empire,0.859,950,586,1,1,0.688,0.73,0.944,1536
dime,0.859,404,249,1,1,0.653,0.317,0.345,653
combo,0.859,924,570,1,1,0.698,0.439,0.453,1494
striker,0.859,114,70,1,1,0.5,0.589,0.696,184
orbit,0.858,237,146,1,1,0.561,0.422,0.575,383
precursor,0.858,33,20,1,1,0.58,0.672,0.783,53
rusted,0.858,33,20,1,1,0.286,0.357,0.302,53
melody,0.858,784,484,1,1,0.847,0.434,0.405,1268
haiku,0.857,130,80,1,1,0.583,0.356,0.392,210
rectangle,0.856,20,12,1,1,0.479,0.225,0.438,32
horseback,0.856,20,12,1,1,0.688,0.588,0.566,32
asteroids,0.856,20,12,1,1,0.361,0.694,0.712,32
rowboat,0.856,20,12,1,1,0.455,0.393,0.353,32
fecal,0.856,20,12,1,1,0.255,0.528,0.213,32
mist,0.856,356,220,1,1,0.375,0.194,0.221,576
bathhouse,0.856,20,12,1,1,0.602,0.38,0.459,32
dominatrix,0.856,20,12,1,1,0.39,0.727,0.709,32
inherent,0.855,246,152,1,1,0.562,0.439,0.48,398
garden,0.855,2872,1779,1,1,0.77,0.23,0.456,4651
squid,0.855,120,74,1,1,0.497,0.398,0.357,194
architect,0.855,120,74,1,1,0.776,0.442,0.836,194
searching,0.854,4196,2601,1,1,0.534,0.657,0.466,6797
chilly,0.854,249,154,1,1,0.329,0.459,0.408,403
pokes,0.854,99,61,1,1,0.365,0.48,0.538,160
add,0.854,9800,6078,1,1,0.728,0.49,0.554,15878
depress,0.853,621,385,1,1,0.219,0.635,0.528,1006
schoolyard,0.853,28,17,1,1,0.684,0.529,0.44,45
prawn,0.853,28,17,1,1,0.488,0.324,0.39,45
mage,0.853,123,76,1,1,0.622,0.373,0.453,199
eclipse,0.852,176,109,1,1,0.541,0.469,0.616,285
scurry,0.852,36,22,1,1,0.398,0.647,0.509,58
mineral,0.852,36,22,1,1,0.519,0.287,0.605,58
irony,0.85,1043,649,1,1,0.39,0.587,0.508,1692
elephant,0.85,752,468,1,1,0.531,0.51,0.615,1220
sandbox,0.85,60,37,1,1,0.573,0.274,0.264,97
unemployment,0.85,312,194,1,1,0.094,0.4,0.297,506
metropolitan,0.849,68,42,1,1,0.387,0.408,0.723,110
transient,0.848,100,62,1,1,0.51,0.405,0.43,162
popular,0.848,3636,2268,1,1,0.88,0.676,0.731,5904
dank,0.848,148,92,1,1,0.39,0.381,0.383,240
stanza,0.846,23,14,1,1,0.612,0.343,0.297,37
charred,0.846,23,14,1,1,0.208,0.676,0.373,37
pronto,0.846,63,39,1,1,0.646,0.5,0.468,102
damsel,0.846,63,39,1,1,0.719,0.475,0.4,102
cholesterol,0.846,55,34,1,1,0.198,0.583,0.398,89
troublemaker,0.846,47,29,1,1,0.26,0.9,0.596,76
quasi,0.846,23,14,1,1,0.51,0.343,0.33,37
contagion,0.846,31,19,1,1,0.208,0.63,0.535,50
coon,0.846,63,39,1,1,0.49,0.46,0.4,102
suitor,0.846,47,29,1,1,0.708,0.639,0.546,76
bay,0.846,1179,737,1,1,0.719,0.365,0.569,1916
beep,0.845,234,146,1,1,0.595,0.541,0.304,380
shade,0.845,897,561,1,1,0.388,0.265,0.278,1458
shutup,0.845,130,81,1,1,0.333,0.56,0.491,211
starvation,0.845,221,138,1,1,0.24,0.592,0.284,359
hormonal,0.845,221,138,1,1,0.5,0.62,0.551,359
unproductive,0.844,213,133,1,1,0.1,0.324,0.237,346
rags,0.844,82,51,1,1,0.434,0.309,0.198,133
nothingness,0.844,449,281,1,1,0.204,0.08,0.161,730
lipstick,0.843,420,263,1,1,0.653,0.429,0.306,683
gingerbread,0.843,58,36,1,1,0.597,0.333,0.264,94
realist,0.843,286,179,1,1,0.72,0.572,0.809,465
cute,0.843,18778,11779,1,1,0.92,0.528,0.579,30557
east,0.843,1915,1201,1,1,0.51,0.25,0.317,3116
pout,0.843,262,164,1,1,0.458,0.354,0.202,426
mockingbird,0.842,50,31,1,1,0.513,0.337,0.423,81
librarian,0.842,152,95,1,1,0.625,0.135,0.509,247
abyss,0.842,920,577,1,1,0.353,0.725,0.296,1497
hacker,0.842,128,80,1,1,0.271,0.755,0.74,208
magical,0.841,1789,1124,1,1,0.875,0.651,0.595,2913
priestess,0.841,34,21,1,1,0.531,0.39,0.691,55
rendition,0.841,139,87,1,1,0.417,0.36,0.398,226
matching,0.841,656,412,1,1,0.719,0.735,0.418,1068
crusty,0.84,239,150,1,1,0.625,0.531,0.473,389
amidst,0.839,490,308,1,1,0.48,0.33,0.316,798
spar,0.839,26,16,1,1,0.417,0.438,0.536,42
daemon,0.839,26,16,1,1,0.333,0.49,0.5,42
peach,0.838,410,258,1,1,0.704,0.48,0.272,668
dungeon,0.838,264,166,1,1,0.276,0.608,0.44,430
swagger,0.838,45,28,1,1,0.333,0.731,0.538,73
profile,0.837,2712,1710,1,1,0.689,0.293,0.529,4422
perfection,0.837,828,522,1,1,0.881,0.745,0.934,1350
bingo,0.837,232,146,1,1,0.735,0.667,0.429,378
displaced,0.837,121,76,1,1,0.281,0.472,0.291,197
horse,0.836,1774,1120,1,1,0.635,0.51,0.529,2894
soulless,0.836,284,179,1,1,0.125,0.591,0.4,463
renaissance,0.836,56,35,1,1,0.771,0.67,0.767,91
inhabitant,0.836,18,11,1,1,0.604,0.356,0.519,29
wrecker,0.836,189,119,1,1,0.229,0.716,0.474,308
mogul,0.836,18,11,1,1,0.51,0.652,0.865,29
spectral,0.836,18,11,1,1,0.43,0.667,0.5,29
extravaganza,0.836,18,11,1,1,0.646,0.786,0.906,29
interstellar,0.836,75,47,1,1,0.708,0.702,0.622,122
narrator,0.835,200,126,1,1,0.673,0.43,0.623,326
trio,0.835,287,181,1,1,0.521,0.613,0.473,468
attendant,0.835,143,90,1,1,0.58,0.365,0.519,233
commence,0.835,86,54,1,1,0.76,0.585,0.741,140
brighten,0.835,619,391,1,1,0.76,0.547,0.649,1010
contemplative,0.835,67,42,1,1,0.729,0.308,0.739,109
ninth,0.834,48,30,1,1,0.49,0.212,0.396,78
fortunes,0.834,48,30,1,1,0.824,0.706,0.789,78
dole,0.834,48,30,1,1,0.448,0.402,0.348,78
piano,0.833,1278,809,1,1,0.704,0.343,0.438,2087
stressin,0.833,89,56,1,1,0.146,0.81,0.367,145
jailbreak,0.833,29,18,1,1,0.354,0.629,0.471,47
rook,0.833,29,18,1,1,0.38,0.4,0.51,47
literary,0.833,220,139,1,1,0.719,0.324,0.667,359
nocturnal,0.833,201,127,1,1,0.54,0.5,0.462,328
fleet,0.832,141,89,1,1,0.547,0.43,0.623,230
delight,0.832,466,295,1,1,0.949,0.666,0.647,761
rolling,0.832,2228,1412,1,1,0.51,0.606,0.321,3640
boring,0.832,12185,7726,1,1,0.194,0.217,0.125,19911
bum,0.832,849,538,1,1,0.281,0.451,0.155,1387
characteristic,0.832,81,51,1,1,0.583,0.328,0.538,132
token,0.831,226,143,1,1,0.51,0.418,0.414,369
uneducated,0.831,412,261,1,1,0.177,0.35,0.246,673
vanishing,0.831,103,65,1,1,0.292,0.55,0.322,168
lantern,0.831,103,65,1,1,0.622,0.25,0.243,168
betrayal,0.831,1168,741,1,1,0.083,0.719,0.418,1909
pasture,0.831,62,39,1,1,0.688,0.145,0.17,101
orchard,0.831,62,39,1,1,0.76,0.269,0.333,101
poetic,0.83,410,260,1,1,0.86,0.269,0.548,670
mailbox,0.829,128,81,1,1,0.573,0.222,0.404,209
banishment,0.828,21,13,1,1,0.16,0.775,0.298,34
hilarity,0.828,43,27,1,1,0.745,0.48,0.575,70
crafty,0.828,43,27,1,1,0.589,0.679,0.783,70
lice,0.828,76,48,1,1,0.133,0.5,0.194,124
conversational,0.828,65,41,1,1,0.719,0.431,0.596,106
flabby,0.828,21,13,1,1,0.292,0.358,0.25,34
casino,0.828,175,111,1,1,0.542,0.684,0.568,286
lockup,0.828,21,13,1,1,0.24,0.602,0.617,34
largo,0.828,32,20,1,1,0.521,0.48,0.517,52
juniper,0.828,21,13,1,1,0.583,0.327,0.352,34
crepe,0.828,21,13,1,1,0.562,0.224,0.349,34
blight,0.828,43,27,1,1,0.271,0.771,0.429,70
glittering,0.828,54,34,1,1,0.86,0.588,0.818,88
aesthetics,0.827,134,85,1,1,0.847,0.327,0.549,219
crumb,0.827,79,50,1,1,0.417,0.255,0.216,129
pioneer,0.826,137,87,1,1,0.796,0.618,0.802,224
heroine,0.826,195,124,1,1,0.729,0.755,0.833,319
flowers,0.826,2795,1783,1,1,0.875,0.324,0.33,4578
chick,0.825,1536,980,1,1,0.771,0.602,0.387,2516
dispersed,0.825,46,29,1,1,0.344,0.49,0.274,75
impending,0.825,281,179,1,1,0.48,0.735,0.752,460
evolutionary,0.825,82,52,1,1,0.796,0.673,0.825,134
fountain,0.825,190,121,1,1,0.704,0.292,0.559,311
cloning,0.824,35,22,1,1,0.216,0.696,0.679,57
koala,0.824,71,45,1,1,0.608,0.21,0.311,116
mistress,0.824,431,275,1,1,0.63,0.796,0.694,706
specimen,0.823,74,47,1,1,0.531,0.444,0.568,121
holographic,0.823,24,15,1,1,0.51,0.471,0.555,39
recruits,0.823,49,31,1,1,0.396,0.653,0.593,80
incomplete,0.822,711,455,1,1,0.153,0.37,0.205,1166
denominator,0.822,88,56,1,1,0.45,0.41,0.613,144
mixed,0.822,2266,1451,1,1,0.51,0.346,0.444,3717
blossom,0.822,305,195,1,1,0.792,0.275,0.309,500
veiled,0.822,63,40,1,1,0.37,0.317,0.324,103
copycat,0.821,38,24,1,1,0.449,0.58,0.443,62
gargoyle,0.821,38,24,1,1,0.286,0.536,0.525,62
helium,0.821,38,24,1,1,0.49,0.316,0.304,62
mound,0.82,52,33,1,1,0.52,0.481,0.509,85
classics,0.82,253,162,1,1,0.75,0.333,0.51,415
champagne,0.82,471,302,1,1,0.76,0.6,0.454,773
empress,0.819,108,69,1,1,0.716,0.669,0.855,177
pigeon,0.819,178,114,1,1,0.688,0.224,0.276,292
night,0.819,116282,74724,1,1,0.598,0.396,0.404,191006
withering,0.818,83,53,1,1,0.271,0.65,0.345,136
breeding,0.818,195,125,1,1,0.667,0.481,0.61,320
alpine,0.818,27,17,1,1,0.594,0.337,0.474,44
vase,0.818,69,44,1,1,0.638,0.225,0.215,113
sate,0.818,41,26,1,1,0.667,0.4,0.472,67
zenith,0.818,27,17,1,1,0.582,0.387,0.589,44
gray,0.818,1453,934,1,1,0.335,0.153,0.189,2387
chubby,0.818,324,208,1,1,0.531,0.427,0.304,532
decrease,0.817,271,174,1,1,0.125,0.36,0.267,445
litter,0.817,330,212,1,1,0.255,0.551,0.11,542
sentient,0.817,232,149,1,1,0.583,0.417,0.363,381
manifestation,0.816,179,115,1,1,0.583,0.75,0.655,294
estate,0.815,579,373,1,1,0.653,0.385,0.647,952
memoir,0.815,275,177,1,1,0.75,0.242,0.553,452
howl,0.815,275,177,1,1,0.357,0.646,0.407,452
snap,0.815,3027,1952,1,1,0.344,0.517,0.352,4979
apex,0.815,492,317,1,1,0.57,0.433,0.418,809
cleavage,0.815,61,39,1,1,0.542,0.602,0.454,100
rickety,0.815,30,19,1,1,0.224,0.402,0.241,49
levitate,0.815,30,19,1,1,0.561,0.598,0.551,49
neglected,0.814,1139,735,1,1,0.271,0.385,0.16,1874
excellence,0.814,191,123,1,1,0.958,0.62,0.907,314
snowy,0.813,225,145,1,1,0.656,0.304,0.357,370
mega,0.813,516,333,1,1,0.724,0.538,0.723,849
craving,0.813,1915,1237,1,1,0.51,0.755,0.636,3152
grenade,0.812,67,43,1,1,0.281,0.777,0.694,110
inscription,0.812,16,10,1,1,0.592,0.422,0.542,26
blacksmith,0.812,16,10,1,1,0.48,0.531,0.702,26
mailman,0.812,50,32,1,1,0.659,0.418,0.462,82
barnacle,0.812,16,10,1,1,0.408,0.337,0.457,26
flipper,0.812,16,10,1,1,0.677,0.42,0.415,26
chummy,0.812,16,10,1,1,0.76,0.42,0.61,26
inexplicable,0.812,135,87,1,1,0.224,0.635,0.443,222
flame,0.811,980,634,1,1,0.448,0.574,0.615,1614
mushroom,0.811,189,122,1,1,0.49,0.274,0.269,311
havoc,0.811,192,124,1,1,0.163,0.769,0.535,316
peculiar,0.81,212,137,1,1,0.6,0.491,0.564,349
restock,0.81,53,34,1,1,0.51,0.538,0.645,87
impenetrable,0.81,53,34,1,1,0.531,0.577,0.839,87
heaviness,0.81,144,93,1,1,0.219,0.549,0.318,237
demented,0.81,218,141,1,1,0.088,0.787,0.309,359
arty,0.809,36,23,1,1,0.49,0.422,0.388,59
allure,0.808,56,36,1,1,0.804,0.585,0.686,92
jackpot,0.808,56,36,1,1,0.95,0.75,0.786,92
stupor,0.808,56,36,1,1,0.323,0.59,0.33,92
overshadow,0.808,56,36,1,1,0.333,0.549,0.654,92
inability,0.808,1279,830,1,1,0.15,0.529,0.25,2109
overhead,0.808,133,86,1,1,0.344,0.7,0.538,219
literature,0.808,535,347,1,1,0.708,0.25,0.598,882
charm,0.808,561,364,1,1,0.833,0.363,0.649,925
lover,0.808,4427,2875,1,1,0.881,0.816,0.75,7302
widowed,0.808,310,201,1,1,0.205,0.439,0.333,511
lonesome,0.808,1289,837,1,1,0.281,0.213,0.336,2126
daddy,0.807,5167,3358,1,1,0.795,0.4,0.736,8525
crescendo,0.807,19,12,1,1,0.76,0.575,0.594,31
unmistakable,0.807,19,12,1,1,0.602,0.571,0.765,31
brutish,0.807,19,12,1,1,0.27,0.837,0.588,31
clamp,0.807,19,12,1,1,0.541,0.388,0.454,31
tycoon,0.807,19,12,1,1,0.682,0.596,0.867,31
metropolis,0.807,39,25,1,1,0.656,0.625,0.779,64
superlative,0.807,19,12,1,1,0.714,0.566,0.737,31
agonizing,0.807,242,157,1,1,0.083,0.8,0.34,399
intersection,0.806,122,79,1,1,0.344,0.541,0.658,201
rapper,0.806,497,323,1,1,0.55,0.755,0.482,820
gangster,0.806,125,81,1,1,0.292,0.833,0.655,206
retail,0.806,592,385,1,1,0.51,0.353,0.411,977
alight,0.805,42,27,1,1,0.667,0.657,0.605,69
vacant,0.805,240,156,1,1,0.578,0.22,0.464,396
december,0.805,3836,2499,1,1,0.74,0.54,0.464,6335
drifted,0.805,243,158,1,1,0.312,0.542,0.31,401
podium,0.805,88,57,1,1,0.627,0.365,0.702,145
raptor,0.804,45,29,1,1,0.27,0.773,0.612,74
advertisement,0.804,91,59,1,1,0.6,0.566,0.539,150
kisser,0.804,45,29,1,1,0.844,0.682,0.618,74
trainee,0.804,229,149,1,1,0.627,0.408,0.352,378
regularity,0.804,22,14,1,1,0.663,0.337,0.585,36
hamster,0.803,442,288,1,1,0.52,0.394,0.349,730
monument,0.803,94,61,1,1,0.833,0.404,0.811,155
dismal,0.803,120,78,1,1,0.194,0.45,0.192,198
delinquent,0.802,48,31,1,1,0.051,0.904,0.5,79
retard,0.802,276,180,1,1,0.194,0.347,0.222,456
everlasting,0.801,435,284,1,1,0.74,0.413,0.809,719
trees,0.801,2003,1309,1,1,0.653,0.137,0.537,3312
kangaroo,0.801,51,33,1,1,0.716,0.333,0.301,84
colorful,0.801,337,220,1,1,0.85,0.52,0.519,557
loudness,0.801,51,33,1,1,0.35,0.582,0.62,84
snazzy,0.801,25,16,1,1,0.735,0.37,0.66,41
scribe,0.801,25,16,1,1,0.541,0.264,0.491,41
shard,0.801,25,16,1,1,0.388,0.407,0.426,41
poor,0.801,18237,11929,1,1,0.156,0.358,0.087,30166
frequency,0.801,427,279,1,1,0.561,0.557,0.537,706
hospitality,0.8,135,88,1,1,0.865,0.333,0.725,223
relieve,0.8,653,427,1,1,0.813,0.183,0.536,1080
farmhouse,0.8,54,35,1,1,0.69,0.33,0.444,89
advent,0.8,164,107,1,1,0.665,0.56,0.627,271
corona,0.8,54,35,1,1,0.818,0.439,0.745,89
finesse,0.8,112,73,1,1,0.74,0.387,0.412,185
obscure,0.799,315,206,1,1,0.37,0.551,0.278,521
glutton,0.799,28,18,1,1,0.438,0.519,0.384,46
salve,0.799,57,37,1,1,0.612,0.39,0.5,94
picnic,0.799,234,153,1,1,0.625,0.47,0.375,387
envious,0.799,449,294,1,1,0.11,0.754,0.341,743
chirp,0.799,89,58,1,1,0.469,0.602,0.365,147
cucumber,0.798,121,79,1,1,0.49,0.235,0.237,200
visit,0.798,8648,5674,1,1,0.771,0.443,0.445,14322
delicacy,0.798,31,20,1,1,0.812,0.279,0.336,51
paperback,0.798,63,41,1,1,0.633,0.269,0.314,104
calico,0.798,31,20,1,1,0.406,0.338,0.491,51
spike,0.797,293,192,1,1,0.382,0.51,0.408,485
bribe,0.797,130,85,1,1,0.112,0.69,0.472,215
girl,0.797,72573,47647,1,1,0.74,0.572,0.443,120220
wretched,0.797,299,196,1,1,0.135,0.56,0.19,495
preservation,0.797,168,110,1,1,0.667,0.51,0.686,278
descriptive,0.797,101,66,1,1,0.667,0.352,0.57,167
questionnaire,0.796,34,22,1,1,0.385,0.327,0.606,56
cad,0.796,34,22,1,1,0.447,0.406,0.404,56
elemental,0.796,34,22,1,1,0.627,0.306,0.711,56
entangled,0.796,72,47,1,1,0.319,0.578,0.357,119
superstar,0.796,291,191,1,1,0.885,0.86,0.88,482
broken,0.795,22256,14640,1,1,0.062,0.5,0.293,36896
beholder,0.795,37,24,1,1,0.714,0.491,0.52,61
flattery,0.795,37,24,1,1,0.47,0.575,0.404,61
cleric,0.795,37,24,1,1,0.521,0.324,0.589,61
cheerful,0.795,686,451,1,1,0.99,0.72,0.696,1137
bask,0.795,192,126,1,1,0.76,0.33,0.381,318
fleabag,0.795,78,51,1,1,0.271,0.557,0.348,129
workaholic,0.794,160,105,1,1,0.344,0.657,0.557,265
fool,0.794,6510,4286,1,1,0.16,0.56,0.148,10796
rain,0.794,8532,5619,1,1,0.542,0.388,0.33,14151
unemployed,0.794,764,503,1,1,0.094,0.481,0.23,1267
seven,0.793,2188,1442,1,1,0.672,0.265,0.373,3630
stroll,0.793,269,177,1,1,0.745,0.415,0.444,446
airplane,0.793,454,299,1,1,0.719,0.702,0.708,753
oldies,0.793,137,90,1,1,0.438,0.3,0.412,227
measurement,0.792,46,30,1,1,0.622,0.418,0.491,76
seducing,0.792,46,30,1,1,0.569,0.794,0.708,76
suffocating,0.792,1195,788,1,1,0.133,0.774,0.429,1983
iconic,0.792,725,478,1,1,0.583,0.537,0.7,1203
destitute,0.792,146,96,1,1,0.13,0.451,0.222,242
devour,0.792,205,135,1,1,0.344,0.888,0.574,340
sub,0.791,1209,798,1,1,0.51,0.37,0.312,2007
cave,0.791,1975,1304,1,1,0.459,0.333,0.38,3279
weave,0.791,111,73,1,1,0.604,0.265,0.172,184
rhino,0.791,55,36,1,1,0.531,0.549,0.555,91
breathless,0.79,117,77,1,1,0.323,0.49,0.222,194
homecoming,0.79,312,206,1,1,0.76,0.413,0.472,518
charity,0.79,1071,708,1,1,0.92,0.284,0.551,1779
striking,0.79,253,167,1,1,0.357,0.827,0.657,420
bout,0.79,10278,6799,1,1,0.208,0.808,0.679,17077
orphaned,0.789,132,87,1,1,0.062,0.43,0.228,219
drum,0.788,393,260,1,1,0.615,0.679,0.339,653
muses,0.788,79,52,1,1,0.714,0.434,0.571,131
tortoise,0.788,82,54,1,1,0.673,0.078,0.25,136
sixty,0.787,91,60,1,1,0.694,0.24,0.433,151
prom,0.787,1106,733,1,1,0.527,0.44,0.404,1839
single,0.787,71278,47280,1,1,0.291,0.354,0.259,118558
admirer,0.787,100,66,1,1,0.796,0.72,0.65,166
trap,0.787,1470,975,1,1,0.104,0.61,0.391,2445
rescue,0.786,1732,1150,1,1,0.806,0.926,0.85,2882
fluff,0.785,336,223,1,1,0.52,0.264,0.172,559
wholesome,0.784,745,495,1,1,0.888,0.423,0.754,1240
shades,0.784,423,281,1,1,0.49,0.3,0.38,704
dangerously,0.784,244,162,1,1,0.082,0.93,0.564,406
complain,0.784,6644,4421,1,1,0.143,0.682,0.36,11065
rose,0.783,2586,1721,1,1,0.865,0.276,0.386,4307
deafening,0.783,418,278,1,1,0.281,0.835,0.482,696
restless,0.782,799,532,1,1,0.219,0.81,0.304,1331
sledge,0.782,17,11,1,1,0.646,0.5,0.361,28
procession,0.782,29,19,1,1,0.656,0.539,0.643,48
lustrous,0.782,17,11,1,1,0.771,0.606,0.598,28
jest,0.782,110,73,1,1,0.52,0.736,0.222,183
minutiae,0.782,17,11,1,1,0.323,0.257,0.316,28
locality,0.782,20,13,1,1,0.582,0.336,0.464,33
concoction,0.782,32,21,1,1,0.448,0.459,0.417,53
parry,0.782,17,11,1,1,0.51,0.404,0.436,28
crossword,0.782,29,19,1,1,0.611,0.423,0.455,48
dipper,0.782,26,17,1,1,0.548,0.361,0.348,43
consuming,0.782,767,511,1,1,0.573,0.541,0.536,1278
herald,0.782,47,31,1,1,0.643,0.382,0.5,78
mailing,0.782,47,31,1,1,0.688,0.324,0.375,78
footloose,0.782,17,11,1,1,0.549,0.595,0.447,28
patchwork,0.782,20,13,1,1,0.5,0.26,0.325,33
rocker,0.782,74,49,1,1,0.615,0.704,0.625,123
slammer,0.782,26,17,1,1,0.417,0.565,0.391,43
corvette,0.782,17,11,1,1,0.551,0.52,0.598,28
orangutan,0.782,29,19,1,1,0.43,0.56,0.471,48
unnamed,0.782,65,43,1,1,0.316,0.189,0.284,108
kelp,0.782,17,11,1,1,0.479,0.264,0.213,28
buoy,0.782,29,19,1,1,0.562,0.28,0.284,48
antithetical,0.782,17,11,1,1,0.271,0.509,0.358,28
overture,0.782,20,13,1,1,0.49,0.402,0.491,33
uptight,0.782,89,59,1,1,0.184,0.716,0.333,148
gringo,0.782,20,13,1,1,0.54,0.452,0.51,33
hub,0.782,323,215,1,1,0.479,0.399,0.433,538
morose,0.782,47,31,1,1,0.24,0.663,0.264,78
dearth,0.782,38,25,1,1,0.156,0.539,0.255,63
souvenir,0.782,29,19,1,1,0.844,0.311,0.466,48
transistor,0.782,17,11,1,1,0.48,0.48,0.444,28
flute,0.782,86,57,1,1,0.635,0.33,0.363,143
hush,0.782,371,247,1,1,0.471,0.231,0.312,618
flexibility,0.782,98,65,1,1,0.867,0.402,0.472,163
blab,0.782,17,11,1,1,0.438,0.425,0.353,28
pub,0.781,831,554,1,1,0.592,0.637,0.446,1385
aging,0.781,642,428,1,1,0.214,0.255,0.284,1070
rooftop,0.78,273,182,1,1,0.571,0.471,0.461,455
pink,0.78,2014,1345,1,1,0.806,0.269,0.471,3359
lemonade,0.78,219,146,1,1,0.661,0.287,0.412,365
moth,0.779,204,136,1,1,0.323,0.35,0.196,340
refugee,0.779,340,227,1,1,0.379,0.607,0.327,567
cow,0.778,739,494,1,1,0.449,0.23,0.3,1233
incurable,0.778,138,92,1,1,0.104,0.667,0.255,230
moon,0.778,11246,7524,1,1,0.673,0.233,0.547,18770
doll,0.778,1211,810,1,1,0.729,0.321,0.33,2021
icy,0.778,235,157,1,1,0.684,0.375,0.345,392
visionary,0.777,111,74,1,1,0.823,0.565,0.791,185
inhabit,0.777,111,74,1,1,0.656,0.378,0.556,185
bench,0.777,1068,715,1,1,0.571,0.289,0.544,1783
fling,0.777,208,139,1,1,0.439,0.696,0.534,347
absence,0.777,1905,1276,1,1,0.153,0.235,0.266,3181
interact,0.776,4414,2958,1,1,0.822,0.69,0.759,7372
account,0.776,10061,6743,1,1,0.531,0.347,0.472,16804
warmth,0.776,2407,1613,1,1,0.878,0.307,0.602,4020
embodiment,0.776,184,123,1,1,0.562,0.69,0.663,307
amid,0.776,175,117,1,1,0.51,0.34,0.256,292
reconnect,0.776,436,292,1,1,0.63,0.548,0.667,728
pessimism,0.776,81,54,1,1,0.083,0.484,0.264,135
whoo,0.776,81,54,1,1,0.531,0.578,0.311,135
savage,0.775,674,452,1,1,0.204,0.931,0.605,1126
mire,0.775,72,48,1,1,0.344,0.376,0.298,120
poodle,0.774,66,44,1,1,0.5,0.413,0.301,110
senile,0.774,130,87,1,1,0.28,0.211,0.305,217
clown,0.774,1551,1042,1,1,0.65,0.598,0.3,2593
exhilarating,0.774,121,81,1,1,0.917,0.823,0.81,202
hangry,0.774,60,40,1,1,0.219,0.794,0.279,100
gravel,0.773,57,38,1,1,0.39,0.37,0.332,95
tequila,0.773,347,233,1,1,0.612,0.71,0.536,580
empty,0.773,24968,16790,1,1,0.188,0.183,0.081,41758
soapbox,0.773,54,36,1,1,0.5,0.415,0.393,90
booze,0.773,485,326,1,1,0.265,0.745,0.431,811
grader,0.772,158,106,1,1,0.583,0.317,0.42,264
semen,0.772,51,34,1,1,0.5,0.755,0.471,85
secondhand,0.772,103,69,1,1,0.194,0.389,0.283,172
atonement,0.772,51,34,1,1,0.55,0.602,0.683,85
mighty,0.772,902,607,1,1,0.855,0.837,0.936,1509
toil,0.772,48,32,1,1,0.558,0.51,0.583,80
purr,0.772,97,65,1,1,0.604,0.46,0.302,162
sheltered,0.771,192,129,1,1,0.59,0.377,0.717,321
christmastime,0.771,45,30,1,1,0.837,0.588,0.515,75
abode,0.77,85,57,1,1,0.62,0.302,0.5,142
overcast,0.77,42,28,1,1,0.417,0.25,0.475,70
assassin,0.77,214,144,1,1,0.073,0.933,0.632,358
womanizer,0.77,42,28,1,1,0.281,0.8,0.471,70
harem,0.77,125,84,1,1,0.521,0.578,0.582,209
overcrowded,0.77,82,55,1,1,0.292,0.52,0.491,137
steer,0.769,267,180,1,1,0.469,0.49,0.527,447
hateful,0.769,1709,1154,1,1,0.071,0.819,0.43,2863
cushion,0.769,113,76,1,1,0.653,0.221,0.292,189
dynamite,0.768,70,47,1,1,0.344,0.86,0.783,117
confuse,0.768,1055,713,1,1,0.1,0.58,0.27,1768
boyfriend,0.768,18564,12552,1,1,0.781,0.604,0.547,31116
holiness,0.767,101,68,1,1,0.86,0.264,0.742,169
grovel,0.767,33,22,1,1,0.36,0.5,0.414,55
retort,0.767,33,22,1,1,0.417,0.52,0.481,55
mysterious,0.767,698,472,1,1,0.448,0.699,0.455,1170
panda,0.767,423,286,1,1,0.646,0.194,0.406,709
brimming,0.767,64,43,1,1,0.656,0.69,0.758,107
contrast,0.766,312,211,1,1,0.48,0.406,0.52,523
snowflake,0.766,312,211,1,1,0.748,0.192,0.26,523
chat,0.766,12143,8225,1,1,0.729,0.4,0.346,20368
bluebird,0.766,30,20,1,1,0.573,0.35,0.45,50
feigned,0.766,30,20,1,1,0.173,0.602,0.333,50
tarmac,0.766,30,20,1,1,0.357,0.302,0.398,50
sonnet,0.766,30,20,1,1,0.718,0.294,0.404,50
symbiotic,0.766,30,20,1,1,0.832,0.425,0.406,50
sum,0.766,2197,1488,1,1,0.792,0.34,0.42,3685
descent,0.765,145,98,1,1,0.3,0.402,0.158,243
structural,0.765,86,58,1,1,0.582,0.425,0.69,144
weathered,0.764,55,37,1,1,0.422,0.491,0.537,92
mortar,0.764,27,18,1,1,0.333,0.627,0.562,45
aaaaaaah,0.764,27,18,1,1,0.479,0.606,0.291,45
plowing,0.764,27,18,1,1,0.562,0.531,0.518,45
palace,0.764,475,322,1,1,0.878,0.51,0.804,797
emerald,0.764,111,75,1,1,0.74,0.363,0.726,186
virginity,0.764,251,170,1,1,0.691,0.676,0.576,421
bloom,0.764,693,470,1,1,0.816,0.453,0.587,1163
blowjob,0.763,214,145,1,1,0.46,0.784,0.387,359
lunar,0.763,133,90,1,1,0.562,0.296,0.427,223
mating,0.763,133,90,1,1,0.755,0.84,0.759,223
diner,0.763,239,162,1,1,0.643,0.302,0.538,401
dopey,0.763,52,35,1,1,0.32,0.38,0.365,87
narrow,0.763,548,372,1,1,0.26,0.368,0.356,920
prose,0.763,102,69,1,1,0.542,0.274,0.436,171
xoxo,0.762,1666,1132,1,1,0.729,0.52,0.4,2798
meek,0.762,127,86,1,1,0.531,0.15,0.198,213
whore,0.762,1420,965,1,1,0.135,0.88,0.333,2385
grey,0.762,1758,1195,1,1,0.347,0.14,0.295,2953
quail,0.762,24,16,1,1,0.5,0.318,0.287,40
merriment,0.762,24,16,1,1,0.948,0.721,0.632,40
maniacal,0.762,24,16,1,1,0.2,0.848,0.5,40
menagerie,0.762,24,16,1,1,0.573,0.48,0.538,40
lovelife,0.762,99,67,1,1,0.837,0.61,0.592,166
facade,0.762,399,271,1,1,0.52,0.333,0.518,670
anger,0.762,6311,4293,1,1,0.167,0.865,0.657,10604
stormy,0.761,481,327,1,1,0.146,0.87,0.562,808
dickhead,0.761,312,212,1,1,0.115,0.608,0.284,524
balloon,0.761,259,176,1,1,0.729,0.245,0.315,435
wrought,0.761,46,31,1,1,0.322,0.559,0.681,77
notoriety,0.761,46,31,1,1,0.552,0.633,0.769,77
sumo,0.761,46,31,1,1,0.48,0.394,0.564,77
malaria,0.761,46,31,1,1,0.125,0.653,0.304,77
dreamland,0.761,46,31,1,1,0.844,0.471,0.566,77
petite,0.76,112,76,1,1,0.51,0.354,0.245,188
exception,0.76,991,675,1,1,0.469,0.6,0.544,1666
whittle,0.759,21,14,1,1,0.347,0.451,0.427,35
farmland,0.759,21,14,1,1,0.729,0.363,0.509,35
eventual,0.759,131,89,1,1,0.633,0.459,0.413,220
sequestered,0.759,21,14,1,1,0.16,0.863,0.427,35
squander,0.759,21,14,1,1,0.24,0.755,0.529,35
spurred,0.759,21,14,1,1,0.562,0.684,0.472,35
dislocation,0.759,21,14,1,1,0.229,0.565,0.373,35
loyal,0.759,2973,2027,1,1,0.896,0.265,0.657,5000
pumpkin,0.759,496,338,1,1,0.539,0.177,0.355,834
violin,0.759,213,145,1,1,0.823,0.396,0.389,358
vertical,0.758,62,42,1,1,0.52,0.387,0.492,104
modern,0.758,1905,1300,1,1,0.855,0.423,0.691,3205
ambitious,0.757,283,193,1,1,0.484,0.821,0.717,476
inferiority,0.757,141,96,1,1,0.177,0.43,0.205,237
sunset,0.757,1173,801,1,1,0.875,0.231,0.298,1974
castle,0.757,1565,1069,1,1,0.68,0.396,0.718,2634
wilt,0.757,59,40,1,1,0.226,0.354,0.312,99
cuckoo,0.757,59,40,1,1,0.42,0.459,0.284,99
glitter,0.756,306,209,1,1,0.814,0.75,0.762,515
extraordinaire,0.756,18,12,1,1,0.847,0.864,0.898,30
characterize,0.756,18,12,1,1,0.729,0.471,0.735,30
thesaurus,0.756,18,12,1,1,0.52,0.48,0.509,30
nucleus,0.756,18,12,1,1,0.529,0.296,0.667,30
unpleasantness,0.756,18,12,1,1,0.062,0.724,0.264,30
gourd,0.756,18,12,1,1,0.427,0.271,0.289,30
woolly,0.756,18,12,1,1,0.531,0.398,0.32,30
coupling,0.756,37,25,1,1,0.594,0.479,0.555,62
tribute,0.755,608,416,1,1,0.684,0.573,0.7,1024
hulk,0.755,291,199,1,1,0.46,0.74,0.75,490
chit,0.755,180,123,1,1,0.49,0.352,0.321,303
monk,0.754,215,147,1,1,0.472,0.208,0.439,362
vault,0.754,142,97,1,1,0.49,0.378,0.644,239
festive,0.754,819,561,1,1,0.854,0.74,0.764,1380
weasel,0.754,123,84,1,1,0.408,0.317,0.337,207
ecstasy,0.754,123,84,1,1,0.796,0.922,0.655,207
recreation,0.754,69,47,1,1,0.909,0.632,0.66,116
endearing,0.754,139,95,1,1,0.663,0.434,0.604,234
emphasize,0.754,279,191,1,1,0.51,0.605,0.769,470
observatory,0.754,34,23,1,1,0.643,0.324,0.731,57
jovial,0.754,34,23,1,1,0.823,0.46,0.526,57
tearful,0.753,136,93,1,1,0.208,0.5,0.184,229
strip,0.753,630,432,1,1,0.427,0.5,0.436,1062
snuggling,0.753,235,161,1,1,0.683,0.585,0.373,396
bio,0.752,1625,1116,1,1,0.612,0.225,0.49,2741
displace,0.751,15,10,1,1,0.424,0.541,0.454,25
christen,0.751,15,10,1,1,0.673,0.356,0.588,25
stimulant,0.751,15,10,1,1,0.441,0.794,0.745,25
astronomer,0.751,15,10,1,1,0.75,0.509,0.735,25
pageant,0.751,47,32,1,1,0.719,0.667,0.651,79
loudmouth,0.751,15,10,1,1,0.337,0.615,0.456,25
accumulation,0.751,31,21,1,1,0.479,0.527,0.6,52
kissy,0.751,31,21,1,1,0.874,0.684,0.402,52
rope,0.751,623,428,1,1,0.385,0.28,0.345,1051
cavalry,0.751,31,21,1,1,0.667,0.727,0.794,52
impersonator,0.751,15,10,1,1,0.469,0.586,0.406,25
indirect,0.751,127,87,1,1,0.385,0.402,0.33,214
named,0.75,2428,1670,1,1,0.562,0.396,0.565,4098
stereotype,0.75,281,193,1,1,0.151,0.422,0.612,474
baby,0.75,64893,44673,1,1,0.837,0.365,0.455,109566
pistol,0.75,121,83,1,1,0.17,0.9,0.677,204
guitar,0.749,1448,997,1,1,0.844,0.542,0.469,2445
lack,0.749,7742,5334,1,1,0.25,0.365,0.242,13076
sticky,0.749,282,194,1,1,0.385,0.569,0.292,476
occupation,0.749,221,152,1,1,0.562,0.47,0.692,373
misty,0.748,205,141,1,1,0.427,0.451,0.278,346
pouting,0.748,160,110,1,1,0.263,0.471,0.27,270
bomber,0.748,115,79,1,1,0.125,0.837,0.81,194
nightlife,0.748,28,19,1,1,0.542,0.783,0.51,47
epitaph,0.748,28,19,1,1,0.276,0.323,0.442,47
smitten,0.748,57,39,1,1,0.153,0.76,0.204,96
ostrich,0.748,28,19,1,1,0.592,0.382,0.241,47
damnation,0.748,57,39,1,1,0.135,0.75,0.416,96
clink,0.748,57,39,1,1,0.458,0.462,0.319,96
slang,0.748,128,88,1,1,0.479,0.418,0.491,216
squirrel,0.747,283,195,1,1,0.592,0.358,0.333,478
supremely,0.747,70,48,1,1,0.833,0.725,0.897,118
smack,0.747,480,331,1,1,0.323,0.662,0.381,811
projection,0.747,209,144,1,1,0.708,0.5,0.731,353
disgruntled,0.747,83,57,1,1,0.104,0.658,0.442,140
doomsday,0.747,41,28,1,1,0.125,0.861,0.67,69
idle,0.746,397,274,1,1,0.179,0.167,0.112,671
alias,0.746,67,46,1,1,0.541,0.353,0.333,113
hazy,0.745,119,82,1,1,0.45,0.433,0.23,201
plug,0.745,492,340,1,1,0.531,0.356,0.473,832
mix,0.744,2932,2029,1,1,0.542,0.49,0.472,4961
foaming,0.744,25,17,1,1,0.643,0.24,0.198,42
viola,0.744,38,26,1,1,0.521,0.461,0.481,64
skid,0.744,38,26,1,1,0.357,0.64,0.44,64
mach,0.744,25,17,1,1,0.541,0.432,0.463,42
fragment,0.744,51,35,1,1,0.211,0.316,0.429,86
unclean,0.744,103,71,1,1,0.133,0.529,0.134,174
headliner,0.744,25,17,1,1,0.5,0.49,0.625,42
mercenary,0.744,51,35,1,1,0.245,0.837,0.673,86
pickup,0.743,227,157,1,1,0.561,0.529,0.42,384
loon,0.743,113,78,1,1,0.429,0.392,0.325,191
blond,0.743,188,130,1,1,0.59,0.49,0.49,318
dry,0.743,3174,2200,1,1,0.363,0.169,0.311,5374
lavender,0.742,198,137,1,1,0.812,0.198,0.388,335
patter,0.742,61,42,1,1,0.312,0.635,0.451,103
masterpiece,0.742,1050,728,1,1,0.926,0.623,0.847,1778
abstract,0.742,221,153,1,1,0.438,0.292,0.444,374
provoking,0.742,159,110,1,1,0.338,0.92,0.717,269
awkwardness,0.742,404,280,1,1,0.167,0.454,0.148,684
sorcerer,0.742,48,33,1,1,0.377,0.633,0.632,81
recruit,0.741,192,133,1,1,0.551,0.654,0.633,325
shrill,0.741,71,49,1,1,0.312,0.721,0.64,120
bullock,0.74,58,40,1,1,0.281,0.402,0.375,98
panty,0.74,58,40,1,1,0.451,0.557,0.303,98
impotent,0.74,140,97,1,1,0.146,0.587,0.333,237
manhood,0.74,81,56,1,1,0.625,0.735,0.858,137
horribly,0.74,783,544,1,1,0.05,0.631,0.454,1327
omega,0.74,301,209,1,1,0.529,0.337,0.526,510
candy,0.74,1555,1081,1,1,0.93,0.425,0.384,2636
hobby,0.74,1483,1031,1,1,0.827,0.56,0.471,2514
ambition,0.739,426,296,1,1,0.51,0.804,0.661,722
wallflower,0.739,91,63,1,1,0.667,0.298,0.342,154
cub,0.739,114,79,1,1,0.646,0.382,0.284,193
erect,0.739,45,31,1,1,0.643,0.885,0.627,76
yodel,0.739,45,31,1,1,0.51,0.454,0.389,76
dehydrated,0.739,114,79,1,1,0.31,0.685,0.212,193
schoolboy,0.739,22,15,1,1,0.623,0.385,0.441,37
fender,0.739,22,15,1,1,0.369,0.459,0.476,37
precarious,0.739,68,47,1,1,0.107,0.54,0.273,115
bitterly,0.739,114,79,1,1,0.194,0.685,0.362,193
overbearing,0.739,180,125,1,1,0.323,0.833,0.861,305
damp,0.738,190,132,1,1,0.36,0.279,0.21,322
angst,0.738,685,477,1,1,0.167,0.888,0.333,1162
interested,0.738,6943,4838,1,1,0.75,0.529,0.725,11781
repression,0.737,65,45,1,1,0.214,0.764,0.481,110
meager,0.737,32,22,1,1,0.144,0.389,0.281,54
vie,0.737,164,114,1,1,0.484,0.491,0.5,278
warden,0.737,65,45,1,1,0.615,0.627,0.898,110
discrepancy,0.737,32,22,1,1,0.26,0.643,0.417,54
nebulous,0.737,32,22,1,1,0.469,0.347,0.417,54
catnip,0.737,32,22,1,1,0.439,0.381,0.296,54
sunny,0.737,1085,756,1,1,0.74,0.348,0.481,1841
ark,0.737,141,98,1,1,0.396,0.427,0.543,239
accounts,0.737,2678,1867,1,1,0.592,0.34,0.471,4545
homosexual,0.737,227,158,1,1,0.333,0.78,0.431,385
animate,0.736,42,29,1,1,0.827,0.755,0.635,71
entice,0.736,42,29,1,1,0.521,0.887,0.518,71
encore,0.736,138,96,1,1,0.51,0.423,0.5,234
longevity,0.736,95,66,1,1,0.75,0.353,0.745,161
spice,0.736,350,244,1,1,0.594,0.439,0.384,594
fern,0.736,52,36,1,1,0.602,0.24,0.29,88
reside,0.735,178,124,1,1,0.451,0.44,0.455,302
invent,0.735,208,145,1,1,0.719,0.689,0.833,353
bilingual,0.735,72,50,1,1,0.735,0.49,0.606,122
beanie,0.735,82,57,1,1,0.5,0.23,0.263,139
stuffy,0.735,82,57,1,1,0.323,0.615,0.406,139
killer,0.735,2078,1452,1,1,0.041,0.971,0.543,3530
wave,0.734,2854,1995,1,1,0.622,0.491,0.49,4849
poems,0.734,933,652,1,1,0.833,0.388,0.418,1585
pax,0.734,142,99,1,1,0.551,0.421,0.473,241
hot,0.734,10674,7467,1,1,0.49,0.74,0.573,18141
lingering,0.733,422,295,1,1,0.63,0.643,0.667,717
terminator,0.733,39,27,1,1,0.37,0.663,0.737,66
conjugal,0.733,19,13,1,1,0.698,0.51,0.688,32
arousal,0.733,29,20,1,1,0.791,0.943,0.731,49
sophistication,0.733,19,13,1,1,0.792,0.472,0.704,32
drunken,0.733,479,335,1,1,0.155,0.849,0.25,814
charcoal,0.733,59,41,1,1,0.302,0.186,0.342,100
quaint,0.733,49,34,1,1,0.625,0.463,0.474,83
orbiting,0.733,59,41,1,1,0.52,0.643,0.554,100
settler,0.733,29,20,1,1,0.573,0.453,0.519,49
companion,0.732,3897,2729,1,1,0.77,0.377,0.618,6626
soft,0.732,6000,4202,1,1,0.76,0.179,0.232,10202
bereaved,0.732,193,135,1,1,0.104,0.479,0.221,328
catcher,0.731,86,60,1,1,0.653,0.413,0.54,146
horseman,0.731,163,114,1,1,0.441,0.7,0.676,277
billy,0.731,1204,844,1,1,0.49,0.397,0.375,2048
bait,0.731,334,234,1,1,0.276,0.327,0.296,568
jellyfish,0.731,66,46,1,1,0.531,0.567,0.377,112
kappa,0.731,66,46,1,1,0.469,0.375,0.366,112
street,0.731,5962,4183,1,1,0.594,0.324,0.398,10145
repressed,0.731,237,166,1,1,0.188,0.337,0.311,403
moist,0.73,93,65,1,1,0.47,0.316,0.386,158
hater,0.73,580,407,1,1,0.052,0.702,0.422,987
glen,0.729,120,84,1,1,0.573,0.337,0.406,204
parting,0.729,184,129,1,1,0.26,0.542,0.353,313
pavilion,0.729,36,25,1,1,0.583,0.5,0.77,61
bouncer,0.729,36,25,1,1,0.49,0.653,0.655,61
regulars,0.728,90,63,1,1,0.729,0.327,0.508,153
researcher,0.728,117,82,1,1,0.569,0.51,0.857,199
acclaim,0.728,26,18,1,1,0.562,0.809,0.718,44
excitable,0.728,26,18,1,1,0.803,0.939,0.629,44
jockey,0.728,26,18,1,1,0.562,0.644,0.703,44
ministerial,0.728,26,18,1,1,0.571,0.519,0.66,44
beta,0.728,708,498,1,1,0.71,0.37,0.439,1206
founder,0.728,313,220,1,1,0.76,0.465,0.891,533
experimental,0.727,70,49,1,1,0.417,0.764,0.396,119
soldier,0.727,1352,952,1,1,0.392,0.708,0.768,2304
pastel,0.727,87,61,1,1,0.719,0.357,0.367,148
groove,0.726,253,178,1,1,0.552,0.448,0.361,431
dealer,0.726,182,128,1,1,0.799,0.615,0.683,310
musing,0.726,60,42,1,1,0.74,0.151,0.465,102
opera,0.726,294,207,1,1,0.714,0.5,0.483,501
arsehole,0.725,128,90,1,1,0.276,0.598,0.433,218
sensual,0.725,145,102,1,1,0.73,0.79,0.642,247
wasteland,0.725,291,205,1,1,0.365,0.308,0.391,496
play,0.725,30245,21348,1,1,0.812,0.765,0.358,51593
radish,0.725,16,11,1,1,0.5,0.316,0.398,27
rout,0.725,16,11,1,1,0.163,0.625,0.233,27
icebreaker,0.725,16,11,1,1,0.571,0.545,0.848,27
footpath,0.725,16,11,1,1,0.677,0.321,0.473,27
jellybean,0.725,16,11,1,1,0.592,0.406,0.399,27
coveted,0.725,33,23,1,1,0.661,0.73,0.625,56
drafty,0.725,16,11,1,1,0.458,0.5,0.518,27
goggle,0.725,16,11,1,1,0.525,0.286,0.36,27
cannon,0.725,118,83,1,1,0.529,0.676,0.811,201
petal,0.725,67,47,1,1,0.81,0.194,0.211,114
ambience,0.725,67,47,1,1,0.735,0.356,0.426,114
cabaret,0.725,33,23,1,1,0.677,0.656,0.482,56
runaround,0.725,16,11,1,1,0.448,0.519,0.349,27
autographed,0.725,16,11,1,1,0.781,0.62,0.625,27
unforgiving,0.725,152,107,1,1,0.406,0.63,0.793,259
indomitable,0.725,16,11,1,1,0.458,0.8,0.83,27
lego,0.724,278,196,1,1,0.6,0.294,0.189,474
creator,0.724,1514,1069,1,1,0.865,0.592,0.856,2583
photographer,0.724,350,247,1,1,0.714,0.481,0.562,597
cue,0.724,609,430,1,1,0.521,0.433,0.484,1039
intensely,0.724,425,300,1,1,0.694,0.846,0.75,725
fetish,0.723,415,293,1,1,0.307,0.706,0.5,708
willow,0.723,265,187,1,1,0.604,0.245,0.4,452
activist,0.723,456,322,1,1,0.531,0.653,0.877,778
detour,0.723,57,40,1,1,0.398,0.539,0.309,97
geek,0.723,279,197,1,1,0.479,0.392,0.39,476
tentative,0.723,40,28,1,1,0.582,0.657,0.534,68
windmill,0.723,40,28,1,1,0.773,0.412,0.412,68
dissipate,0.722,64,45,1,1,0.385,0.368,0.355,109
janitor,0.722,64,45,1,1,0.51,0.35,0.527,109
saddle,0.722,64,45,1,1,0.51,0.509,0.306,109
starlight,0.721,208,147,1,1,0.908,0.368,0.611,355
confused,0.721,9005,6378,1,1,0.22,0.65,0.179,15383
disembodied,0.721,23,16,1,1,0.167,0.62,0.412,39
munchies,0.721,47,33,1,1,0.562,0.47,0.491,80
ovary,0.721,23,16,1,1,0.469,0.399,0.28,39
hoof,0.721,23,16,1,1,0.427,0.341,0.365,39
piccolo,0.721,23,16,1,1,0.625,0.423,0.38,39
volunteers,0.721,809,573,1,1,0.82,0.448,0.63,1382
dresser,0.721,102,72,1,1,0.604,0.398,0.473,174
fish,0.721,2595,1839,1,1,0.51,0.28,0.25,4434
malaise,0.72,54,38,1,1,0.15,0.6,0.161,92
underpaid,0.72,54,38,1,1,0.146,0.413,0.209,92
jock,0.72,85,60,1,1,0.592,0.656,0.473,145
psalm,0.72,1059,751,1,1,0.688,0.224,0.557,1810
soaring,0.719,92,65,1,1,0.708,0.704,0.65,157
tuxedo,0.719,30,21,1,1,0.694,0.354,0.519,51
intersect,0.719,30,21,1,1,0.521,0.51,0.48,51
unattractive,0.719,485,344,1,1,0.177,0.307,0.208,829
evoke,0.719,99,70,1,1,0.438,0.341,0.5,169
rap,0.719,1206,856,1,1,0.604,0.575,0.464,2062
hiatus,0.719,544,386,1,1,0.479,0.294,0.352,930
rat,0.718,1056,750,1,1,0.271,0.567,0.255,1806
besties,0.718,493,350,1,1,0.888,0.509,0.614,843
seamless,0.718,37,26,1,1,0.459,0.14,0.302,63
induced,0.718,203,144,1,1,0.397,0.471,0.491,347
salesman,0.717,89,63,1,1,0.643,0.559,0.664,152
prolonged,0.717,200,142,1,1,0.406,0.453,0.56,342
lovely,0.717,10933,7778,1,1,0.917,0.456,0.741,18711
radiance,0.717,51,36,1,1,0.796,0.625,0.719,87
cohesive,0.717,51,36,1,1,0.531,0.47,0.603,87
mammy,0.717,51,36,1,1,0.68,0.415,0.436,87
gateway,0.717,155,110,1,1,0.592,0.376,0.529,265
pristine,0.717,51,36,1,1,0.65,0.363,0.625,87
intrigue,0.716,58,41,1,1,0.362,0.83,0.327,99
dispel,0.716,58,41,1,1,0.388,0.402,0.411,99
hull,0.716,72,51,1,1,0.542,0.265,0.353,123
bisexual,0.715,931,663,1,1,0.438,0.765,0.459,1594
scorned,0.715,79,56,1,1,0.062,0.529,0.226,135
northwest,0.715,79,56,1,1,0.604,0.345,0.451,135
mountain,0.715,2838,2022,1,1,0.698,0.408,0.649,4860
milky,0.715,187,133,1,1,0.517,0.283,0.311,320
husk,0.715,100,71,1,1,0.378,0.173,0.147,171
pulse,0.715,309,220,1,1,0.507,0.412,0.492,529
muted,0.714,487,347,1,1,0.26,0.167,0.162,834
angry,0.714,12099,8628,1,1,0.122,0.83,0.604,20727
pet,0.713,5216,3724,1,1,0.875,0.327,0.305,8940
meathead,0.713,20,14,1,1,0.306,0.534,0.49,34
glide,0.713,34,24,1,1,0.561,0.706,0.415,58
entrapment,0.713,27,19,1,1,0.177,0.604,0.441,46
meatball,0.713,48,34,1,1,0.612,0.279,0.343,82
typewriter,0.713,41,29,1,1,0.542,0.373,0.418,70
skeletal,0.713,27,19,1,1,0.306,0.558,0.318,46
trophy,0.713,426,304,1,1,0.947,0.643,0.676,730
artiste,0.713,27,19,1,1,0.844,0.512,0.565,46
ruse,0.713,41,29,1,1,0.531,0.64,0.546,70
gawk,0.713,27,19,1,1,0.333,0.472,0.434,46
mutilated,0.713,48,34,1,1,0.041,0.841,0.356,82
kaleidoscope,0.713,27,19,1,1,0.615,0.439,0.58,46
ingenious,0.713,20,14,1,1,0.76,0.69,0.891,34
cracker,0.713,125,89,1,1,0.604,0.343,0.346,214
ravage,0.713,20,14,1,1,0.214,0.755,0.575,34
mystical,0.713,90,64,1,1,0.594,0.443,0.689,154
quartz,0.713,48,34,1,1,0.704,0.292,0.481,82
topaz,0.713,20,14,1,1,0.643,0.325,0.384,34
starfish,0.713,55,39,1,1,0.68,0.32,0.421,94
tempo,0.713,132,94,1,1,0.582,0.337,0.5,226
relics,0.713,20,14,1,1,0.719,0.58,0.579,34
ceramic,0.713,20,14,1,1,0.521,0.255,0.371,34
unwrap,0.713,27,19,1,1,0.604,0.491,0.557,46
fleece,0.713,41,29,1,1,0.561,0.25,0.381,70
landfill,0.713,27,19,1,1,0.398,0.423,0.324,46
countenance,0.713,34,24,1,1,0.635,0.44,0.69,58
romantic,0.713,4884,3489,1,1,0.936,0.531,0.598,8373
lame,0.713,2489,1778,1,1,0.145,0.41,0.217,4267
pleasure,0.712,2946,2106,1,1,0.939,0.74,0.682,5052
dreamy,0.712,157,112,1,1,0.837,0.35,0.5,269
unspeakable,0.711,115,82,1,1,0.327,0.567,0.393,197
curb,0.711,340,243,1,1,0.472,0.371,0.402,583
cretin,0.711,101,72,1,1,0.265,0.583,0.312,173
statue,0.711,263,188,1,1,0.542,0.153,0.57,451
trolley,0.711,87,62,1,1,0.562,0.558,0.464,149
active,0.71,3449,2471,1,1,0.847,0.73,0.731,5920
raven,0.71,440,315,1,1,0.479,0.446,0.426,755
quarantine,0.709,59,42,1,1,0.16,0.577,0.589,101
recruiting,0.709,144,103,1,1,0.448,0.787,0.693,247
pleasant,0.709,915,656,1,1,0.939,0.31,0.673,1571
orchestra,0.709,190,136,1,1,0.708,0.5,0.664,326
rattle,0.708,91,65,1,1,0.49,0.429,0.268,156
refuge,0.708,774,555,1,1,0.64,0.238,0.481,1329
emo,0.708,2615,1876,1,1,0.354,0.314,0.226,4491
shrine,0.708,130,93,1,1,0.802,0.255,0.574,223
mischievous,0.708,84,60,1,1,0.439,0.804,0.472,144
sequel,0.708,371,266,1,1,0.65,0.48,0.574,637
resemble,0.708,162,116,1,1,0.602,0.388,0.463,278
biscuit,0.708,201,144,1,1,0.888,0.26,0.231,345
motorcycle,0.708,240,172,1,1,0.677,0.764,0.713,412
spring,0.708,2782,1997,1,1,0.837,0.37,0.481,4779
loom,0.708,38,27,1,1,0.531,0.245,0.325,65
inanimate,0.708,155,111,1,1,0.281,0.143,0.224,266
reboot,0.707,219,157,1,1,0.673,0.577,0.519,376
doodle,0.707,173,124,1,1,0.604,0.402,0.376,297
lube,0.707,102,73,1,1,0.552,0.49,0.411,175
imagery,0.707,134,96,1,1,0.653,0.327,0.39,230
bate,0.707,31,22,1,1,0.429,0.525,0.464,53
disparate,0.707,31,22,1,1,0.438,0.5,0.368,53
potted,0.707,31,22,1,1,0.469,0.336,0.375,53
goodie,0.707,63,45,1,1,0.854,0.327,0.6,108
lane,0.707,1336,960,1,1,0.449,0.49,0.451,2296
horn,0.706,280,201,1,1,0.385,0.51,0.366,481
genius,0.706,1406,1011,1,1,0.878,0.667,0.846,2417
exciting,0.706,1919,1380,1,1,0.95,0.792,0.789,3299
sickness,0.705,1290,928,1,1,0.094,0.704,0.288,2218
insecure,0.705,4355,3135,1,1,0.114,0.538,0.132,7490
spare,0.705,1613,1161,1,1,0.552,0.398,0.411,2774
caster,0.705,49,35,1,1,0.604,0.67,0.647,84
marsh,0.705,74,53,1,1,0.302,0.358,0.277,127
maverick,0.705,74,53,1,1,0.354,0.676,0.409,127
banish,0.705,99,71,1,1,0.163,0.677,0.543,170
fixation,0.705,74,53,1,1,0.562,0.459,0.655,127
wedlock,0.705,24,17,1,1,0.747,0.654,0.745,41
gent,0.705,74,53,1,1,0.573,0.494,0.464,127
gourmet,0.705,49,35,1,1,0.911,0.387,0.562,84
calender,0.705,24,17,1,1,0.531,0.275,0.451,41
mend,0.705,560,403,1,1,0.542,0.436,0.602,963
feline,0.704,142,102,1,1,0.615,0.745,0.509,244
miss,0.704,53100,38266,1,1,0.573,0.49,0.408,91366
bulldog,0.703,103,74,1,1,0.494,0.65,0.53,177
giraffe,0.703,121,87,1,1,0.561,0.347,0.436,208
mystery,0.703,1072,773,1,1,0.417,0.667,0.519,1845
messenger,0.703,541,390,1,1,0.694,0.434,0.5,931
engraved,0.703,78,56,1,1,0.542,0.375,0.473,134
opposites,0.703,96,69,1,1,0.281,0.518,0.462,165
keynote,0.702,89,64,1,1,0.63,0.431,0.545,153
amuse,0.702,107,77,1,1,0.812,0.684,0.664,184
decreased,0.702,107,77,1,1,0.224,0.271,0.17,184
bloodhound,0.702,17,12,1,1,0.327,0.462,0.538,29
crosswalk,0.702,17,12,1,1,0.557,0.441,0.38,29
charitable,0.702,89,64,1,1,0.865,0.38,0.593,153
rousing,0.702,17,12,1,1,0.714,0.517,0.692,29
unfriendly,0.702,107,77,1,1,0.173,0.67,0.458,184
policeman,0.702,53,38,1,1,0.542,0.708,0.898,91
wiener,0.702,53,38,1,1,0.594,0.434,0.391,91
emotive,0.702,35,25,1,1,0.917,0.741,0.525,60
introductory,0.702,17,12,1,1,0.635,0.368,0.593,29
summer,0.701,10256,7409,1,1,0.812,0.373,0.55,17665
jaded,0.701,320,231,1,1,0.255,0.56,0.4,551
snug,0.701,82,59,1,1,0.867,0.173,0.5,141
dicks,0.701,544,393,1,1,0.31,0.694,0.358,937
bun,0.701,378,273,1,1,0.424,0.306,0.268,651
sucker,0.701,425,307,1,1,0.265,0.393,0.204,732
bind,0.7,241,174,1,1,0.398,0.462,0.448,415
trembling,0.7,346,250,1,1,0.177,0.824,0.324,596
seventh,0.7,140,101,1,1,0.5,0.245,0.288,241
inflammation,0.7,46,33,1,1,0.146,0.765,0.423,79
darkly,0.7,46,33,1,1,0.219,0.548,0.443,79
destroyer,0.7,93,67,1,1,0.083,0.83,0.543,160
bit,0.7,33595,24307,1,1,0.427,0.31,0.225,57902
composer,0.7,75,54,1,1,0.822,0.588,0.691,129
ethereal,0.7,104,75,1,1,0.52,0.419,0.518,179
mitigate,0.7,104,75,1,1,0.506,0.427,0.456,179
volunteer,0.699,1354,980,1,1,0.888,0.422,0.596,2334
lacking,0.699,963,697,1,1,0.229,0.375,0.121,1660
honk,0.699,86,62,1,1,0.549,0.635,0.415,148
stricken,0.699,86,62,1,1,0.163,0.72,0.368,148
spaz,0.699,28,20,1,1,0.443,0.5,0.268,48
saturation,0.699,28,20,1,1,0.255,0.582,0.583,48
inquiring,0.699,28,20,1,1,0.479,0.51,0.5,48
umbrella,0.699,503,364,1,1,0.583,0.246,0.255,867
extremely,0.699,8630,6250,1,1,0.635,0.827,0.886,14880
strap,0.699,155,112,1,1,0.38,0.417,0.382,267
abandonment,0.698,1268,919,1,1,0.128,0.43,0.202,2187
affluent,0.698,39,28,1,1,0.756,0.388,0.477,67
honorary,0.698,39,28,1,1,0.885,0.565,0.811,67
tile,0.697,50,36,1,1,0.429,0.245,0.348,86
grind,0.697,1307,948,1,1,0.48,0.276,0.397,2255
indie,0.697,480,348,1,1,0.479,0.368,0.43,828
plant,0.697,1034,750,1,1,0.73,0.18,0.371,1784
saggy,0.697,61,44,1,1,0.37,0.429,0.3,105
alcoholic,0.697,849,616,1,1,0.153,0.688,0.361,1465
buff,0.697,134,97,1,1,0.561,0.425,0.361,231
composed,0.696,240,174,1,1,0.684,0.385,0.682,414
digital,0.696,1257,913,1,1,0.74,0.382,0.529,2170
classic,0.696,1535,1115,1,1,0.69,0.26,0.611,2650
shootout,0.695,21,15,1,1,0.08,0.927,0.615,36
sifting,0.695,32,23,1,1,0.571,0.469,0.474,55
adopt,0.694,2484,1807,1,1,0.694,0.612,0.701,4291
follower,0.694,987,718,1,1,0.646,0.488,0.461,1705
factory,0.694,392,285,1,1,0.5,0.5,0.683,677
dreary,0.694,190,138,1,1,0.26,0.49,0.324,328
enthusiast,0.694,157,114,1,1,0.867,0.81,0.875,271
sweatshirt,0.694,135,98,1,1,0.51,0.368,0.353,233
mingle,0.694,521,379,1,1,0.561,0.48,0.434,900
thrust,0.694,124,90,1,1,0.51,0.647,0.663,214
businessman,0.694,102,74,1,1,0.653,0.51,0.802,176
yacht,0.693,91,66,1,1,0.823,0.67,0.66,157
dreams,0.693,11738,8549,1,1,0.865,0.415,0.53,20287
selfishness,0.693,496,361,1,1,0.2,0.686,0.453,857
spirited,0.693,161,117,1,1,0.854,0.587,0.734,278
grill,0.693,220,160,1,1,0.755,0.491,0.546,380
nomad,0.693,69,50,1,1,0.375,0.413,0.433,119
exploit,0.693,257,187,1,1,0.312,0.878,0.66,444
nosey,0.693,128,93,1,1,0.276,0.655,0.223,221
celestial,0.693,117,85,1,1,0.817,0.36,0.731,202
boob,0.693,176,128,1,1,0.694,0.6,0.392,304
groovy,0.693,58,42,1,1,0.615,0.538,0.464,100
trilogy,0.692,272,198,1,1,0.615,0.52,0.664,470
traps,0.692,239,174,1,1,0.235,0.673,0.481,413
troubled,0.692,830,605,1,1,0.167,0.627,0.385,1435
swag,0.692,169,123,1,1,0.656,0.676,0.654,292
plaque,0.691,36,26,1,1,0.52,0.333,0.42,62
sensibility,0.691,36,26,1,1,0.583,0.423,0.448,62
incubus,0.691,36,26,1,1,0.458,0.529,0.482,62
hedgehog,0.691,173,126,1,1,0.458,0.491,0.377,299
daring,0.691,225,164,1,1,0.583,0.84,0.711,389
duck,0.691,866,632,1,1,0.594,0.337,0.236,1498
fragrance,0.691,88,64,1,1,0.847,0.357,0.667,152
fax,0.691,88,64,1,1,0.406,0.368,0.304,152
potent,0.691,88,64,1,1,0.698,0.784,0.907,152
trivia,0.69,192,140,1,1,0.69,0.49,0.473,332
platoon,0.69,25,18,1,1,0.448,0.7,0.745,43
solicit,0.69,25,18,1,1,0.62,0.49,0.604,43
diatribe,0.69,25,18,1,1,0.354,0.569,0.409,43
fossils,0.69,25,18,1,1,0.52,0.314,0.422,43
columbine,0.69,25,18,1,1,0.52,0.521,0.407,43
chirping,0.69,129,94,1,1,0.5,0.463,0.36,223
wet,0.69,1686,1232,1,1,0.385,0.417,0.185,2918
throwback,0.69,300,219,1,1,0.28,0.454,0.356,519
dreamt,0.69,553,404,1,1,0.812,0.38,0.518,957
mayhem,0.69,118,86,1,1,0.188,0.87,0.364,204
upbeat,0.689,304,222,1,1,0.878,0.531,0.802,526
pixie,0.689,92,67,1,1,0.562,0.537,0.325,159
gap,0.689,956,699,1,1,0.396,0.451,0.357,1655
ere,0.689,107,78,1,1,0.479,0.312,0.377,185
dissatisfaction,0.689,107,78,1,1,0.115,0.663,0.202,185
hairy,0.689,230,168,1,1,0.542,0.38,0.343,398
rod,0.689,312,228,1,1,0.479,0.319,0.355,540
fen,0.689,40,29,1,1,0.49,0.276,0.379,69
subdued,0.689,40,29,1,1,0.236,0.463,0.223,69
pong,0.688,96,70,1,1,0.5,0.5,0.396,166
slumber,0.688,208,152,1,1,0.592,0.191,0.426,360
infatuation,0.688,126,92,1,1,0.844,0.745,0.53,218
dexter,0.687,100,73,1,1,0.458,0.473,0.444,173
mayday,0.687,115,84,1,1,0.344,0.643,0.423,199
shuffle,0.687,602,441,1,1,0.459,0.45,0.556,1043
motherfucker,0.687,782,573,1,1,0.122,0.827,0.351,1355
dragon,0.687,1419,1040,1,1,0.541,0.821,0.712,2459
thorny,0.686,29,21,1,1,0.177,0.69,0.5,50
glint,0.686,29,21,1,1,0.677,0.538,0.541,50
stead,0.686,59,43,1,1,0.551,0.214,0.51,102
ballerina,0.686,29,21,1,1,0.802,0.66,0.475,50
obsessing,0.686,224,164,1,1,0.173,0.773,0.698,388
petting,0.686,183,134,1,1,0.812,0.462,0.48,317
producer,0.685,345,253,1,1,0.559,0.561,0.917,598
wood,0.685,804,590,1,1,0.494,0.182,0.373,1394
stifling,0.685,78,57,1,1,0.163,0.858,0.608,135
diseased,0.685,78,57,1,1,0.123,0.51,0.134,135
chaps,0.685,63,46,1,1,0.35,0.462,0.35,109
ceiling,0.685,1189,873,1,1,0.52,0.224,0.366,2062
personification,0.685,48,35,1,1,0.76,0.471,0.691,83
chardonnay,0.685,48,35,1,1,0.677,0.567,0.492,83
feminist,0.684,991,728,1,1,0.51,0.56,0.585,1719
gasoline,0.684,116,85,1,1,0.417,0.562,0.519,201
comedy,0.684,1305,959,1,1,0.918,0.555,0.49,2264
karaoke,0.684,532,391,1,1,0.763,0.649,0.342,923
artificial,0.683,245,180,1,1,0.306,0.385,0.351,425
gong,0.683,105,77,1,1,0.49,0.529,0.462,182
isolated,0.683,10801,7949,1,1,0.221,0.356,0.255,18750
mamma,0.683,249,183,1,1,0.6,0.358,0.449,432
penis,0.682,727,535,1,1,0.354,0.81,0.556,1262
sexy,0.682,4732,3484,1,1,0.865,0.945,0.802,8216
shyness,0.682,219,161,1,1,0.312,0.265,0.246,380
disconnected,0.682,1400,1031,1,1,0.292,0.276,0.173,2431
rigid,0.682,75,55,1,1,0.357,0.552,0.591,130
raisin,0.682,94,69,1,1,0.594,0.235,0.246,163
maim,0.682,18,13,1,1,0.133,0.724,0.496,31
grapevine,0.682,18,13,1,1,0.541,0.343,0.232,31
yielding,0.682,18,13,1,1,0.49,0.643,0.444,31
marshal,0.682,37,27,1,1,0.469,0.61,0.819,64
citrus,0.682,37,27,1,1,0.469,0.368,0.375,64
zoo,0.682,474,349,1,1,0.76,0.52,0.58,823
correspondent,0.682,18,13,1,1,0.573,0.565,0.712,31
lithe,0.682,18,13,1,1,0.656,0.596,0.602,31
mirth,0.682,18,13,1,1,0.888,0.64,0.608,31
eighty,0.682,37,27,1,1,0.5,0.3,0.453,64
reprieve,0.682,75,55,1,1,0.531,0.471,0.574,130
shrimp,0.681,197,145,1,1,0.571,0.361,0.425,342
van,0.681,1016,749,1,1,0.561,0.378,0.425,1765
playground,0.681,418,308,1,1,0.888,0.62,0.435,726
equate,0.681,498,367,1,1,0.724,0.382,0.624,865
busy,0.68,13882,10242,1,1,0.402,0.5,0.474,24124
malnutrition,0.68,41,30,1,1,0.024,0.592,0.277,71
fable,0.68,41,30,1,1,0.663,0.387,0.389,71
gleaming,0.68,41,30,1,1,0.827,0.635,0.627,71
wealthy,0.68,721,532,1,1,0.927,0.566,0.862,1253
momma,0.68,2307,1703,1,1,0.833,0.412,0.527,4010
teenage,0.679,1503,1110,1,1,0.667,0.673,0.558,2613
kiwi,0.679,156,115,1,1,0.646,0.273,0.282,271
fatherly,0.679,22,16,1,1,0.865,0.363,0.712,38
casual,0.679,873,645,1,1,0.643,0.224,0.385,1518
contrasted,0.679,22,16,1,1,0.521,0.538,0.491,38
corporal,0.679,22,16,1,1,0.582,0.49,0.596,38
barter,0.679,22,16,1,1,0.465,0.559,0.596,38
accelerator,0.679,22,16,1,1,0.593,0.83,0.812,38
goddess,0.679,854,631,1,1,0.865,0.56,0.888,1485
unicorn,0.678,352,260,1,1,0.776,0.51,0.48,612
host,0.678,1327,981,1,1,0.693,0.471,0.537,2308
initiate,0.678,260,192,1,1,0.719,0.48,0.553,452
lad,0.678,740,547,1,1,0.637,0.388,0.336,1287
unused,0.678,145,107,1,1,0.344,0.231,0.234,252
hoop,0.678,72,53,1,1,0.635,0.204,0.315,125
coupled,0.678,318,235,1,1,0.612,0.286,0.65,553
ahhhhhhhh,0.677,49,36,1,1,0.552,0.649,0.288,85
snoopy,0.677,49,36,1,1,0.573,0.534,0.291,85
lilac,0.677,49,36,1,1,0.688,0.18,0.357,85
owl,0.677,611,452,1,1,0.52,0.27,0.321,1063
infidelity,0.677,103,76,1,1,0.062,0.777,0.392,179
songwriter,0.677,130,96,1,1,0.844,0.558,0.713,226
bikini,0.677,184,136,1,1,0.73,0.639,0.353,320
famous,0.677,2374,1758,1,1,0.916,0.775,0.882,4132
toots,0.676,26,19,1,1,0.552,0.48,0.451,45
groupie,0.676,53,39,1,1,0.521,0.583,0.393,92
barbershop,0.676,26,19,1,1,0.597,0.441,0.382,45
twister,0.676,26,19,1,1,0.33,0.68,0.647,45
opium,0.676,26,19,1,1,0.276,0.49,0.333,45
pup,0.676,1029,762,1,1,0.755,0.427,0.302,1791
meteor,0.676,84,62,1,1,0.398,0.714,0.737,146
submissive,0.676,200,148,1,1,0.48,0.217,0.173,348
crazed,0.676,115,85,1,1,0.153,0.877,0.417,200
twit,0.676,320,237,1,1,0.194,0.653,0.198,557
limb,0.675,297,220,1,1,0.51,0.397,0.427,517
misfortune,0.675,243,180,1,1,0.094,0.78,0.311,423
sudden,0.675,3605,2674,1,1,0.449,0.66,0.435,6279
fantasy,0.675,2157,1600,1,1,0.88,0.627,0.474,3757
fade,0.675,1514,1123,1,1,0.354,0.333,0.245,2637
downcast,0.675,30,22,1,1,0.071,0.5,0.222,52
catchy,0.675,216,160,1,1,0.677,0.441,0.462,376
parable,0.675,30,22,1,1,0.479,0.357,0.525,52
pinball,0.675,30,22,1,1,0.582,0.64,0.442,52
heighten,0.675,30,22,1,1,0.755,0.622,0.765,52
skull,0.675,371,275,1,1,0.276,0.558,0.574,646
gill,0.675,61,45,1,1,0.521,0.473,0.382,106
juice,0.675,1181,876,1,1,0.776,0.281,0.352,2057
mushy,0.674,127,94,1,1,0.52,0.2,0.182,221
worm,0.674,294,218,1,1,0.13,0.418,0.219,512
liberalism,0.674,100,74,1,1,0.562,0.712,0.75,174
undead,0.674,104,77,1,1,0.367,0.635,0.406,181
hotshot,0.674,34,25,1,1,0.5,0.727,0.615,59
arcane,0.674,34,25,1,1,0.5,0.49,0.637,59
immunity,0.674,69,51,1,1,0.633,0.316,0.786,120
terrain,0.674,69,51,1,1,0.54,0.3,0.472,120
disintegration,0.674,34,25,1,1,0.094,0.551,0.381,59
lurk,0.674,139,103,1,1,0.219,0.74,0.655,242
bee,0.674,703,522,1,1,0.52,0.509,0.309,1225
abba,0.673,264,196,1,1,0.562,0.5,0.48,460
thrilling,0.673,151,112,1,1,0.93,0.827,0.782,263
deterioration,0.673,38,28,1,1,0.13,0.512,0.283,66
lynx,0.673,38,28,1,1,0.51,0.59,0.567,66
choreography,0.672,159,118,1,1,0.812,0.75,0.547,277
adolescent,0.672,163,121,1,1,0.781,0.68,0.509,284
lefty,0.672,163,121,1,1,0.49,0.406,0.379,284
mane,0.672,507,377,1,1,0.521,0.277,0.373,884
accompaniment,0.671,46,34,1,1,0.74,0.479,0.695,80
mope,0.671,93,69,1,1,0.406,0.309,0.345,162
symposium,0.671,46,34,1,1,0.573,0.394,0.644,80
druid,0.671,46,34,1,1,0.517,0.445,0.481,80
astral,0.671,97,72,1,1,0.604,0.417,0.567,169
buffalo,0.671,254,189,1,1,0.469,0.528,0.527,443
brittle,0.671,50,37,1,1,0.276,0.49,0.272,87
renowned,0.671,50,37,1,1,0.844,0.481,0.697,87
portray,0.67,309,230,1,1,0.656,0.529,0.457,539
pig,0.67,1106,824,1,1,0.343,0.368,0.324,1930
increased,0.67,737,549,1,1,0.684,0.66,0.773,1286
reproduction,0.67,54,40,1,1,0.8,0.736,0.713,94
unattainable,0.67,113,84,1,1,0.22,0.635,0.571,197
polar,0.669,314,234,1,1,0.468,0.261,0.5,548
flush,0.669,259,193,1,1,0.408,0.755,0.589,452
flattered,0.669,129,96,1,1,0.865,0.608,0.708,225
interactive,0.669,204,152,1,1,0.727,0.811,0.77,356
betterment,0.669,137,102,1,1,0.898,0.536,0.769,239
meaning,0.669,6497,4849,1,1,0.663,0.395,0.625,11346
beaming,0.668,74,55,1,1,0.892,0.654,0.587,129
birdie,0.668,74,55,1,1,0.594,0.394,0.407,129
inequality,0.668,157,117,1,1,0.122,0.575,0.259,274
promo,0.668,339,253,1,1,0.602,0.551,0.614,592
fangs,0.668,90,67,1,1,0.286,0.598,0.434,157
palmer,0.668,94,70,1,1,0.48,0.269,0.413,164
tipsy,0.667,399,298,1,1,0.51,0.625,0.57,697
singular,0.666,404,302,1,1,0.61,0.302,0.482,706
bride,0.666,404,302,1,1,0.84,0.708,0.579,706
fleeting,0.666,416,311,1,1,0.439,0.65,0.387,727
woody,0.666,162,121,1,1,0.469,0.26,0.396,283
bark,0.666,361,270,1,1,0.36,0.602,0.395,631
moot,0.666,182,136,1,1,0.344,0.5,0.615,318
pursuit,0.666,576,431,1,1,0.643,0.453,0.617,1007
string,0.666,648,485,1,1,0.385,0.398,0.445,1133
alcoholism,0.665,278,208,1,1,0.061,0.779,0.407,486
heartbroken,0.665,2501,1874,1,1,0.082,0.551,0.235,4375
hombres,0.664,15,11,1,1,0.51,0.538,0.652,26
faithless,0.664,23,17,1,1,0.102,0.683,0.304,40
grub,0.664,47,35,1,1,0.602,0.406,0.355,82
immutable,0.664,15,11,1,1,0.427,0.431,0.571,26
tickle,0.664,95,71,1,1,0.76,0.727,0.342,166
preventative,0.664,43,32,1,1,0.65,0.442,0.682,75
collaborator,0.664,15,11,1,1,0.729,0.32,0.769,26
lotus,0.664,91,68,1,1,0.604,0.377,0.51,159
maxim,0.664,15,11,1,1,0.875,0.562,0.887,26
prodigal,0.664,23,17,1,1,0.643,0.491,0.66,40
porcelain,0.664,67,50,1,1,0.562,0.31,0.349,117
stag,0.664,55,41,1,1,0.594,0.25,0.389,96
hydrogen,0.664,27,20,1,1,0.469,0.303,0.554,47
dike,0.664,15,11,1,1,0.36,0.384,0.49,26
grassy,0.664,27,20,1,1,0.647,0.323,0.371,47
formality,0.664,23,17,1,1,0.594,0.353,0.75,40
junkyard,0.664,23,17,1,1,0.177,0.398,0.302,40
recon,0.664,35,26,1,1,0.5,0.447,0.4,61
abrasive,0.664,47,35,1,1,0.392,0.61,0.593,82
loin,0.664,15,11,1,1,0.42,0.298,0.379,26
smuggle,0.664,19,14,1,1,0.194,0.775,0.57,33
freelance,0.664,223,167,1,1,0.833,0.577,0.736,390
tuba,0.664,15,11,1,1,0.542,0.402,0.381,26
penchant,0.664,43,32,1,1,0.688,0.48,0.609,75
captivate,0.664,15,11,1,1,0.698,0.604,0.723,26
frayed,0.664,23,17,1,1,0.312,0.363,0.307,40
goo,0.664,227,170,1,1,0.439,0.396,0.312,397
indulgence,0.664,59,44,1,1,0.479,0.49,0.517,103
fatso,0.664,15,11,1,1,0.286,0.394,0.336,26
atom,0.664,75,56,1,1,0.51,0.5,0.433,131
bronco,0.664,15,11,1,1,0.5,0.51,0.473,26
booger,0.664,43,32,1,1,0.399,0.537,0.427,75
sheepdog,0.664,19,14,1,1,0.684,0.442,0.529,33
boastful,0.664,15,11,1,1,0.49,0.806,0.695,26
titanium,0.664,19,14,1,1,0.52,0.47,0.704,33
fulfilled,0.664,660,495,1,1,0.896,0.48,0.676,1155
donkey,0.663,324,243,1,1,0.406,0.367,0.245,567
scheme,0.663,525,394,1,1,0.521,0.269,0.577,919
bleak,0.662,646,485,1,1,0.204,0.427,0.272,1131
lady,0.662,10096,7585,1,1,0.854,0.481,0.602,17681
caption,0.662,458,344,1,1,0.814,0.292,0.379,802
despairing,0.662,132,99,1,1,0.073,0.735,0.286,231
fiction,0.661,858,645,1,1,0.438,0.657,0.441,1503
old,0.661,51308,38590,1,1,0.41,0.279,0.315,89898
rhyme,0.661,201,151,1,1,0.667,0.249,0.481,352
nut,0.66,906,682,1,1,0.365,0.31,0.25,1588
bluff,0.66,80,60,1,1,0.418,0.286,0.377,140
brightens,0.66,161,121,1,1,0.771,0.611,0.613,282
philosophical,0.66,153,115,1,1,0.719,0.275,0.713,268
summit,0.66,230,173,1,1,0.625,0.618,0.764,403
hangout,0.66,3233,2435,1,1,0.573,0.5,0.462,5668
bid,0.66,226,170,1,1,0.76,0.53,0.655,396
hallmark,0.659,279,210,1,1,0.646,0.315,0.411,489
childless,0.659,608,458,1,1,0.31,0.4,0.396,1066
digit,0.659,64,48,1,1,0.447,0.286,0.333,112
plaster,0.659,60,45,1,1,0.438,0.264,0.255,105
caterpillar,0.659,121,91,1,1,0.461,0.286,0.33,212
majesty,0.659,121,91,1,1,0.823,0.602,0.955,212
picket,0.659,60,45,1,1,0.365,0.615,0.451,105
subjective,0.658,292,220,1,1,0.51,0.35,0.432,512
dishonesty,0.658,113,85,1,1,0.094,0.592,0.348,198
stoopid,0.658,113,85,1,1,0.28,0.431,0.382,198
boomer,0.658,227,171,1,1,0.48,0.539,0.441,398
masculinity,0.658,390,294,1,1,0.583,0.67,0.851,684
soy,0.658,329,248,1,1,0.438,0.25,0.286,577
decreasing,0.658,109,82,1,1,0.32,0.346,0.224,191
beauty,0.658,5304,4002,1,1,0.842,0.6,0.644,9306
lead,0.658,6612,4989,1,1,0.323,0.657,0.455,11601
kiss,0.658,7617,5748,1,1,0.967,0.813,0.63,13365
dance,0.657,7589,5730,1,1,0.894,0.84,0.551,13319
filthy,0.657,629,475,1,1,0.115,0.714,0.321,1104
begging,0.657,3583,2707,1,1,0.292,0.461,0.202,6290
titled,0.656,503,380,1,1,0.677,0.24,0.658,883
charismatic,0.656,167,126,1,1,0.938,0.684,0.849,293
west,0.656,2235,1690,1,1,0.562,0.337,0.414,3925
sac,0.655,114,86,1,1,0.344,0.245,0.226,200
name,0.655,22963,17372,1,1,0.573,0.3,0.415,40335
haze,0.655,188,142,1,1,0.427,0.327,0.217,330
conversationalist,0.655,36,27,1,1,0.719,0.467,0.667,63
gin,0.655,369,279,1,1,0.449,0.551,0.518,648
peninsula,0.655,36,27,1,1,0.551,0.384,0.627,63
reply,0.655,7120,5388,1,1,0.762,0.29,0.596,12508
hearted,0.655,1105,836,1,1,0.823,0.41,0.805,1941
launch,0.655,575,435,1,1,0.684,0.814,0.598,1010
harp,0.655,69,52,1,1,0.618,0.31,0.356,121
myopic,0.654,32,24,1,1,0.344,0.396,0.218,56
unyielding,0.654,32,24,1,1,0.367,0.806,0.738,56
allotment,0.654,32,24,1,1,0.6,0.39,0.64,56
inquisitive,0.654,32,24,1,1,0.301,0.637,0.615,56
waffle,0.654,222,168,1,1,0.708,0.394,0.327,390
bonfire,0.654,94,71,1,1,0.48,0.719,0.473,165
lotto,0.653,61,46,1,1,0.76,0.635,0.475,107
triumphant,0.653,61,46,1,1,0.949,0.837,0.972,107
prerogative,0.653,61,46,1,1,0.521,0.442,0.538,107
midlife,0.653,90,68,1,1,0.594,0.244,0.473,158
sting,0.653,359,272,1,1,0.163,0.651,0.373,631
underneath,0.653,583,442,1,1,0.45,0.265,0.158,1025
microscope,0.653,28,21,1,1,0.531,0.33,0.464,49
hospitable,0.653,28,21,1,1,0.791,0.47,0.661,49
sleigh,0.653,28,21,1,1,0.742,0.551,0.396,49
cocoon,0.653,115,87,1,1,0.47,0.28,0.29,202
viper,0.653,28,21,1,1,0.173,0.846,0.632,49
midget,0.653,86,65,1,1,0.396,0.295,0.254,151
hypertension,0.653,28,21,1,1,0.133,0.784,0.427,49
grin,0.653,546,414,1,1,0.885,0.57,0.491,960
extinct,0.652,165,125,1,1,0.112,0.491,0.412,290
borough,0.652,53,40,1,1,0.429,0.343,0.38,93
sterile,0.651,78,59,1,1,0.302,0.471,0.291,137
blueberry,0.651,78,59,1,1,0.656,0.185,0.365,137
symbolism,0.651,103,78,1,1,0.688,0.347,0.64,181
bartender,0.651,299,227,1,1,0.573,0.698,0.585,526
enclosure,0.651,49,37,1,1,0.417,0.375,0.49,86
preceding,0.651,24,18,1,1,0.456,0.442,0.663,42
haughty,0.651,24,18,1,1,0.24,0.708,0.588,42
patriarch,0.651,24,18,1,1,0.592,0.448,0.898,42
humanoid,0.651,49,37,1,1,0.521,0.462,0.491,86
stench,0.651,124,94,1,1,0.104,0.57,0.298,218
pantomime,0.651,24,18,1,1,0.552,0.481,0.385,42
distance,0.651,6624,5034,1,1,0.233,0.317,0.418,11658
date,0.651,17984,13669,1,1,0.604,0.231,0.4,31653
lunchtime,0.65,116,88,1,1,0.896,0.398,0.444,204
tube,0.65,559,425,1,1,0.418,0.279,0.409,984
indifference,0.65,208,158,1,1,0.265,0.417,0.299,366
ranger,0.649,313,238,1,1,0.526,0.545,0.705,551
painted,0.649,464,353,1,1,0.667,0.333,0.424,817
crybaby,0.649,330,251,1,1,0.375,0.702,0.311,581
super,0.649,17589,13391,1,1,0.844,0.663,0.78,30980
misguided,0.649,322,245,1,1,0.28,0.531,0.259,567
bachelor,0.649,683,520,1,1,0.667,0.406,0.6,1203
tomb,0.649,234,178,1,1,0.112,0.5,0.343,412
emancipation,0.648,20,15,1,1,0.704,0.684,0.763,35
triplet,0.648,20,15,1,1,0.622,0.51,0.618,35
plated,0.648,20,15,1,1,0.562,0.458,0.457,35
courtship,0.648,41,31,1,1,0.667,0.49,0.654,72
behest,0.648,20,15,1,1,0.602,0.35,0.72,35
snoop,0.647,79,60,1,1,0.134,0.74,0.434,139
gifted,0.647,576,439,1,1,0.902,0.647,0.868,1015
mascot,0.647,96,73,1,1,0.75,0.337,0.337,169
hit,0.647,20962,15994,1,1,0.235,0.931,0.679,36956
rural,0.647,818,624,1,1,0.562,0.245,0.408,1442
pepperoni,0.646,92,70,1,1,0.796,0.472,0.358,162
collection,0.646,1111,848,1,1,0.725,0.311,0.588,1959
woodland,0.646,54,41,1,1,0.776,0.306,0.48,95
breakers,0.646,71,54,1,1,0.469,0.588,0.439,125
bald,0.646,520,397,1,1,0.306,0.184,0.268,917
cocaine,0.646,232,177,1,1,0.156,0.84,0.373,409
folly,0.645,88,67,1,1,0.184,0.833,0.363,155
lip,0.645,1064,813,1,1,0.541,0.348,0.443,1877
clubs,0.645,836,639,1,1,0.723,0.53,0.591,1475
blunt,0.645,1244,951,1,1,0.551,0.68,0.925,2195
geology,0.645,16,12,1,1,0.635,0.321,0.518,28
diversify,0.645,16,12,1,1,0.656,0.588,0.464,28
mutilate,0.645,16,12,1,1,0.125,0.9,0.465,28
pungent,0.645,16,12,1,1,0.347,0.755,0.535,28
melodious,0.645,16,12,1,1,0.932,0.53,0.587,28
anaconda,0.645,16,12,1,1,0.146,0.83,0.54,28
cargo,0.645,67,51,1,1,0.408,0.444,0.455,118
wrangling,0.645,16,12,1,1,0.146,0.865,0.585,28
quay,0.645,16,12,1,1,0.542,0.209,0.442,28
enigmatic,0.645,33,25,1,1,0.469,0.589,0.679,58
raccoon,0.644,165,126,1,1,0.541,0.435,0.32,291
shivering,0.644,165,126,1,1,0.122,0.663,0.373,291
camaraderie,0.644,165,126,1,1,0.833,0.51,0.648,291
conversing,0.644,131,100,1,1,0.755,0.409,0.442,231
retriever,0.644,80,61,1,1,0.459,0.5,0.464,141
homeless,0.643,2906,2225,1,1,0.042,0.45,0.188,5131
waddle,0.643,46,35,1,1,0.49,0.453,0.388,81
round,0.643,4050,3103,1,1,0.552,0.434,0.311,7153
film,0.642,4498,3448,1,1,0.823,0.491,0.566,7946
rinse,0.642,149,114,1,1,0.663,0.168,0.409,263
sailboat,0.642,29,22,1,1,0.719,0.392,0.381,51
commuter,0.642,59,45,1,1,0.646,0.52,0.512,104
bonne,0.642,29,22,1,1,0.448,0.395,0.362,51
frostbite,0.642,29,22,1,1,0.203,0.38,0.566,51
lightweight,0.642,59,45,1,1,0.67,0.3,0.358,104
indifferent,0.642,329,252,1,1,0.396,0.157,0.25,581
agency,0.642,651,499,1,1,0.46,0.296,0.583,1150
hee,0.642,325,249,1,1,0.43,0.433,0.312,574
affections,0.642,102,78,1,1,0.76,0.547,0.655,180
eventful,0.641,72,55,1,1,0.543,0.837,0.51,127
conjure,0.641,72,55,1,1,0.385,0.679,0.645,127
dementia,0.641,966,741,1,1,0.092,0.779,0.337,1707
penetration,0.641,85,65,1,1,0.438,0.885,0.792,150
wavy,0.641,85,65,1,1,0.52,0.284,0.345,150
diary,0.641,1036,795,1,1,0.698,0.292,0.464,1831
tail,0.641,666,511,1,1,0.48,0.272,0.293,1177
snatch,0.64,180,138,1,1,0.219,0.861,0.691,318
meanie,0.64,68,52,1,1,0.388,0.42,0.404,120
anxiousness,0.64,68,52,1,1,0.235,0.814,0.282,120
chimes,0.64,68,52,1,1,0.625,0.49,0.402,120
pastime,0.64,81,62,1,1,0.677,0.353,0.443,143
notch,0.64,215,165,1,1,0.459,0.361,0.358,380
exclusive,0.639,574,441,1,1,0.792,0.63,0.653,1015
herd,0.639,488,375,1,1,0.592,0.5,0.474,863
inclusion,0.639,315,242,1,1,0.774,0.404,0.712,557
inaugural,0.639,25,19,1,1,0.684,0.567,0.608,44
gooey,0.639,25,19,1,1,0.392,0.48,0.445,44
inquire,0.639,51,39,1,1,0.583,0.519,0.363,90
eggplant,0.639,38,29,1,1,0.592,0.152,0.323,67
surge,0.639,155,119,1,1,0.449,0.684,0.5,274
fatigue,0.638,537,413,1,1,0.173,0.378,0.265,950
smash,0.638,1432,1102,1,1,0.195,0.692,0.53,2534
lee,0.638,2133,1642,1,1,0.51,0.269,0.296,3775
underlying,0.638,312,240,1,1,0.48,0.445,0.452,552
carpool,0.638,99,76,1,1,0.625,0.509,0.5,175
timid,0.637,182,140,1,1,0.327,0.276,0.132,322
beaches,0.637,217,167,1,1,0.865,0.5,0.538,384
dork,0.636,261,201,1,1,0.272,0.519,0.361,462
acid,0.636,344,265,1,1,0.265,0.642,0.566,609
goddamn,0.636,2139,1649,1,1,0.125,0.76,0.422,3788
parrot,0.636,187,144,1,1,0.588,0.333,0.292,331
capitalist,0.636,222,171,1,1,0.352,0.577,0.821,393
gardener,0.636,69,53,1,1,0.673,0.346,0.361,122
plat,0.636,34,26,1,1,0.716,0.359,0.556,60
wry,0.636,34,26,1,1,0.219,0.548,0.528,60
prowess,0.636,34,26,1,1,0.792,0.657,0.833,60
innings,0.636,34,26,1,1,0.573,0.487,0.443,60
fairy,0.636,752,580,1,1,0.776,0.408,0.413,1332
widow,0.636,818,631,1,1,0.25,0.45,0.265,1449
splash,0.635,148,114,1,1,0.521,0.412,0.281,262
tod,0.635,56,43,1,1,0.469,0.33,0.384,99
smother,0.635,113,87,1,1,0.292,0.685,0.42,200
entertainment,0.635,1368,1056,1,1,0.847,0.75,0.569,2424
grim,0.635,359,277,1,1,0.31,0.483,0.298,636
rebellion,0.635,166,128,1,1,0.245,0.843,0.746,294
austerity,0.635,166,128,1,1,0.438,0.406,0.534,294
lawnmower,0.634,21,16,1,1,0.48,0.531,0.355,37
firefly,0.634,87,67,1,1,0.622,0.41,0.363,154
preliminary,0.634,21,16,1,1,0.531,0.393,0.585,37
innocently,0.634,65,50,1,1,0.776,0.25,0.302,115
clouds,0.634,1416,1094,1,1,0.735,0.195,0.324,2510
superiority,0.634,140,108,1,1,0.582,0.602,0.959,248
antagonist,0.633,74,57,1,1,0.24,0.615,0.7,131
launches,0.633,52,40,1,1,0.49,0.663,0.602,92
chimney,0.633,52,40,1,1,0.583,0.286,0.225,92
cradle,0.633,105,81,1,1,0.776,0.194,0.333,186
twitch,0.633,1090,843,1,1,0.51,0.74,0.548,1933
falsehood,0.633,83,64,1,1,0.031,0.625,0.384,147
hart,0.632,207,160,1,1,0.643,0.389,0.447,367
fallow,0.632,30,23,1,1,0.375,0.368,0.464,53
mould,0.632,61,47,1,1,0.357,0.176,0.246,108
fraught,0.632,61,47,1,1,0.266,0.662,0.596,108
taco,0.632,526,407,1,1,0.561,0.353,0.277,933
pickled,0.632,30,23,1,1,0.344,0.45,0.291,53
mobility,0.632,194,150,1,1,0.7,0.596,0.654,344
sideways,0.632,234,181,1,1,0.788,0.245,0.291,415
bust,0.632,589,456,1,1,0.52,0.5,0.42,1045
ell,0.631,39,30,1,1,0.469,0.418,0.373,69
counterpoint,0.631,39,30,1,1,0.438,0.509,0.538,69
quivering,0.631,39,30,1,1,0.407,0.776,0.342,69
terrestrial,0.631,39,30,1,1,0.542,0.413,0.582,69
surrendering,0.631,79,61,1,1,0.198,0.411,0.245,140
stale,0.631,217,168,1,1,0.235,0.461,0.286,385
millennium,0.631,88,68,1,1,0.573,0.398,0.76,156
subtext,0.631,48,37,1,1,0.635,0.276,0.412,85
futon,0.631,48,37,1,1,0.429,0.351,0.343,85
lessen,0.63,351,272,1,1,0.235,0.284,0.255,623
popularity,0.63,458,355,1,1,0.896,0.784,0.861,813
server,0.63,1025,795,1,1,0.656,0.356,0.536,1820
suburbs,0.63,182,141,1,1,0.51,0.571,0.286,323
halo,0.63,365,283,1,1,0.49,0.37,0.441,648
commissioner,0.63,66,51,1,1,0.602,0.449,0.949,117
delusional,0.629,998,775,1,1,0.219,0.745,0.327,1773
civic,0.629,111,86,1,1,0.653,0.24,0.573,197
introduce,0.629,748,581,1,1,0.592,0.559,0.648,1329
cover,0.629,4839,3760,1,1,0.365,0.24,0.471,8599
demographic,0.628,228,177,1,1,0.459,0.356,0.594,405
vanity,0.628,237,184,1,1,0.26,0.54,0.439,421
keypad,0.628,17,13,1,1,0.604,0.255,0.33,30
taming,0.628,17,13,1,1,0.569,0.514,0.575,30
missionary,0.628,62,48,1,1,0.729,0.404,0.596,110
unwed,0.628,17,13,1,1,0.541,0.595,0.459,30
promotional,0.628,35,27,1,1,0.84,0.646,0.679,62
expectant,0.628,26,20,1,1,0.708,0.65,0.474,46
midsummer,0.628,44,34,1,1,0.781,0.48,0.492,78
rung,0.628,44,34,1,1,0.51,0.355,0.368,78
lettering,0.628,17,13,1,1,0.541,0.18,0.431,30
toxin,0.628,17,13,1,1,0.115,0.654,0.456,30
suffocation,0.628,53,41,1,1,0.02,0.83,0.462,94
bleeding,0.627,798,621,1,1,0.135,0.817,0.408,1419
endless,0.627,2407,1874,1,1,0.347,0.462,0.472,4281
kris,0.626,365,284,1,1,0.427,0.417,0.407,649
stoic,0.626,112,87,1,1,0.427,0.473,0.602,199
moss,0.626,103,80,1,1,0.235,0.27,0.245,183
highlight,0.626,886,690,1,1,0.844,0.637,0.882,1576
retards,0.626,85,66,1,1,0.362,0.434,0.218,151
cloak,0.626,171,133,1,1,0.469,0.188,0.333,304
starving,0.626,814,634,1,1,0.163,0.67,0.336,1448
oblivion,0.626,307,239,1,1,0.153,0.33,0.282,546
programme,0.626,425,331,1,1,0.74,0.298,0.537,756
musical,0.625,992,773,1,1,0.908,0.63,0.53,1765
graffiti,0.625,58,45,1,1,0.582,0.633,0.353,103
mast,0.625,49,38,1,1,0.542,0.39,0.58,87
beau,0.625,140,109,1,1,0.612,0.44,0.432,249
tidal,0.625,90,70,1,1,0.592,0.539,0.519,160
painting,0.624,1052,821,1,1,0.792,0.324,0.333,1873
bye,0.624,6639,5183,1,1,0.375,0.398,0.321,11822
coastal,0.624,72,56,1,1,0.604,0.37,0.51,128
bargaining,0.624,72,56,1,1,0.622,0.64,0.642,128
parish,0.623,136,106,1,1,0.698,0.354,0.582,242
barn,0.623,200,156,1,1,0.51,0.452,0.425,356
interaction,0.623,3930,3070,1,1,0.646,0.735,0.75,7000
racer,0.623,31,24,1,1,0.48,0.631,0.678,55
germ,0.623,31,24,1,1,0.265,0.421,0.302,55
skate,0.623,237,185,1,1,0.74,0.653,0.508,422
doggy,0.623,237,185,1,1,0.646,0.491,0.404,422
limelight,0.623,141,110,1,1,0.667,0.639,0.694,251
poetry,0.623,1488,1163,1,1,0.697,0.235,0.629,2651
railway,0.622,109,85,1,1,0.613,0.615,0.623,194
boon,0.622,54,42,1,1,0.878,0.294,0.642,96
counteract,0.622,54,42,1,1,0.378,0.542,0.688,96
symptom,0.622,384,300,1,1,0.38,0.529,0.434,684
meth,0.622,187,146,1,1,0.354,0.564,0.34,333
sample,0.622,270,211,1,1,0.521,0.187,0.452,481
aloft,0.621,22,17,1,1,0.771,0.373,0.7,39
dryness,0.621,22,17,1,1,0.292,0.296,0.263,39
recital,0.621,22,17,1,1,0.838,0.44,0.572,39
dispirited,0.621,22,17,1,1,0.204,0.28,0.142,39
coloring,0.621,137,107,1,1,0.781,0.469,0.353,244
arithmetic,0.621,22,17,1,1,0.453,0.46,0.634,39
scholarly,0.621,22,17,1,1,0.75,0.466,0.709,39
rub,0.621,1099,860,1,1,0.521,0.565,0.4,1959
triangle,0.621,165,129,1,1,0.562,0.269,0.352,294
brandy,0.621,119,93,1,1,0.6,0.59,0.487,212
chronicle,0.62,36,28,1,1,0.427,0.571,0.586,64
joyful,0.62,531,416,1,1,0.99,0.74,0.667,947
vagina,0.62,425,333,1,1,0.551,0.87,0.5,758
chapel,0.619,138,108,1,1,0.573,0.24,0.44,246
motherfucking,0.619,231,181,1,1,0.071,0.823,0.373,412
eastern,0.619,361,283,1,1,0.521,0.42,0.48,644
rapping,0.619,194,152,1,1,0.565,0.716,0.417,346
peachy,0.619,64,50,1,1,0.755,0.479,0.388,114
weenie,0.619,64,50,1,1,0.406,0.451,0.284,114
billboard,0.619,208,163,1,1,0.594,0.317,0.481,371
obsessive,0.619,352,276,1,1,0.219,0.823,0.48,628
yearn,0.619,352,276,1,1,0.592,0.491,0.491,628
furry,0.619,854,670,1,1,0.428,0.4,0.333,1524
voluntary,0.619,171,134,1,1,0.771,0.46,0.643,305
childhood,0.618,3612,2835,1,1,0.865,0.413,0.307,6447
wind,0.618,3706,2909,1,1,0.531,0.404,0.578,6615
success,0.618,4391,3447,1,1,0.959,0.88,0.981,7838
chap,0.618,255,200,1,1,0.55,0.41,0.345,455
capitalism,0.618,577,453,1,1,0.448,0.686,0.848,1030
neurotic,0.617,139,109,1,1,0.198,0.801,0.387,248
erosion,0.617,41,32,1,1,0.312,0.77,0.465,73
path,0.617,8175,6423,1,1,0.59,0.245,0.421,14598
famine,0.617,69,54,1,1,0.163,0.679,0.31,123
realism,0.617,83,65,1,1,0.74,0.545,0.67,148
cocksucker,0.617,27,21,1,1,0.083,0.764,0.339,48
fink,0.617,27,21,1,1,0.41,0.514,0.439,48
blue,0.617,8746,6874,1,1,0.646,0.137,0.291,15620
converse,0.617,373,293,1,1,0.594,0.406,0.598,666
pill,0.617,1192,937,1,1,0.573,0.407,0.368,2129
unattached,0.616,74,58,1,1,0.192,0.439,0.283,132
orphanage,0.616,135,106,1,1,0.184,0.439,0.425,241
lavish,0.616,107,84,1,1,0.792,0.648,0.73,191
quirky,0.616,342,269,1,1,0.708,0.373,0.564,611
gizmo,0.616,46,36,1,1,0.51,0.49,0.337,82
capsule,0.616,46,36,1,1,0.583,0.29,0.57,82
price,0.615,2547,2005,1,1,0.479,0.475,0.535,4552
grumpy,0.615,720,567,1,1,0.198,0.808,0.559,1287
keg,0.615,32,25,1,1,0.551,0.389,0.404,57
piggy,0.615,164,129,1,1,0.541,0.365,0.412,293
misread,0.615,98,77,1,1,0.115,0.558,0.315,175
repellent,0.615,32,25,1,1,0.286,0.5,0.491,57
mosaic,0.615,32,25,1,1,0.635,0.25,0.302,57
cascade,0.615,32,25,1,1,0.735,0.509,0.395,57
jingle,0.615,131,103,1,1,0.635,0.5,0.424,234
arbor,0.615,32,25,1,1,0.583,0.49,0.591,57
youthful,0.614,84,66,1,1,0.827,0.48,0.686,150
merciless,0.614,51,40,1,1,0.062,0.88,0.634,91
hurl,0.614,51,40,1,1,0.316,0.745,0.574,91
achy,0.614,51,40,1,1,0.167,0.84,0.373,91
intellectual,0.614,680,536,1,1,0.906,0.455,0.845,1216
mellow,0.614,174,137,1,1,0.633,0.069,0.265,311
touch,0.614,10765,8489,1,1,0.646,0.477,0.455,19254
cheery,0.614,122,96,1,1,0.949,0.657,0.486,218
farming,0.613,217,171,1,1,0.58,0.414,0.568,388
misery,0.613,3891,3070,1,1,0.146,0.378,0.158,6961
cat,0.613,16335,12893,1,1,0.667,0.26,0.37,29228
smelly,0.613,208,164,1,1,0.1,0.528,0.245,372
eject,0.613,18,14,1,1,0.434,0.656,0.559,32
crevice,0.613,18,14,1,1,0.361,0.471,0.275,32
delirium,0.613,37,29,1,1,0.233,0.694,0.484,66
seminal,0.613,18,14,1,1,0.459,0.413,0.566,32
flatulence,0.613,18,14,1,1,0.21,0.632,0.343,32
submerge,0.613,18,14,1,1,0.517,0.643,0.456,32
perdition,0.613,18,14,1,1,0.135,0.656,0.496,32
piggyback,0.613,18,14,1,1,0.438,0.49,0.343,32
coherence,0.613,18,14,1,1,0.72,0.406,0.788,32
alchemy,0.613,37,29,1,1,0.541,0.583,0.693,66
pore,0.613,18,14,1,1,0.427,0.271,0.342,32
albino,0.613,37,29,1,1,0.5,0.24,0.358,66
delighted,0.612,456,360,1,1,0.938,0.664,0.685,816
lace,0.612,123,97,1,1,0.625,0.2,0.293,220
swoon,0.612,61,48,1,1,0.292,0.51,0.16,109
cube,0.611,271,214,1,1,0.469,0.226,0.274,485
departure,0.611,195,154,1,1,0.573,0.5,0.426,349
thrift,0.611,66,52,1,1,0.76,0.217,0.649,118
contentment,0.611,358,283,1,1,0.875,0.61,0.782,641
riches,0.611,224,177,1,1,0.958,0.694,0.88,401
author,0.61,1093,865,1,1,0.775,0.343,0.749,1958
concord,0.61,23,18,1,1,0.677,0.32,0.586,41
sandal,0.61,23,18,1,1,0.49,0.283,0.333,41
relocation,0.61,23,18,1,1,0.396,0.5,0.475,41
chowder,0.61,23,18,1,1,0.51,0.324,0.241,41
kernel,0.61,23,18,1,1,0.542,0.453,0.462,41
uncouth,0.61,23,18,1,1,0.08,0.761,0.35,41
valentine,0.609,9787,7752,1,1,0.888,0.615,0.51,17539
lsd,0.609,76,60,1,1,0.375,0.471,0.39,136
hitch,0.609,76,60,1,1,0.512,0.48,0.554,136
congratulation,0.609,76,60,1,1,0.948,0.78,0.717,136
fluffy,0.609,519,411,1,1,0.781,0.431,0.356,930
fruity,0.609,52,41,1,1,0.683,0.414,0.33,93
chitchat,0.609,52,41,1,1,0.673,0.455,0.403,93
exude,0.609,52,41,1,1,0.375,0.519,0.411,93
waves,0.608,1858,1473,1,1,0.643,0.47,0.509,3331
cash,0.608,1525,1209,1,1,0.867,0.552,0.714,2734
speaker,0.608,1192,945,1,1,0.604,0.66,0.723,2137
whirl,0.608,28,22,1,1,0.461,0.788,0.661,50
pacify,0.608,28,22,1,1,0.812,0.283,0.629,50
diagram,0.608,86,68,1,1,0.562,0.357,0.445,154
deepen,0.608,57,45,1,1,0.625,0.53,0.776,102
ostensibly,0.608,28,22,1,1,0.473,0.529,0.509,50
labyrinth,0.608,91,72,1,1,0.479,0.811,0.491,163
director,0.608,677,537,1,1,0.688,0.58,0.912,1214
dale,0.608,154,122,1,1,0.622,0.27,0.365,276
martini,0.607,62,49,1,1,0.828,0.5,0.519,111
unhappy,0.607,5995,4758,1,1,0.112,0.5,0.155,10753
drivel,0.607,96,76,1,1,0.398,0.469,0.463,172
blob,0.607,96,76,1,1,0.5,0.376,0.298,172
ambient,0.607,96,76,1,1,0.625,0.36,0.582,172
granny,0.607,518,411,1,1,0.796,0.24,0.452,929
intricate,0.607,67,53,1,1,0.559,0.704,0.5,120
irregular,0.607,67,53,1,1,0.312,0.548,0.321,120
arduous,0.607,67,53,1,1,0.344,0.783,0.605,120
powerfully,0.607,67,53,1,1,0.854,0.724,0.935,120
streak,0.607,271,215,1,1,0.44,0.608,0.511,486
dill,0.607,33,26,1,1,0.427,0.36,0.373,59
junk,0.607,723,574,1,1,0.115,0.481,0.118,1297
gardens,0.607,213,169,1,1,0.775,0.202,0.296,382
sucking,0.606,705,560,1,1,0.227,0.528,0.377,1265
presents,0.606,1032,820,1,1,0.781,0.394,0.526,1852
sundae,0.606,38,30,1,1,0.743,0.414,0.404,68
smartass,0.606,38,30,1,1,0.364,0.52,0.62,68
exchange,0.606,1073,853,1,1,0.74,0.569,0.491,1926
embers,0.605,43,34,1,1,0.49,0.481,0.508,77
nurture,0.604,303,241,1,1,0.745,0.378,0.657,544
hop,0.604,1271,1012,1,1,0.45,0.52,0.427,2283
noodle,0.604,230,183,1,1,0.633,0.216,0.225,413
expressive,0.603,127,101,1,1,0.755,0.724,0.685,228
naught,0.603,63,50,1,1,0.344,0.176,0.161,113
handsome,0.603,1521,1212,1,1,0.89,0.6,0.682,2733
letters,0.603,1296,1033,1,1,0.663,0.327,0.364,2329
capitalize,0.602,83,66,1,1,0.771,0.601,0.885,149
directed,0.602,548,437,1,1,0.542,0.49,0.541,985
lookout,0.602,98,78,1,1,0.698,0.538,0.639,176
inseparable,0.602,98,78,1,1,0.7,0.52,0.571,176
pearl,0.602,306,244,1,1,0.905,0.425,0.642,550
diesel,0.602,103,82,1,1,0.49,0.327,0.448,185
appease,0.602,113,90,1,1,0.633,0.278,0.434,203
weeds,0.602,118,94,1,1,0.32,0.551,0.315,212
dissatisfied,0.601,123,98,1,1,0.042,0.561,0.291,221
phantom,0.601,312,249,1,1,0.26,0.759,0.448,561
doe,0.601,511,408,1,1,0.55,0.336,0.336,919
booklet,0.599,19,15,1,1,0.51,0.27,0.351,34
rudder,0.599,14,11,1,1,0.439,0.469,0.509,25
cherub,0.599,14,11,1,1,0.663,0.34,0.455,25
steep,0.599,129,103,1,1,0.312,0.612,0.321,232
scat,0.599,29,23,1,1,0.337,0.548,0.409,52
corporeal,0.599,14,11,1,1,0.52,0.35,0.461,25
piping,0.599,24,19,1,1,0.365,0.337,0.405,43
imissyou,0.599,39,31,1,1,0.48,0.608,0.344,70
namesake,0.599,39,31,1,1,0.418,0.327,0.404,70
domination,0.599,104,83,1,1,0.505,0.786,0.959,187
abduct,0.599,39,31,1,1,0.173,0.72,0.615,70
miffed,0.599,19,15,1,1,0.204,0.726,0.429,34
unbelief,0.599,24,19,1,1,0.265,0.582,0.407,43
insinuate,0.599,34,27,1,1,0.292,0.635,0.413,61
renegade,0.599,44,35,1,1,0.14,0.64,0.509,79
philanthropy,0.599,24,19,1,1,0.745,0.412,0.801,43
crackle,0.599,24,19,1,1,0.327,0.643,0.481,43
infamy,0.599,24,19,1,1,0.177,0.676,0.421,43
lather,0.599,14,11,1,1,0.635,0.327,0.313,25
overgrown,0.599,69,55,1,1,0.333,0.5,0.369,124
ornament,0.599,34,27,1,1,0.561,0.373,0.441,61
viking,0.599,79,63,1,1,0.541,0.755,0.605,142
hypnotic,0.599,34,27,1,1,0.571,0.56,0.569,61
mongrel,0.599,14,11,1,1,0.425,0.438,0.395,25
euphoric,0.599,99,79,1,1,0.745,0.904,0.588,178
wop,0.599,14,11,1,1,0.417,0.452,0.394,25
candlelight,0.599,59,47,1,1,0.789,0.294,0.417,106
mead,0.599,24,19,1,1,0.667,0.337,0.441,43
backwater,0.599,14,11,1,1,0.312,0.41,0.161,25
descendant,0.599,34,27,1,1,0.684,0.42,0.625,61
sweltering,0.599,19,15,1,1,0.204,0.644,0.362,34
disorientation,0.599,14,11,1,1,0.163,0.472,0.212,25
whimsy,0.599,19,15,1,1,0.729,0.639,0.455,34
spotty,0.599,39,31,1,1,0.281,0.606,0.241,70
constable,0.599,14,11,1,1,0.573,0.667,0.764,25
slop,0.599,14,11,1,1,0.306,0.409,0.325,25
cognac,0.599,14,11,1,1,0.615,0.51,0.43,25
spontaneity,0.599,24,19,1,1,0.817,0.698,0.655,43
caviar,0.599,19,15,1,1,0.906,0.394,0.481,34
derivative,0.599,19,15,1,1,0.541,0.491,0.508,34
beseech,0.599,19,15,1,1,0.33,0.441,0.6,34
photo,0.599,3627,2902,1,1,0.729,0.327,0.431,6529
visual,0.599,675,540,1,1,0.813,0.462,0.462,1215
detective,0.599,365,292,1,1,0.5,0.764,0.901,657
shifting,0.599,335,268,1,1,0.518,0.548,0.546,603
little,0.599,68556,54898,1,1,0.385,0.16,0.213,123454
brag,0.598,511,409,1,1,0.347,0.545,0.578,920
bottom,0.598,4312,3454,1,1,0.417,0.37,0.291,7766
darkened,0.598,155,124,1,1,0.135,0.44,0.452,279
mask,0.598,2114,1694,1,1,0.51,0.49,0.537,3808
roaring,0.597,120,96,1,1,0.449,0.817,0.634,216
local,0.597,4719,3783,1,1,0.656,0.269,0.452,8502
imprisoned,0.597,231,185,1,1,0.032,0.717,0.302,416
excessive,0.597,332,266,1,1,0.417,0.731,0.601,598
mature,0.597,1427,1144,1,1,0.625,0.347,0.6,2571
homeboy,0.597,201,161,1,1,0.602,0.255,0.436,362
tuck,0.597,196,157,1,1,0.367,0.473,0.361,353
strategy,0.597,955,766,1,1,0.704,0.667,0.858,1721
retarded,0.596,485,389,1,1,0.302,0.462,0.161,874
unusually,0.596,80,64,1,1,0.385,0.406,0.358,144
conceited,0.596,80,64,1,1,0.194,0.667,0.473,144
damn,0.596,34524,27707,1,1,0.073,0.784,0.431,62231
sitting,0.596,15785,12669,1,1,0.561,0.146,0.353,28454
schoolwork,0.596,75,60,1,1,0.479,0.5,0.481,135
sadistic,0.596,146,117,1,1,0.031,0.906,0.618,263
excerpt,0.596,131,105,1,1,0.437,0.367,0.543,236
beaver,0.596,65,52,1,1,0.49,0.344,0.393,117
cohort,0.596,126,101,1,1,0.459,0.551,0.566,227
elegant,0.596,126,101,1,1,0.865,0.5,0.685,227
cattle,0.595,116,93,1,1,0.622,0.34,0.445,209
perpetuate,0.595,111,89,1,1,0.397,0.588,0.788,200
spanking,0.595,55,44,1,1,0.194,0.736,0.392,99
elders,0.595,437,351,1,1,0.602,0.26,0.441,788
montage,0.595,106,85,1,1,0.438,0.52,0.388,191
mediocrity,0.595,208,167,1,1,0.073,0.398,0.225,375
carols,0.595,50,40,1,1,0.847,0.42,0.491,90
riding,0.595,1422,1143,1,1,0.694,0.654,0.62,2565
entertain,0.594,1795,1443,1,1,0.918,0.684,0.598,3238
mythical,0.594,96,77,1,1,0.625,0.556,0.583,173
gab,0.594,142,114,1,1,0.5,0.471,0.375,256
sundown,0.594,45,36,1,1,0.812,0.276,0.445,81
song,0.594,38054,30613,1,1,0.854,0.413,0.5,68667
decaying,0.594,86,69,1,1,0.073,0.51,0.214,155
dam,0.593,993,799,1,1,0.25,0.553,0.394,1792
drugs,0.593,4201,3381,1,1,0.167,0.75,0.368,7582
foreboding,0.593,40,32,1,1,0.439,0.706,0.636,72
whammy,0.593,40,32,1,1,0.461,0.491,0.345,72
folklore,0.593,40,32,1,1,0.755,0.585,0.449,72
worldly,0.593,122,98,1,1,0.438,0.612,0.295,220
lifestyle,0.593,1578,1270,1,1,0.75,0.472,0.645,2848
chorus,0.593,656,528,1,1,0.62,0.417,0.5,1184
destination,0.593,739,595,1,1,0.708,0.471,0.637,1334
pictures,0.593,4846,3903,1,1,0.653,0.24,0.405,8749
connection,0.593,5224,4208,1,1,0.729,0.56,0.655,9432
truss,0.593,35,28,1,1,0.521,0.482,0.569,63
startling,0.593,71,57,1,1,0.75,0.768,0.83,128
barbed,0.593,35,28,1,1,0.177,0.594,0.455,63
eavesdropping,0.593,35,28,1,1,0.49,0.38,0.441,63
released,0.592,1926,1552,1,1,0.844,0.49,0.651,3478
musician,0.592,391,315,1,1,0.816,0.509,0.618,706
rejects,0.591,247,199,1,1,0.083,0.637,0.422,446
cacophony,0.591,30,24,1,1,0.408,0.562,0.44,54
madman,0.591,118,95,1,1,0.135,0.88,0.312,213
femme,0.591,118,95,1,1,0.551,0.529,0.398,213
foolish,0.591,958,773,1,1,0.316,0.255,0.109,1731
foresee,0.59,82,66,1,1,0.583,0.452,0.522,148
entertained,0.59,524,423,1,1,0.902,0.644,0.712,947
superior,0.59,810,654,1,1,0.801,0.697,0.94,1464
giver,0.59,155,125,1,1,0.688,0.415,0.658,280
tranquil,0.59,103,83,1,1,0.917,0.094,0.355,186
falcon,0.59,103,83,1,1,0.557,0.58,0.678,186
panacea,0.59,25,20,1,1,0.42,0.427,0.613,45
untamed,0.59,25,20,1,1,0.429,0.778,0.709,45
degeneracy,0.59,25,20,1,1,0.143,0.72,0.298,45
inn,0.59,176,142,1,1,0.66,0.284,0.475,318
steak,0.589,437,353,1,1,0.625,0.359,0.315,790
lama,0.589,187,151,1,1,0.56,0.32,0.4,338
dashing,0.589,46,37,1,1,0.612,0.627,0.799,83
autograph,0.589,46,37,1,1,0.735,0.565,0.473,83
embark,0.589,93,75,1,1,0.541,0.55,0.619,168
tame,0.589,208,168,1,1,0.56,0.604,0.642,376
hibernation,0.589,67,54,1,1,0.469,0.245,0.384,121
rampage,0.589,67,54,1,1,0.24,0.875,0.509,121
stimulating,0.588,88,71,1,1,0.74,0.804,0.809,159
shunned,0.588,376,304,1,1,0.271,0.464,0.367,680
astray,0.588,130,105,1,1,0.098,0.676,0.308,235
keeper,0.588,377,305,1,1,0.612,0.457,0.773,682
prance,0.588,20,16,1,1,0.683,0.547,0.435,36
stunner,0.588,20,16,1,1,0.418,0.78,0.492,36
leprechaun,0.588,20,16,1,1,0.417,0.48,0.417,36
chatterbox,0.588,20,16,1,1,0.459,0.548,0.482,36
earthy,0.588,20,16,1,1,0.375,0.413,0.404,36
individual,0.588,3522,2851,1,1,0.627,0.327,0.533,6373
aye,0.587,1397,1131,1,1,0.562,0.42,0.392,2528
absorbed,0.587,241,195,1,1,0.49,0.471,0.519,436
onion,0.587,257,208,1,1,0.378,0.367,0.382,465
greatness,0.587,752,609,1,1,0.99,0.75,0.943,1361
nickname,0.587,273,221,1,1,0.49,0.47,0.263,494
chamber,0.587,484,392,1,1,0.583,0.373,0.455,876
amusement,0.586,226,183,1,1,0.929,0.837,0.803,409
wright,0.586,168,136,1,1,0.54,0.528,0.389,304
remote,0.586,1183,959,1,1,0.458,0.333,0.477,2142
ballet,0.586,110,89,1,1,0.656,0.48,0.358,199
pipe,0.586,290,235,1,1,0.541,0.34,0.33,525
fictional,0.586,634,514,1,1,0.43,0.49,0.34,1148
simulator,0.586,89,72,1,1,0.677,0.559,0.583,161
jam,0.586,1259,1021,1,1,0.51,0.548,0.318,2280
yak,0.585,52,42,1,1,0.469,0.422,0.422,94
floss,0.585,68,55,1,1,0.5,0.28,0.278,123
innovative,0.585,153,124,1,1,0.88,0.64,0.83,277
rye,0.585,84,68,1,1,0.49,0.298,0.411,152
replay,0.584,404,328,1,1,0.612,0.522,0.761,732
snarling,0.584,15,12,1,1,0.312,0.704,0.491,27
anvil,0.584,15,12,1,1,0.38,0.51,0.604,27
proton,0.584,15,12,1,1,0.458,0.415,0.491,27
temporal,0.584,47,38,1,1,0.5,0.413,0.36,85
screenplay,0.584,63,51,1,1,0.5,0.406,0.518,114
boutique,0.584,31,25,1,1,0.745,0.49,0.441,56
mastermind,0.584,47,38,1,1,0.792,0.625,0.918,85
enlarge,0.584,31,25,1,1,0.735,0.606,0.688,56
pillowcase,0.584,15,12,1,1,0.5,0.179,0.25,27
fireman,0.584,31,25,1,1,0.583,0.745,0.755,56
induce,0.584,63,51,1,1,0.257,0.606,0.684,114
irrelevant,0.584,1002,814,1,1,0.138,0.311,0.296,1816
hank,0.584,544,442,1,1,0.51,0.375,0.339,986
poster,0.583,668,543,1,1,0.542,0.275,0.365,1211
rekindle,0.583,74,60,1,1,0.656,0.52,0.788,134
nightly,0.583,235,191,1,1,0.673,0.41,0.474,426
degenerate,0.582,187,152,1,1,0.069,0.724,0.264,339
pretty,0.582,34017,27688,1,1,0.875,0.516,0.561,61705
continuum,0.582,42,34,1,1,0.677,0.39,0.491,76
internet,0.582,8438,6868,1,1,0.76,0.462,0.755,15306
curl,0.582,806,656,1,1,0.385,0.452,0.351,1462
mundane,0.582,268,218,1,1,0.312,0.42,0.48,486
welsh,0.582,182,148,1,1,0.49,0.385,0.5,330
suburban,0.582,193,157,1,1,0.439,0.45,0.453,350
departed,0.581,150,122,1,1,0.245,0.536,0.391,272
instability,0.581,150,122,1,1,0.177,0.76,0.353,272
fantasia,0.581,26,21,1,1,0.898,0.694,0.436,47
pinot,0.581,26,21,1,1,0.365,0.37,0.361,47
nicotine,0.581,107,87,1,1,0.235,0.608,0.447,194
bookstore,0.581,188,153,1,1,0.771,0.18,0.503,341
rabies,0.581,26,21,1,1,0.115,0.75,0.382,47
wander,0.581,875,713,1,1,0.427,0.417,0.33,1588
wick,0.581,145,118,1,1,0.337,0.481,0.309,263
river,0.581,1703,1388,1,1,0.688,0.392,0.605,3091
taxi,0.581,659,537,1,1,0.542,0.362,0.43,1196
sketch,0.581,340,277,1,1,0.704,0.276,0.42,617
surrogate,0.58,64,52,1,1,0.406,0.59,0.472,116
fricking,0.58,140,114,1,1,0.333,0.642,0.357,254
rover,0.58,319,260,1,1,0.51,0.538,0.421,579
tar,0.58,75,61,1,1,0.438,0.44,0.57,136
ingredient,0.58,75,61,1,1,0.792,0.373,0.451,136
splendid,0.58,113,92,1,1,0.896,0.74,0.81,205
angle,0.579,462,377,1,1,0.541,0.33,0.455,839
egg,0.579,909,742,1,1,0.684,0.241,0.293,1651
sill,0.579,59,48,1,1,0.433,0.375,0.324,107
lineup,0.579,201,164,1,1,0.635,0.427,0.638,365
pop,0.579,3407,2783,1,1,0.673,0.51,0.491,6190
sappy,0.578,447,365,1,1,0.583,0.469,0.33,812
childlike,0.578,81,66,1,1,0.656,0.372,0.293,147
lowlife,0.578,103,84,1,1,0.296,0.529,0.309,187
excluded,0.578,563,460,1,1,0.061,0.54,0.134,1023
euro,0.578,229,187,1,1,0.68,0.441,0.521,416
greed,0.577,685,560,1,1,0.173,0.78,0.528,1245
outer,0.577,411,336,1,1,0.552,0.471,0.456,747
ugly,0.577,12679,10371,1,1,0.167,0.63,0.254,23050
material,0.577,1285,1051,1,1,0.521,0.363,0.439,2336
sophisticated,0.577,109,89,1,1,0.865,0.481,0.845,198
charmed,0.577,76,62,1,1,0.938,0.57,0.769,138
posture,0.577,98,80,1,1,0.562,0.309,0.598,178
deflection,0.577,43,35,1,1,0.188,0.5,0.382,78
elude,0.577,21,17,1,1,0.438,0.521,0.464,38
tenfold,0.577,43,35,1,1,0.469,0.418,0.5,78
approximate,0.577,21,17,1,1,0.551,0.56,0.52,38
statesman,0.577,32,26,1,1,0.51,0.49,0.736,58
beset,0.577,21,17,1,1,0.385,0.717,0.317,38
rehabilitate,0.577,21,17,1,1,0.671,0.538,0.642,38
mystique,0.577,21,17,1,1,0.668,0.633,0.667,38
haystack,0.577,21,17,1,1,0.552,0.292,0.331,38
mammoth,0.577,32,26,1,1,0.48,0.471,0.537,58
santa,0.577,990,810,1,1,0.735,0.286,0.509,1800
decay,0.576,264,216,1,1,0.143,0.312,0.17,480
skinny,0.576,839,687,1,1,0.333,0.333,0.298,1526
monopoly,0.576,154,126,1,1,0.449,0.509,0.64,280
treasures,0.575,143,117,1,1,0.867,0.771,0.842,260
fig,0.575,71,58,1,1,0.573,0.39,0.339,129
impatience,0.575,71,58,1,1,0.278,0.78,0.411,129
incessantly,0.575,71,58,1,1,0.417,0.765,0.606,129
scrap,0.575,132,108,1,1,0.156,0.339,0.173,240
jasper,0.575,121,99,1,1,0.48,0.425,0.402,220
harrowing,0.575,99,81,1,1,0.209,0.81,0.474,180
prickly,0.575,49,40,1,1,0.333,0.587,0.456,89
tandem,0.575,49,40,1,1,0.552,0.406,0.485,89
dibs,0.574,38,31,1,1,0.51,0.41,0.391,69
sole,0.574,763,626,1,1,0.427,0.194,0.279,1389
brawl,0.574,66,54,1,1,0.104,0.938,0.603,120
banana,0.574,608,499,1,1,0.612,0.23,0.241,1107
rodeo,0.574,94,77,1,1,0.49,0.676,0.588,171
stereo,0.573,150,123,1,1,0.617,0.519,0.5,273
monkey,0.573,603,495,1,1,0.548,0.449,0.283,1098
poem,0.573,1757,1443,1,1,0.81,0.27,0.571,3200
compost,0.573,27,22,1,1,0.48,0.404,0.441,49
hundredth,0.573,27,22,1,1,0.427,0.368,0.466,49
behemoth,0.573,27,22,1,1,0.583,0.781,0.853,49
superficial,0.573,386,317,1,1,0.357,0.407,0.309,703
fort,0.573,420,345,1,1,0.78,0.673,0.86,765
flashing,0.573,246,202,1,1,0.604,0.574,0.438,448
anew,0.572,145,119,1,1,0.771,0.358,0.385,264
substitute,0.572,387,318,1,1,0.427,0.406,0.398,705
added,0.572,2003,1647,1,1,0.562,0.405,0.509,3650
barrel,0.572,230,189,1,1,0.429,0.298,0.474,419
green,0.572,3713,3054,1,1,0.63,0.306,0.333,6767
orb,0.572,61,50,1,1,0.463,0.37,0.444,111
riveting,0.572,61,50,1,1,0.448,0.544,0.394,111
blaze,0.571,174,143,1,1,0.698,0.467,0.658,317
blazing,0.571,95,78,1,1,0.594,0.896,0.735,173
sickly,0.571,95,78,1,1,0.188,0.55,0.191,173
dash,0.571,293,241,1,1,0.574,0.312,0.324,534
awake,0.571,5627,4632,1,1,0.667,0.469,0.741,10259
definition,0.571,1369,1127,1,1,0.573,0.375,0.579,2496
buck,0.571,520,428,1,1,0.677,0.577,0.72,948
watery,0.57,84,69,1,1,0.367,0.461,0.292,153
bovine,0.57,16,13,1,1,0.449,0.255,0.353,29
bountiful,0.57,16,13,1,1,0.854,0.596,0.759,29
overlord,0.57,33,27,1,1,0.75,0.755,0.932,60
oceanic,0.57,16,13,1,1,0.74,0.317,0.632,29
crusher,0.57,16,13,1,1,0.271,0.709,0.598,29
incestuous,0.57,16,13,1,1,0.188,0.736,0.442,29
specialize,0.57,50,41,1,1,0.776,0.54,0.861,91
transcription,0.57,16,13,1,1,0.592,0.455,0.615,29
mannered,0.57,33,27,1,1,0.469,0.556,0.291,60
floater,0.57,16,13,1,1,0.48,0.433,0.37,29
yellows,0.57,16,13,1,1,0.57,0.306,0.318,29
porcupine,0.57,33,27,1,1,0.388,0.421,0.367,60
glowing,0.57,373,307,1,1,0.94,0.62,0.737,680
affectionate,0.57,430,354,1,1,0.949,0.422,0.55,784
innovation,0.57,141,116,1,1,0.949,0.68,0.89,257
bile,0.57,124,102,1,1,0.157,0.461,0.324,226
fishing,0.57,465,383,1,1,0.677,0.283,0.405,848
collector,0.57,90,74,1,1,0.552,0.481,0.648,164
immense,0.57,625,515,1,1,0.755,0.75,0.811,1140
indigo,0.57,73,60,1,1,0.514,0.365,0.473,133
shrivel,0.569,56,46,1,1,0.16,0.409,0.143,102
trumpet,0.569,96,79,1,1,0.573,0.57,0.393,175
cupcake,0.569,176,145,1,1,0.656,0.333,0.344,321
prompt,0.569,216,178,1,1,0.602,0.548,0.582,394
occupied,0.569,770,635,1,1,0.337,0.546,0.441,1405
rig,0.569,79,65,1,1,0.542,0.382,0.746,144
checkmate,0.569,39,32,1,1,0.667,0.708,0.75,71
heroism,0.569,39,32,1,1,0.844,0.802,0.898,71
stir,0.569,302,249,1,1,0.448,0.773,0.453,551
smoker,0.568,165,136,1,1,0.208,0.528,0.311,301
contemporary,0.568,171,141,1,1,0.72,0.365,0.569,312
fab,0.568,418,345,1,1,0.49,0.38,0.406,763
networking,0.568,309,255,1,1,0.625,0.482,0.545,564
port,0.568,269,222,1,1,0.55,0.409,0.513,491
peridot,0.567,22,18,1,1,0.458,0.481,0.435,40
fallback,0.567,22,18,1,1,0.458,0.358,0.508,40
indigestion,0.567,22,18,1,1,0.204,0.61,0.182,40
bowling,0.567,235,194,1,1,0.656,0.431,0.309,429
cutie,0.567,754,623,1,1,0.638,0.528,0.464,1377
proposition,0.567,74,61,1,1,0.627,0.75,0.565,135
dependence,0.566,132,109,1,1,0.25,0.451,0.433,241
frightened,0.566,1133,937,1,1,0.153,0.817,0.255,2070
liquor,0.566,451,373,1,1,0.603,0.702,0.433,824
celebrations,0.566,225,186,1,1,0.958,0.794,0.714,411
pacifier,0.566,28,23,1,1,0.615,0.342,0.356,51
carelessness,0.566,28,23,1,1,0.245,0.482,0.33,51
cockpit,0.566,28,23,1,1,0.52,0.424,0.343,51
anus,0.566,57,47,1,1,0.347,0.644,0.35,104
formation,0.565,121,100,1,1,0.615,0.453,0.731,221
aroused,0.565,63,52,1,1,0.708,0.952,0.667,115
seed,0.565,453,375,1,1,0.656,0.135,0.306,828
lower,0.565,3358,2781,1,1,0.327,0.296,0.258,6139
sand,0.565,1030,853,1,1,0.582,0.279,0.304,1883
burrow,0.564,34,28,1,1,0.438,0.28,0.355,62
dodge,0.564,139,115,1,1,0.333,0.76,0.509,254
introspective,0.564,174,144,1,1,0.552,0.36,0.471,318
prodigy,0.564,69,57,1,1,0.812,0.704,0.824,126
cam,0.564,1295,1073,1,1,0.448,0.363,0.355,2368
mitt,0.564,75,62,1,1,0.406,0.183,0.264,137
pulp,0.564,75,62,1,1,0.469,0.231,0.324,137
weed,0.564,2263,1876,1,1,0.459,0.294,0.364,4139
vast,0.564,1469,1218,1,1,0.52,0.535,0.545,2687
trickster,0.564,40,33,1,1,0.375,0.68,0.446,73
vale,0.564,122,101,1,1,0.592,0.276,0.387,223
prize,0.564,450,373,1,1,0.885,0.763,0.67,823
fickle,0.563,128,106,1,1,0.406,0.481,0.346,234
ashes,0.563,609,505,1,1,0.327,0.279,0.142,1114
kinship,0.563,87,72,1,1,0.771,0.3,0.652,159
audacity,0.563,533,442,1,1,0.76,0.755,0.916,975
bin,0.563,733,608,1,1,0.422,0.304,0.327,1341
strait,0.563,46,38,1,1,0.438,0.433,0.412,84
hypnosis,0.563,46,38,1,1,0.417,0.41,0.546,84
sibling,0.563,1040,863,1,1,0.857,0.34,0.636,1903
insert,0.562,635,527,1,1,0.481,0.552,0.519,1162
critter,0.562,52,43,1,1,0.542,0.539,0.482,95
torment,0.562,347,288,1,1,0.057,0.75,0.387,635
steamy,0.562,58,48,1,1,0.479,0.538,0.445,106
teal,0.562,58,48,1,1,0.54,0.293,0.321,106
appoint,0.562,58,48,1,1,0.565,0.33,0.509,106
wonder,0.562,19149,15904,1,1,0.939,0.771,0.765,35053
delusion,0.562,336,279,1,1,0.344,0.647,0.4,615
innate,0.561,141,117,1,1,0.49,0.4,0.521,258
bookmark,0.561,76,63,1,1,0.543,0.441,0.415,139
chart,0.561,633,526,1,1,0.469,0.317,0.33,1159
echo,0.561,1143,950,1,1,0.573,0.373,0.345,2093
pariah,0.561,94,78,1,1,0.397,0.478,0.293,172
sterling,0.56,118,98,1,1,0.529,0.481,0.615,216
comedian,0.56,243,202,1,1,0.812,0.735,0.598,445
grape,0.56,124,103,1,1,0.729,0.122,0.295,227
gang,0.56,2417,2011,1,1,0.217,0.85,0.629,4428
carnival,0.56,148,123,1,1,0.927,0.888,0.555,271
text,0.56,13600,11321,1,1,0.604,0.157,0.402,24921
site,0.559,1840,1532,1,1,0.677,0.265,0.452,3372
fundamentally,0.559,286,238,1,1,0.653,0.441,0.759,524
evening,0.559,4701,3915,1,1,0.458,0.185,0.318,8616
harass,0.559,400,333,1,1,0.16,0.775,0.62,733
intro,0.559,616,513,1,1,0.51,0.331,0.657,1129
follow,0.559,15789,13156,1,1,0.667,0.509,0.6,28945
slab,0.559,47,39,1,1,0.398,0.265,0.264,86
hugger,0.559,41,34,1,1,0.52,0.48,0.412,75
lull,0.559,65,54,1,1,0.602,0.13,0.402,119
delightful,0.559,233,194,1,1,0.918,0.735,0.644,427
capture,0.559,473,394,1,1,0.357,0.65,0.537,867
intergalactic,0.559,35,29,1,1,0.562,0.661,0.741,64
tubby,0.559,23,19,1,1,0.427,0.423,0.353,42
unorthodox,0.559,23,19,1,1,0.34,0.48,0.441,42
repelling,0.559,17,14,1,1,0.184,0.633,0.429,31
transsexual,0.559,35,29,1,1,0.264,0.815,0.423,64
wordy,0.559,17,14,1,1,0.643,0.478,0.586,31
hornet,0.559,29,24,1,1,0.398,0.594,0.5,53
altitude,0.559,29,24,1,1,0.708,0.482,0.736,53
incline,0.559,17,14,1,1,0.49,0.423,0.345,31
unmoved,0.559,17,14,1,1,0.184,0.355,0.36,31
elm,0.559,23,19,1,1,0.51,0.345,0.321,42
idealist,0.559,23,19,1,1,0.816,0.51,0.802,42
tart,0.559,59,49,1,1,0.719,0.38,0.219,108
yeast,0.559,35,29,1,1,0.5,0.35,0.327,64
coolness,0.559,41,34,1,1,0.49,0.307,0.548,75
infantile,0.559,41,34,1,1,0.604,0.382,0.259,75
remnant,0.559,71,59,1,1,0.367,0.312,0.388,130
beetle,0.559,47,39,1,1,0.323,0.356,0.295,86
exposition,0.559,23,19,1,1,0.521,0.627,0.655,42
ejaculate,0.559,17,14,1,1,0.604,0.896,0.604,31
righty,0.559,17,14,1,1,0.75,0.314,0.786,31
dagger,0.559,95,79,1,1,0.224,0.797,0.613,174
smog,0.559,17,14,1,1,0.271,0.48,0.382,31
prosperity,0.559,239,199,1,1,0.917,0.6,0.86,438
carpal,0.559,23,19,1,1,0.449,0.327,0.42,42
yaw,0.559,89,74,1,1,0.586,0.592,0.491,163
cell,0.559,3763,3136,1,1,0.541,0.375,0.465,6899
laughter,0.558,1861,1551,1,1,0.959,0.654,0.588,3412
soul,0.558,23611,19681,1,1,0.77,0.22,0.51,43292
butterfly,0.558,741,618,1,1,0.892,0.327,0.314,1359
notorious,0.557,120,100,1,1,0.366,0.582,0.609,220
energetic,0.557,308,257,1,1,0.847,0.868,0.902,565
fulfilling,0.557,799,667,1,1,0.823,0.417,0.755,1466
era,0.557,1799,1502,1,1,0.615,0.407,0.449,3301
sweater,0.557,387,323,1,1,0.704,0.245,0.295,710
impoverished,0.556,90,75,1,1,0.125,0.311,0.203,165
evolution,0.556,412,344,1,1,0.781,0.657,0.854,756
galactic,0.556,78,65,1,1,0.656,0.67,0.776,143
accompany,0.556,2339,1954,1,1,0.833,0.406,0.585,4293
web,0.556,844,705,1,1,0.583,0.411,0.519,1549
equivalent,0.556,516,431,1,1,0.646,0.347,0.5,947
upper,0.556,529,442,1,1,0.74,0.529,0.868,971
spawn,0.555,176,147,1,1,0.542,0.586,0.709,323
tin,0.555,268,224,1,1,0.469,0.37,0.217,492
demon,0.555,1711,1431,1,1,0.037,0.908,0.509,3142
relevant,0.554,1051,880,1,1,0.719,0.608,0.764,1931
understatement,0.553,307,257,1,1,0.347,0.48,0.473,564
ferret,0.553,73,61,1,1,0.385,0.391,0.398,134
flaunt,0.553,73,61,1,1,0.438,0.611,0.525,134
heretic,0.553,36,30,1,1,0.09,0.71,0.447,66
utopian,0.553,36,30,1,1,0.542,0.327,0.552,66
bulge,0.553,36,30,1,1,0.26,0.487,0.4,66
adverts,0.553,141,118,1,1,0.551,0.5,0.595,259
sigh,0.553,5468,4583,1,1,0.469,0.387,0.273,10051
quid,0.553,67,56,1,1,0.479,0.378,0.327,123
sublime,0.553,135,113,1,1,0.784,0.333,0.585,248
canine,0.553,67,56,1,1,0.573,0.569,0.425,123
manor,0.553,166,139,1,1,0.646,0.358,0.738,305
digs,0.553,98,82,1,1,0.448,0.67,0.635,180
domino,0.553,98,82,1,1,0.594,0.51,0.473,180
logo,0.552,643,539,1,1,0.469,0.296,0.565,1182
depressing,0.552,5833,4891,1,1,0.146,0.559,0.216,10724
rhyming,0.552,30,25,1,1,0.729,0.41,0.5,55
hight,0.552,30,25,1,1,0.667,0.637,0.645,55
illumination,0.552,30,25,1,1,0.76,0.588,0.537,55
otter,0.552,92,77,1,1,0.439,0.216,0.339,169
brisk,0.552,30,25,1,1,0.719,0.745,0.742,55
milkshake,0.552,123,103,1,1,0.796,0.521,0.33,226
jacks,0.552,92,77,1,1,0.49,0.4,0.505,169
fertile,0.552,61,51,1,1,0.888,0.408,0.704,112
remorseful,0.552,30,25,1,1,0.347,0.429,0.25,55
land,0.552,3236,2714,1,1,0.582,0.26,0.616,5950
spirituality,0.552,210,176,1,1,0.865,0.281,0.667,386
teenager,0.551,1226,1029,1,1,0.781,0.593,0.527,2255
sleeping,0.551,10625,8920,1,1,0.704,0.091,0.312,19545
shallow,0.551,860,722,1,1,0.427,0.298,0.351,1582
iridescent,0.551,24,20,1,1,0.602,0.588,0.539,44
offshore,0.551,49,41,1,1,0.417,0.484,0.441,90
archery,0.551,24,20,1,1,0.594,0.604,0.589,44
cranberry,0.551,49,41,1,1,0.793,0.33,0.363,90
underprivileged,0.551,24,20,1,1,0.167,0.449,0.172,44
godlike,0.551,24,20,1,1,0.854,0.648,0.87,44
nitwit,0.551,24,20,1,1,0.146,0.606,0.139,44
exhaustion,0.551,593,498,1,1,0.366,0.633,0.269,1091
persona,0.55,713,599,1,1,0.741,0.48,0.743,1312
map,0.55,1020,857,1,1,0.561,0.229,0.463,1877
classy,0.55,206,173,1,1,0.917,0.41,0.649,379
chords,0.55,112,94,1,1,0.639,0.406,0.388,206
looming,0.55,200,168,1,1,0.367,0.75,0.528,368
hyperactive,0.55,43,36,1,1,0.5,0.921,0.66,79
pox,0.55,43,36,1,1,0.235,0.567,0.309,79
crammed,0.55,43,36,1,1,0.406,0.74,0.466,79
vigilante,0.55,43,36,1,1,0.418,0.627,0.72,79
desert,0.549,1805,1518,1,1,0.469,0.279,0.389,3323
spew,0.549,251,211,1,1,0.26,0.651,0.573,462
togetherness,0.548,404,340,1,1,0.906,0.36,0.635,744
mismatch,0.548,18,15,1,1,0.25,0.459,0.282,33
dune,0.548,56,47,1,1,0.459,0.173,0.414,103
headless,0.548,37,31,1,1,0.136,0.582,0.235,68
directory,0.548,18,15,1,1,0.439,0.413,0.538,33
gorge,0.548,37,31,1,1,0.365,0.644,0.42,68
slipper,0.548,37,31,1,1,0.635,0.298,0.245,68
kilt,0.548,18,15,1,1,0.448,0.346,0.348,33
peddle,0.548,37,31,1,1,0.539,0.549,0.538,68
asthmatic,0.548,18,15,1,1,0.229,0.706,0.294,33
coastline,0.548,18,15,1,1,0.745,0.282,0.441,33
successive,0.548,18,15,1,1,0.635,0.471,0.518,33
insipid,0.548,18,15,1,1,0.214,0.25,0.241,33
paternal,0.548,37,31,1,1,0.776,0.353,0.755,68
croissant,0.548,37,31,1,1,0.745,0.33,0.43,68
macho,0.548,75,63,1,1,0.643,0.69,0.676,138
retro,0.548,164,138,1,1,0.65,0.276,0.321,302
tender,0.548,640,539,1,1,0.63,0.52,0.509,1179
aka,0.548,2172,1830,1,1,0.459,0.358,0.351,4002
endangered,0.547,88,74,1,1,0.083,0.885,0.43,162
insignificance,0.547,69,58,1,1,0.25,0.216,0.222,127
weepy,0.547,69,58,1,1,0.068,0.615,0.116,127
rust,0.547,120,101,1,1,0.281,0.265,0.321,221
rebirth,0.547,120,101,1,1,0.781,0.712,0.78,221
sail,0.547,292,246,1,1,0.615,0.22,0.325,538
bitty,0.547,50,42,1,1,0.469,0.271,0.257,92
cuisine,0.547,50,42,1,1,0.714,0.365,0.39,92
essay,0.547,771,650,1,1,0.559,0.411,0.53,1421
social,0.547,29720,25063,1,1,0.806,0.37,0.614,54783
decoration,0.547,82,69,1,1,0.878,0.553,0.526,151
lizard,0.546,274,231,1,1,0.378,0.375,0.324,505
rundown,0.546,31,26,1,1,0.52,0.296,0.465,57
untouchable,0.546,127,107,1,1,0.49,0.602,0.683,234
scarcity,0.546,63,53,1,1,0.167,0.5,0.182,116
carving,0.546,95,80,1,1,0.541,0.444,0.368,175
monsieur,0.546,31,26,1,1,0.552,0.34,0.623,57
punk,0.545,571,482,1,1,0.429,0.63,0.358,1053
oblige,0.545,44,37,1,1,0.281,0.77,0.614,81
jazz,0.545,507,428,1,1,0.677,0.362,0.45,935
malice,0.545,102,86,1,1,0.073,0.811,0.492,188
feminism,0.545,572,483,1,1,0.541,0.57,0.636,1055
tissue,0.545,334,282,1,1,0.558,0.236,0.345,616
coral,0.545,57,48,1,1,0.802,0.231,0.425,105
brew,0.545,199,168,1,1,0.74,0.538,0.758,367
chastity,0.545,70,59,1,1,0.469,0.392,0.509,129
coast,0.545,929,785,1,1,0.719,0.396,0.458,1714
digress,0.544,83,70,1,1,0.271,0.625,0.411,153
psychopath,0.544,419,354,1,1,0.04,0.943,0.536,773
arrow,0.544,239,202,1,1,0.439,0.39,0.454,441
tennis,0.544,343,290,1,1,0.622,0.519,0.431,633
cranium,0.543,38,32,1,1,0.439,0.491,0.725,70
rear,0.543,181,153,1,1,0.459,0.52,0.284,334
whiskers,0.543,25,21,1,1,0.439,0.278,0.27,46
subtlety,0.543,25,21,1,1,0.615,0.176,0.363,46
zoning,0.543,77,65,1,1,0.417,0.4,0.578,142
boundless,0.543,64,54,1,1,0.684,0.642,0.652,118
cyclist,0.543,38,32,1,1,0.684,0.582,0.576,70
discerning,0.543,38,32,1,1,0.542,0.584,0.78,70
fascinating,0.543,605,512,1,1,0.979,0.817,0.784,1117
debut,0.543,964,816,1,1,0.806,0.606,0.629,1780
fulfill,0.543,808,684,1,1,0.784,0.461,0.577,1492
amp,0.543,110,93,1,1,0.439,0.393,0.375,203
redemption,0.542,398,337,1,1,0.376,0.408,0.545,735
occupy,0.542,470,398,1,1,0.396,0.52,0.589,868
sale,0.542,771,653,1,1,0.647,0.602,0.573,1424
translation,0.542,713,604,1,1,0.633,0.435,0.598,1317
daze,0.542,117,99,1,1,0.245,0.735,0.329,216
harbor,0.542,163,138,1,1,0.594,0.356,0.634,301
referee,0.541,45,38,1,1,0.531,0.644,0.778,83
edging,0.541,45,38,1,1,0.479,0.394,0.37,83
pester,0.541,78,66,1,1,0.143,0.78,0.385,144
abbot,0.541,32,27,1,1,0.427,0.321,0.483,59
copious,0.541,65,55,1,1,0.427,0.462,0.527,120
forecast,0.541,98,83,1,1,0.783,0.419,0.698,181
legendary,0.541,362,307,1,1,0.857,0.537,0.863,669
apathy,0.54,257,218,1,1,0.184,0.212,0.204,475
burn,0.54,3024,2567,1,1,0.219,0.783,0.509,5591
usher,0.54,125,106,1,1,0.521,0.44,0.519,231
jolly,0.54,251,213,1,1,0.959,0.705,0.708,464
wild,0.54,4723,4011,1,1,0.312,0.922,0.75,8734
posh,0.539,92,78,1,1,0.823,0.337,0.75,170
collaboration,0.539,285,242,1,1,0.885,0.628,0.741,527
engagement,0.539,718,610,1,1,0.906,0.587,0.807,1328
burr,0.539,39,33,1,1,0.39,0.426,0.308,72
psychopathic,0.539,79,67,1,1,0.077,0.918,0.508,146
intestinal,0.539,19,16,1,1,0.357,0.531,0.37,35
snippet,0.539,119,101,1,1,0.612,0.41,0.368,220
asunder,0.539,19,16,1,1,0.208,0.442,0.259,35
wedded,0.539,19,16,1,1,0.771,0.413,0.518,35
lobotomy,0.539,19,16,1,1,0.296,0.598,0.402,35
refraining,0.539,19,16,1,1,0.418,0.453,0.404,35
aegis,0.539,19,16,1,1,0.49,0.439,0.462,35
emotion,0.539,2706,2300,1,1,0.693,0.873,0.696,5006
crush,0.538,5607,4768,1,1,0.271,0.676,0.582,10375
attractive,0.538,1985,1688,1,1,0.906,0.63,0.769,3673
subside,0.538,113,96,1,1,0.375,0.308,0.209,209
doughnut,0.538,46,39,1,1,0.663,0.38,0.279,85
impairment,0.538,46,39,1,1,0.17,0.571,0.22,85
perceptive,0.538,46,39,1,1,0.745,0.5,0.741,85
adore,0.538,1906,1622,1,1,0.854,0.438,0.657,3528
fifty,0.537,241,205,1,1,0.571,0.368,0.439,446
brief,0.537,739,629,1,1,0.469,0.3,0.279,1368
sliding,0.537,403,343,1,1,0.356,0.73,0.491,746
rubbing,0.537,613,522,1,1,0.406,0.569,0.44,1135
cozy,0.537,694,591,1,1,0.91,0.356,0.545,1285
trickery,0.537,26,22,1,1,0.146,0.798,0.336,48
toothache,0.537,26,22,1,1,0.188,0.853,0.412,48
stripe,0.537,26,22,1,1,0.629,0.302,0.361,48
despondent,0.537,107,91,1,1,0.133,0.378,0.221,198
craps,0.537,26,22,1,1,0.375,0.42,0.273,48
hybrid,0.536,202,172,1,1,0.5,0.365,0.57,374
tab,0.536,236,201,1,1,0.594,0.208,0.308,437
rebels,0.536,94,80,1,1,0.135,0.86,0.609,174
experimentation,0.535,33,28,1,1,0.637,0.769,0.767,61
bicker,0.535,33,28,1,1,0.143,0.643,0.552,61
popsicle,0.535,33,28,1,1,0.667,0.3,0.364,61
floppy,0.535,33,28,1,1,0.549,0.3,0.333,61
corny,0.535,673,574,1,1,0.448,0.37,0.221,1247
reunite,0.535,224,191,1,1,0.656,0.55,0.657,415
buzz,0.535,422,360,1,1,0.333,0.686,0.375,782
pervert,0.535,313,267,1,1,0.082,0.863,0.5,580
harper,0.535,197,168,1,1,0.417,0.454,0.435,365
photography,0.535,402,343,1,1,0.63,0.431,0.36,745
goody,0.535,40,34,1,1,0.786,0.337,0.57,74
coil,0.535,40,34,1,1,0.448,0.343,0.298,74
enlightenment,0.534,170,145,1,1,0.837,0.549,0.619,315
ugliness,0.534,225,192,1,1,0.094,0.407,0.267,417
slice,0.534,410,350,1,1,0.583,0.375,0.303,760
rumor,0.534,219,187,1,1,0.255,0.582,0.282,406
disregard,0.533,398,340,1,1,0.177,0.647,0.308,738
prematurely,0.533,68,58,1,1,0.292,0.657,0.289,126
kidnapping,0.533,158,135,1,1,0.094,0.88,0.561,293
float,0.532,442,378,1,1,0.688,0.394,0.344,820
peg,0.532,89,76,1,1,0.52,0.357,0.393,165
grinding,0.532,588,503,1,1,0.415,0.45,0.461,1091
electronic,0.532,200,171,1,1,0.571,0.49,0.704,371
lands,0.532,429,367,1,1,0.594,0.28,0.492,796
technology,0.532,1270,1087,1,1,0.776,0.49,0.825,2357
riddled,0.532,131,112,1,1,0.281,0.861,0.422,243
huff,0.532,138,118,1,1,0.388,0.491,0.315,256
blade,0.532,451,386,1,1,0.378,0.602,0.594,837
intoxicated,0.531,215,184,1,1,0.079,0.824,0.246,399
validation,0.531,1625,1392,1,1,0.655,0.46,0.72,3017
stray,0.531,1598,1369,1,1,0.133,0.76,0.281,2967
scent,0.531,411,352,1,1,0.633,0.41,0.491,763
genre,0.531,481,412,1,1,0.52,0.433,0.5,893
frustration,0.531,2188,1875,1,1,0.06,0.73,0.28,4063
clump,0.53,20,17,1,1,0.551,0.48,0.582,37
chalice,0.53,20,17,1,1,0.633,0.286,0.529,37
salvage,0.53,55,47,1,1,0.622,0.51,0.832,102
squash,0.53,83,71,1,1,0.531,0.667,0.41,154
reimburse,0.53,20,17,1,1,0.68,0.418,0.527,37
contributor,0.53,76,65,1,1,0.844,0.51,0.76,141
clog,0.53,20,17,1,1,0.104,0.618,0.454,37
brewery,0.53,55,47,1,1,0.71,0.622,0.51,102
dapper,0.53,20,17,1,1,0.77,0.56,0.698,37
noggin,0.53,27,23,1,1,0.51,0.433,0.382,50
calligraphy,0.53,20,17,1,1,0.62,0.216,0.5,37
snout,0.53,20,17,1,1,0.276,0.385,0.241,37
rodent,0.53,34,29,1,1,0.323,0.577,0.279,63
sufficiently,0.53,62,53,1,1,0.776,0.367,0.714,115
tabby,0.53,48,41,1,1,0.51,0.426,0.387,89
twinge,0.53,41,35,1,1,0.316,0.72,0.471,76
interminable,0.53,20,17,1,1,0.327,0.481,0.561,37
ooze,0.53,34,29,1,1,0.344,0.577,0.333,63
sojourn,0.53,20,17,1,1,0.514,0.243,0.509,37
boot,0.53,405,347,1,1,0.438,0.65,0.625,752
condor,0.53,20,17,1,1,0.573,0.388,0.519,37
accompanying,0.53,350,300,1,1,0.787,0.46,0.582,650
spoiling,0.53,224,192,1,1,0.135,0.678,0.306,416
produced,0.529,465,399,1,1,0.724,0.528,0.693,864
gush,0.529,84,72,1,1,0.51,0.49,0.381,156
axe,0.529,169,145,1,1,0.296,0.69,0.536,314
harmless,0.528,226,194,1,1,0.625,0.226,0.241,420
catalog,0.528,70,60,1,1,0.561,0.221,0.573,130
disappearance,0.528,70,60,1,1,0.214,0.698,0.367,130
rugged,0.528,70,60,1,1,0.561,0.569,0.793,130
wiki,0.528,70,60,1,1,0.53,0.39,0.455,130
glee,0.528,205,176,1,1,0.698,0.58,0.464,381
high,0.528,21923,18844,1,1,0.684,0.51,0.614,40767
stream,0.527,4732,4068,1,1,0.449,0.537,0.559,8800
ailing,0.527,49,42,1,1,0.094,0.518,0.153,91
metaphysical,0.527,49,42,1,1,0.63,0.573,0.686,91
patron,0.527,185,159,1,1,0.583,0.451,0.87,344
deacon,0.527,42,36,1,1,0.531,0.43,0.736,78
sprite,0.527,85,73,1,1,0.561,0.438,0.625,158
simmer,0.527,42,36,1,1,0.65,0.293,0.393,78
graceful,0.527,85,73,1,1,0.906,0.51,0.655,158
cultured,0.527,42,36,1,1,0.635,0.429,0.625,78
fringe,0.527,171,147,1,1,0.52,0.387,0.323,318
contain,0.526,408,351,1,1,0.542,0.49,0.658,759
faceless,0.526,121,104,1,1,0.23,0.406,0.173,225
miniature,0.526,78,67,1,1,0.429,0.292,0.204,145
excess,0.526,186,160,1,1,0.385,0.889,0.712,346
smiles,0.526,3102,2671,1,1,0.892,0.606,0.607,5773
teeming,0.526,35,30,1,1,0.582,0.55,0.727,65
banshee,0.526,35,30,1,1,0.408,0.565,0.481,65
oddity,0.526,35,30,1,1,0.312,0.557,0.386,65
trading,0.525,469,404,1,1,0.635,0.602,0.705,873
seal,0.525,245,211,1,1,0.49,0.218,0.518,456
extreme,0.525,2303,1985,1,1,0.318,0.8,0.721,4288
fuck,0.525,64169,55317,1,1,0.198,0.93,0.446,119486
headband,0.525,28,24,1,1,0.67,0.469,0.527,52
placebo,0.525,57,49,1,1,0.52,0.306,0.365,106
exalted,0.525,28,24,1,1,0.676,0.845,0.696,52
suede,0.525,28,24,1,1,0.542,0.259,0.259,52
depth,0.525,782,674,1,1,0.708,0.561,0.759,1456
prophetic,0.524,50,43,1,1,0.688,0.586,0.796,93
burrito,0.524,203,175,1,1,0.688,0.294,0.166,378
harvest,0.523,189,163,1,1,0.781,0.353,0.548,352
queen,0.523,5024,4337,1,1,0.875,0.692,0.86,9361
atmosphere,0.523,987,852,1,1,0.604,0.3,0.56,1839
slave,0.523,753,650,1,1,0.171,0.795,0.151,1403
astonishingly,0.523,21,18,1,1,0.827,0.898,0.773,39
prescient,0.523,21,18,1,1,0.531,0.539,0.696,39
extort,0.523,21,18,1,1,0.052,0.827,0.57,39
fruitcake,0.523,21,18,1,1,0.865,0.44,0.357,39
boyish,0.523,21,18,1,1,0.698,0.562,0.462,39
driftwood,0.523,21,18,1,1,0.321,0.283,0.439,39
mileage,0.523,43,37,1,1,0.51,0.458,0.562,80
coldly,0.523,43,37,1,1,0.365,0.358,0.407,80
chum,0.523,43,37,1,1,0.911,0.347,0.518,80
wreath,0.523,21,18,1,1,0.745,0.44,0.66,39
elegance,0.523,43,37,1,1,0.918,0.396,0.824,80
arc,0.523,542,468,1,1,0.552,0.388,0.396,1010
torture,0.523,1621,1400,1,1,0.115,0.878,0.555,3021
chilling,0.523,1733,1497,1,1,0.208,0.85,0.358,3230
streamer,0.522,330,285,1,1,0.615,0.53,0.429,615
depravity,0.522,80,69,1,1,0.115,0.854,0.453,149
cynical,0.522,375,324,1,1,0.156,0.76,0.474,699
deadlines,0.522,213,184,1,1,0.406,0.769,0.411,397
elevation,0.522,95,82,1,1,0.76,0.759,0.711,177
windowsill,0.522,36,31,1,1,0.429,0.274,0.433,67
resort,0.521,717,620,1,1,0.573,0.441,0.632,1337
pessimistic,0.521,214,185,1,1,0.088,0.394,0.236,399
submerged,0.521,51,44,1,1,0.337,0.528,0.357,95
layered,0.521,51,44,1,1,0.571,0.306,0.436,95
engage,0.521,1337,1157,1,1,0.771,0.796,0.713,2494
disease,0.521,2848,2465,1,1,0.041,0.539,0.333,5313
brutal,0.521,959,830,1,1,0.122,0.882,0.643,1789
lap,0.52,976,845,1,1,0.583,0.51,0.412,1821
persistent,0.52,275,238,1,1,0.646,0.667,0.815,513
dinosaur,0.52,208,180,1,1,0.448,0.63,0.596,388
whistle,0.52,350,303,1,1,0.653,0.551,0.463,653
clash,0.52,126,109,1,1,0.293,0.918,0.453,235
baseball,0.52,724,627,1,1,0.66,0.76,0.563,1351
vodka,0.52,508,440,1,1,0.51,0.632,0.491,948
ease,0.52,2883,2498,1,1,0.796,0.385,0.491,5381
rustic,0.519,14,12,1,1,0.369,0.657,0.491,26
instigate,0.519,29,25,1,1,0.278,0.765,0.642,54
infrared,0.519,14,12,1,1,0.469,0.588,0.526,26
catastrophic,0.519,134,116,1,1,0.071,0.934,0.598,250
cerebral,0.519,74,64,1,1,0.408,0.509,0.627,138
crouching,0.519,29,25,1,1,0.261,0.429,0.345,54
antagonize,0.519,29,25,1,1,0.143,0.663,0.629,54
unfailing,0.519,29,25,1,1,0.625,0.635,0.594,54
affluence,0.519,14,12,1,1,0.663,0.618,0.722,26
shoreline,0.519,29,25,1,1,0.677,0.296,0.529,54
gentile,0.519,14,12,1,1,0.833,0.25,0.527,26
tithe,0.519,14,12,1,1,0.507,0.276,0.385,26
programmer,0.519,74,64,1,1,0.562,0.426,0.759,138
clipboard,0.519,14,12,1,1,0.594,0.255,0.423,26
friggen,0.519,29,25,1,1,0.39,0.55,0.442,54
slider,0.519,29,25,1,1,0.585,0.491,0.518,54
beagle,0.519,59,51,1,1,0.649,0.47,0.395,110
regal,0.519,29,25,1,1,0.643,0.459,0.556,54
turret,0.519,14,12,1,1,0.494,0.5,0.588,26
wounded,0.519,420,364,1,1,0.115,0.77,0.275,784
pole,0.519,375,325,1,1,0.418,0.398,0.368,700
starter,0.519,512,444,1,1,0.667,0.461,0.827,956
undying,0.518,150,130,1,1,0.708,0.5,0.773,280
cherry,0.518,671,582,1,1,0.688,0.186,0.25,1253
obsessed,0.518,2190,1900,1,1,0.219,0.84,0.439,4090
combine,0.518,188,163,1,1,0.663,0.442,0.533,351
barbecue,0.518,52,45,1,1,0.792,0.643,0.456,97
harsh,0.518,1461,1268,1,1,0.25,0.65,0.623,2729
lamb,0.518,257,223,1,1,0.646,0.284,0.321,480
flicker,0.518,166,144,1,1,0.635,0.321,0.333,310
avatar,0.518,242,210,1,1,0.633,0.41,0.567,452
flapping,0.517,37,32,1,1,0.458,0.728,0.404,69
glazed,0.517,37,32,1,1,0.622,0.41,0.491,69
anthology,0.517,75,65,1,1,0.338,0.406,0.537,140
shitfaced,0.517,37,32,1,1,0.214,0.695,0.38,69
breeder,0.517,37,32,1,1,0.645,0.481,0.605,69
slick,0.517,265,230,1,1,0.388,0.383,0.349,495
scourge,0.517,75,65,1,1,0.214,0.64,0.302,140
application,0.517,440,382,1,1,0.646,0.445,0.726,822
spoon,0.517,585,508,1,1,0.479,0.236,0.259,1093
user,0.517,722,627,1,1,0.629,0.347,0.442,1349
smoke,0.517,5222,4536,1,1,0.188,0.5,0.391,9758
bright,0.517,3594,3122,1,1,0.89,0.527,0.812,6716
cage,0.517,1005,873,1,1,0.316,0.333,0.352,1878
renounce,0.516,22,19,1,1,0.156,0.49,0.552,41
cheeseburger,0.516,91,79,1,1,0.802,0.529,0.336,170
excessively,0.516,114,99,1,1,0.449,0.882,0.716,213
recede,0.516,22,19,1,1,0.231,0.449,0.245,41
blueprint,0.516,45,39,1,1,0.49,0.173,0.425,84
villain,0.516,544,473,1,1,0.177,0.892,0.59,1017
gram,0.516,168,146,1,1,0.578,0.333,0.26,314
superb,0.515,246,214,1,1,0.98,0.708,0.852,460
knight,0.515,694,604,1,1,0.78,0.441,0.835,1298
reservoir,0.514,30,26,1,1,0.531,0.276,0.462,56
collage,0.514,123,107,1,1,0.68,0.321,0.375,230
afternoon,0.514,2582,2249,1,1,0.533,0.388,0.339,4831
tending,0.514,100,87,1,1,0.622,0.556,0.594,187
reunited,0.514,271,236,1,1,0.708,0.439,0.658,507
ascension,0.514,69,60,1,1,0.765,0.72,0.714,129
browse,0.514,108,94,1,1,0.635,0.75,0.592,202
rim,0.514,77,67,1,1,0.51,0.397,0.302,144
tinker,0.514,38,33,1,1,0.396,0.528,0.275,71
carefully,0.513,905,789,1,1,0.698,0.33,0.544,1694
pit,0.513,1491,1300,1,1,0.408,0.396,0.278,2791
existent,0.513,218,190,1,1,0.635,0.49,0.635,408
bigot,0.513,312,272,1,1,0.479,0.745,0.517,584
showcase,0.513,179,156,1,1,0.521,0.255,0.415,335
staring,0.513,3139,2738,1,1,0.542,0.306,0.423,5877
jasmine,0.513,203,177,1,1,0.765,0.23,0.286,380
humiliation,0.513,258,225,1,1,0.048,0.712,0.31,483
cove,0.512,54,47,1,1,0.5,0.304,0.37,101
mod,0.512,172,150,1,1,0.458,0.367,0.384,322
intense,0.512,1902,1660,1,1,0.592,0.774,0.679,3562
nightclub,0.512,62,54,1,1,0.802,0.894,0.528,116
adventures,0.512,906,791,1,1,0.812,0.764,0.749,1697
extract,0.512,70,61,1,1,0.565,0.402,0.519,131
quits,0.512,149,130,1,1,0.229,0.48,0.352,279
temporarily,0.511,522,456,1,1,0.5,0.365,0.373,978
animated,0.511,229,200,1,1,0.823,0.676,0.538,429
inadequate,0.511,436,381,1,1,0.122,0.45,0.223,817
bull,0.511,738,645,1,1,0.521,0.64,0.644,1383
dire,0.511,357,312,1,1,0.214,0.66,0.259,669
frustrated,0.511,2975,2601,1,1,0.08,0.651,0.255,5576
adventure,0.511,1329,1162,1,1,0.917,0.857,0.71,2491
ops,0.51,230,201,1,1,0.417,0.55,0.528,431
visitor,0.51,262,229,1,1,0.646,0.48,0.461,491
unappreciated,0.51,581,508,1,1,0.143,0.431,0.209,1089
spencer,0.51,167,146,1,1,0.51,0.394,0.367,313
wham,0.51,39,34,1,1,0.469,0.49,0.423,73
lobster,0.51,151,132,1,1,0.571,0.356,0.291,283
canary,0.51,55,48,1,1,0.582,0.276,0.265,103
coursing,0.51,23,20,1,1,0.542,0.472,0.546,43
zebra,0.51,63,55,1,1,0.567,0.448,0.314,118
blister,0.51,15,13,1,1,0.407,0.538,0.402,28
czar,0.51,15,13,1,1,0.48,0.348,0.643,28
runt,0.51,23,20,1,1,0.37,0.5,0.445,43
biker,0.51,55,48,1,1,0.604,0.71,0.567,103
freshness,0.51,23,20,1,1,0.917,0.333,0.585,43
substitution,0.51,15,13,1,1,0.406,0.48,0.353,28
throes,0.51,47,41,1,1,0.146,0.76,0.235,88
auditor,0.51,15,13,1,1,0.582,0.571,0.726,28
booby,0.51,23,20,1,1,0.396,0.423,0.185,43
boating,0.51,15,13,1,1,0.638,0.613,0.557,28
weighty,0.51,15,13,1,1,0.427,0.48,0.657,28
posse,0.51,103,90,1,1,0.398,0.51,0.473,193
stopper,0.51,15,13,1,1,0.365,0.336,0.39,28
looker,0.51,15,13,1,1,0.583,0.354,0.451,28
radiator,0.51,31,27,1,1,0.385,0.452,0.475,58
ceremonial,0.51,15,13,1,1,0.771,0.54,0.691,28
undeveloped,0.51,15,13,1,1,0.292,0.33,0.254,28
substituted,0.51,15,13,1,1,0.271,0.545,0.394,28
vocation,0.51,63,55,1,1,0.833,0.426,0.686,118
quickness,0.51,23,20,1,1,0.774,0.635,0.74,43
putt,0.51,15,13,1,1,0.48,0.5,0.418,28
pruning,0.51,15,13,1,1,0.265,0.302,0.31,28
exhaust,0.509,200,175,1,1,0.546,0.71,0.337,375
piper,0.509,160,140,1,1,0.569,0.442,0.398,300
train,0.509,4878,4272,1,1,0.666,0.705,0.62,9150
bestfriends,0.508,476,417,1,1,0.934,0.662,0.647,893
fray,0.508,88,77,1,1,0.337,0.542,0.482,165
satisfaction,0.508,705,618,1,1,0.939,0.637,0.673,1323
initiative,0.508,657,576,1,1,0.833,0.615,0.768,1233
breezy,0.508,64,56,1,1,0.531,0.472,0.482,120
nine,0.508,836,733,1,1,0.552,0.255,0.327,1569
rejoice,0.508,438,384,1,1,0.827,0.65,0.698,822
installation,0.507,56,49,1,1,0.656,0.469,0.759,105
wallet,0.507,561,492,1,1,0.68,0.432,0.5,1053
writer,0.507,2150,1886,1,1,0.806,0.33,0.78,4036
deer,0.507,301,264,1,1,0.583,0.375,0.292,565
reminisce,0.507,195,171,1,1,0.903,0.49,0.363,366
anon,0.507,579,508,1,1,0.479,0.354,0.298,1087
immune,0.507,473,415,1,1,0.629,0.472,0.78,888
teller,0.507,89,78,1,1,0.5,0.395,0.443,167
soil,0.507,269,236,1,1,0.35,0.18,0.356,505
survey,0.506,507,445,1,1,0.58,0.357,0.379,952
gator,0.506,40,35,1,1,0.418,0.52,0.547,75
tune,0.506,1821,1599,1,1,0.708,0.479,0.426,3420
psychological,0.506,861,756,1,1,0.406,0.449,0.66,1617
join,0.506,12673,11132,1,1,0.729,0.479,0.684,23805
peas,0.506,139,122,1,1,0.542,0.283,0.31,261
title,0.506,1960,1722,1,1,0.708,0.356,0.574,3682
level,0.506,8832,7760,1,1,0.622,0.277,0.491,16592
jewel,0.506,98,86,1,1,0.827,0.588,0.625,184
woe,0.505,280,246,1,1,0.34,0.606,0.204,526
jack,0.505,2546,2238,1,1,0.487,0.45,0.441,4784
unselfish,0.505,57,50,1,1,0.615,0.353,0.377,107
typical,0.505,1068,939,1,1,0.635,0.206,0.426,2007
darn,0.504,407,358,1,1,0.115,0.765,0.418,765
king,0.504,5097,4485,1,1,0.677,0.69,0.892,9582
hypothermia,0.504,24,21,1,1,0.184,0.62,0.301,45
whisk,0.504,24,21,1,1,0.5,0.537,0.412,45
budding,0.504,49,43,1,1,0.49,0.5,0.355,92
bloated,0.504,124,109,1,1,0.167,0.593,0.424,233
temple,0.504,474,417,1,1,0.612,0.269,0.66,891
uncertainty,0.504,684,602,1,1,0.064,0.494,0.282,1286
terrific,0.504,208,183,1,1,0.859,0.65,0.821,391
marvellous,0.503,66,58,1,1,0.878,0.809,0.849,124
intellect,0.503,226,199,1,1,0.844,0.418,0.87,425
preoccupied,0.503,142,125,1,1,0.265,0.7,0.235,267
fatty,0.503,100,88,1,1,0.286,0.361,0.325,188
whisky,0.503,117,103,1,1,0.64,0.615,0.49,220
tormented,0.502,210,185,1,1,0.071,0.855,0.323,395
reread,0.502,227,200,1,1,0.448,0.377,0.492,427
celibate,0.502,295,260,1,1,0.419,0.387,0.391,555
stamp,0.501,135,119,1,1,0.438,0.327,0.441,254
cadet,0.501,50,44,1,1,0.504,0.393,0.664,94
sporty,0.501,16,14,1,1,0.735,0.713,0.648,30
mythological,0.501,16,14,1,1,0.76,0.573,0.658,30
sameness,0.501,16,14,1,1,0.531,0.33,0.484,30
perky,0.501,33,29,1,1,0.896,0.792,0.673,62
unconsciousness,0.501,16,14,1,1,0.177,0.44,0.121,30
showroom,0.501,16,14,1,1,0.74,0.441,0.536,30
baron,0.501,101,89,1,1,0.52,0.358,0.709,190
checkers,0.501,33,29,1,1,0.676,0.451,0.437,62
garnish,0.501,16,14,1,1,0.765,0.418,0.49,30
taffy,0.501,16,14,1,1,0.448,0.431,0.204,30
wheels,0.501,263,232,1,1,0.667,0.471,0.386,495
mechanism,0.501,757,668,1,1,0.573,0.583,0.664,1425
deployment,0.501,144,127,1,1,0.51,0.52,0.612,271
fiery,0.501,127,112,1,1,0.418,0.85,0.721,239
free,0.501,27663,24422,1,1,0.896,0.5,0.544,52085
beast,0.501,1203,1062,1,1,0.214,0.78,0.732,2265
dazzling,0.5,59,52,1,1,0.854,0.88,0.767,111
safari,0.5,59,52,1,1,0.663,0.673,0.64,111
walker,0.5,711,628,1,1,0.551,0.491,0.525,1339
mono,0.5,1020,901,1,1,0.5,0.39,0.273,1921
singer,0.5,875,773,1,1,0.802,0.735,0.628,1648
scar,0.5,480,424,1,1,0.146,0.5,0.397,904
icon,0.5,420,371,1,1,0.549,0.349,0.415,791
hook,0.5,1546,1366,1,1,0.418,0.444,0.395,2912
plow,0.5,42,37,1,1,0.531,0.56,0.456,79
tapeworm,0.5,42,37,1,1,0.357,0.334,0.331,79
mite,0.5,68,60,1,1,0.29,0.584,0.271,128
doubtful,0.499,163,144,1,1,0.25,0.465,0.241,307
crib,0.499,1028,909,1,1,0.653,0.24,0.407,1937
clad,0.499,51,45,1,1,0.583,0.373,0.481,96
syllable,0.499,25,22,1,1,0.448,0.25,0.417,47
designing,0.499,103,91,1,1,0.792,0.355,0.552,194
elliptical,0.499,25,22,1,1,0.338,0.385,0.49,47
navigator,0.499,25,22,1,1,0.583,0.592,0.623,47
tiresome,0.499,181,160,1,1,0.24,0.542,0.153,341
alimony,0.499,25,22,1,1,0.612,0.477,0.464,47
cop,0.499,710,628,1,1,0.327,0.77,0.836,1338
shell,0.499,962,851,1,1,0.615,0.408,0.391,1813
cultivated,0.498,60,53,1,1,0.837,0.343,0.564,113
ministry,0.498,470,416,1,1,0.51,0.346,0.717,886
heir,0.498,95,84,1,1,0.84,0.654,0.764,179
lash,0.498,287,254,1,1,0.235,0.794,0.609,541
worthwhile,0.498,549,486,1,1,0.908,0.385,0.538,1035
imaging,0.498,69,61,1,1,0.724,0.394,0.482,130
irreparable,0.498,34,30,1,1,0.061,0.53,0.43,64
fictitious,0.498,34,30,1,1,0.224,0.444,0.293,64
chess,0.498,209,185,1,1,0.656,0.363,0.518,394
melting,0.497,262,232,1,1,0.592,0.47,0.538,494
bumblebee,0.497,43,38,1,1,0.469,0.493,0.321,81
elusive,0.497,87,77,1,1,0.229,0.615,0.466,164
heap,0.497,131,116,1,1,0.582,0.51,0.474,247
eraser,0.497,43,38,1,1,0.458,0.209,0.311,81
signify,0.497,43,38,1,1,0.453,0.422,0.634,81
misunderstood,0.497,2139,1896,1,1,0.177,0.625,0.309,4035
quantity,0.497,281,249,1,1,0.52,0.472,0.783,530
gazing,0.497,246,218,1,1,0.677,0.413,0.362,464
warlock,0.496,105,93,1,1,0.312,0.558,0.657,198
snag,0.496,52,46,1,1,0.417,0.25,0.339,98
lamenting,0.496,105,93,1,1,0.156,0.39,0.254,198
dominant,0.496,229,203,1,1,0.406,0.854,0.893,432
periscope,0.496,61,54,1,1,0.604,0.375,0.609,115
cellar,0.496,79,70,1,1,0.51,0.277,0.406,149
mimic,0.496,79,70,1,1,0.557,0.587,0.391,149
epic,0.495,1023,908,1,1,0.857,0.713,0.83,1931
utter,0.495,1184,1051,1,1,0.531,0.422,0.549,2235
obsess,0.495,204,181,1,1,0.112,0.846,0.509,385
attachment,0.495,623,553,1,1,0.57,0.343,0.5,1176
joker,0.495,311,276,1,1,0.771,0.76,0.416,587
seesaw,0.495,115,102,1,1,0.57,0.559,0.41,217
terminal,0.495,276,245,1,1,0.316,0.434,0.483,521
violet,0.495,285,253,1,1,0.688,0.272,0.401,538
planes,0.495,285,253,1,1,0.667,0.606,0.575,538
wallpaper,0.495,160,142,1,1,0.673,0.173,0.308,302
sweaty,0.495,322,286,1,1,0.281,0.54,0.304,608
collie,0.494,35,31,1,1,0.562,0.308,0.328,66
penultimate,0.494,17,15,1,1,0.469,0.366,0.255,32
ancient,0.494,602,535,1,1,0.42,0.217,0.439,1137
talon,0.494,35,31,1,1,0.344,0.569,0.475,66
apostrophe,0.494,17,15,1,1,0.469,0.368,0.537,32
cache,0.494,35,31,1,1,0.552,0.348,0.389,66
purist,0.494,17,15,1,1,0.625,0.418,0.575,32
ascetic,0.494,17,15,1,1,0.438,0.375,0.472,32
canterbury,0.494,26,23,1,1,0.582,0.438,0.51,49
wis,0.494,17,15,1,1,0.51,0.431,0.406,32
crayons,0.494,44,39,1,1,0.684,0.366,0.405,83
defunct,0.494,17,15,1,1,0.112,0.491,0.272,32
daybreak,0.494,35,31,1,1,0.802,0.358,0.474,66
fracture,0.494,35,31,1,1,0.135,0.74,0.375,66
steroid,0.494,26,23,1,1,0.36,0.706,0.681,49
selflove,0.494,26,23,1,1,0.854,0.63,0.661,49
century,0.493,913,812,1,1,0.407,0.347,0.735,1725
stained,0.493,171,152,1,1,0.245,0.46,0.209,323
horizon,0.493,534,475,1,1,0.729,0.284,0.59,1009
infinite,0.493,1026,913,1,1,0.724,0.583,0.735,1939
literacy,0.493,81,72,1,1,0.73,0.306,0.638,153
majestic,0.492,145,129,1,1,0.948,0.731,0.906,274
metaphorical,0.492,72,64,1,1,0.5,0.412,0.48,136
engaging,0.492,585,521,1,1,0.948,0.612,0.862,1106
masturbate,0.492,750,668,1,1,0.552,0.926,0.5,1418
presenter,0.492,54,48,1,1,0.673,0.607,0.735,102
architecture,0.492,109,97,1,1,0.82,0.39,0.694,206
telescope,0.491,45,40,1,1,0.531,0.34,0.5,85
scifi,0.491,45,40,1,1,0.592,0.57,0.394,85
vortex,0.491,91,81,1,1,0.408,0.691,0.602,172
advertise,0.491,137,122,1,1,0.5,0.529,0.58,259
psychology,0.491,542,483,1,1,0.561,0.396,0.726,1025
dried,0.491,340,303,1,1,0.427,0.26,0.385,643
smut,0.491,165,147,1,1,0.357,0.36,0.349,312
shooter,0.491,258,230,1,1,0.224,0.814,0.774,488
pluck,0.491,73,65,1,1,0.375,0.583,0.474,138
cautionary,0.491,36,32,1,1,0.51,0.541,0.519,68
subspace,0.491,73,65,1,1,0.47,0.453,0.475,138
engineer,0.49,305,272,1,1,0.719,0.5,0.875,577
bounty,0.49,92,82,1,1,0.76,0.755,0.833,174
shiny,0.49,390,348,1,1,0.885,0.604,0.787,738
surgeon,0.49,148,132,1,1,0.5,0.598,0.793,280
disguised,0.49,148,132,1,1,0.5,0.615,0.326,280
unbearable,0.49,1155,1031,1,1,0.125,0.798,0.447,2186
java,0.49,55,49,1,1,0.459,0.321,0.343,104
bashful,0.49,27,24,1,1,0.4,0.406,0.217,51
gladness,0.49,27,24,1,1,0.896,0.67,0.643,51
exceptional,0.49,223,199,1,1,0.806,0.74,0.933,422
ado,0.49,27,24,1,1,0.52,0.423,0.385,51
snowfall,0.49,27,24,1,1,0.675,0.28,0.455,51
flagging,0.49,27,24,1,1,0.521,0.519,0.509,51
ahoy,0.49,27,24,1,1,0.5,0.497,0.38,51
watchman,0.49,27,24,1,1,0.51,0.509,0.833,51
western,0.489,888,793,1,1,0.573,0.5,0.689,1681
destiny,0.489,1796,1604,1,1,0.781,0.413,0.611,3400
stoop,0.489,149,133,1,1,0.49,0.43,0.284,282
camel,0.489,74,66,1,1,0.54,0.282,0.314,140
paradox,0.489,300,268,1,1,0.417,0.442,0.482,568
flatter,0.488,65,58,1,1,0.521,0.418,0.302,123
hairline,0.488,65,58,1,1,0.418,0.154,0.23,123
fireworks,0.488,509,455,1,1,0.735,0.863,0.579,964
meadow,0.488,84,75,1,1,0.622,0.13,0.382,159
frail,0.488,207,185,1,1,0.255,0.333,0.069,392
lyric,0.488,973,870,1,1,0.702,0.269,0.464,1843
midnight,0.488,4663,4170,1,1,0.562,0.47,0.545,8833
heavyweight,0.488,18,16,1,1,0.429,0.578,0.713,34
liter,0.488,37,33,1,1,0.573,0.208,0.382,70
scrumptious,0.488,18,16,1,1,0.959,0.65,0.566,34
wheat,0.488,113,101,1,1,0.531,0.185,0.25,214
composite,0.488,18,16,1,1,0.591,0.459,0.62,34
agitation,0.488,37,33,1,1,0.24,0.931,0.447,70
smite,0.488,56,50,1,1,0.303,0.846,0.682,106
chimp,0.488,37,33,1,1,0.394,0.588,0.345,70
squadron,0.488,18,16,1,1,0.469,0.686,0.787,34
pierce,0.488,189,169,1,1,0.365,0.67,0.611,358
joyride,0.488,18,16,1,1,0.694,0.55,0.5,34
retailer,0.488,18,16,1,1,0.708,0.439,0.595,34
slurp,0.488,37,33,1,1,0.54,0.528,0.411,70
moderating,0.488,18,16,1,1,0.667,0.402,0.783,34
spiky,0.488,18,16,1,1,0.284,0.657,0.587,34
socialite,0.488,37,33,1,1,0.684,0.668,0.57,70
elope,0.488,18,16,1,1,0.396,0.694,0.528,34
lotion,0.487,199,178,1,1,0.724,0.261,0.188,377
lass,0.487,161,144,1,1,0.656,0.536,0.433,305
grapes,0.487,142,127,1,1,0.784,0.24,0.236,269
sow,0.487,190,170,1,1,0.667,0.43,0.446,360
bloke,0.487,324,290,1,1,0.45,0.479,0.545,614
inflated,0.487,66,59,1,1,0.303,0.431,0.617,125
sound,0.487,11850,10613,1,1,0.765,0.623,0.398,22463
lurking,0.487,392,351,1,1,0.421,0.781,0.575,743
situated,0.486,47,42,1,1,0.542,0.231,0.543,89
frivolous,0.486,47,42,1,1,0.271,0.565,0.377,89
oneself,0.486,826,740,1,1,0.66,0.337,0.483,1566
teaser,0.486,326,292,1,1,0.51,0.558,0.534,618
duality,0.486,105,94,1,1,0.438,0.52,0.503,199
rebound,0.486,240,215,1,1,0.521,0.48,0.506,455
propel,0.486,28,25,1,1,0.75,0.786,0.804,53
nook,0.486,57,51,1,1,0.48,0.321,0.296,108
dissolve,0.486,86,77,1,1,0.271,0.49,0.41,163
succumb,0.486,231,207,1,1,0.202,0.787,0.292,438
harshness,0.486,28,25,1,1,0.323,0.6,0.779,53
insult,0.485,890,798,1,1,0.085,0.831,0.389,1688
wagon,0.485,154,138,1,1,0.49,0.461,0.474,292
uninteresting,0.485,125,112,1,1,0.153,0.235,0.228,237
newfound,0.485,96,86,1,1,0.745,0.741,0.52,182
bigoted,0.485,232,208,1,1,0.153,0.76,0.462,440
chord,0.485,174,156,1,1,0.729,0.394,0.539,330
profession,0.485,515,462,1,1,0.68,0.529,0.786,977
canto,0.485,38,34,1,1,0.776,0.461,0.554,72
voucher,0.485,38,34,1,1,0.622,0.416,0.601,72
cavity,0.485,38,34,1,1,0.466,0.385,0.379,72
ghost,0.484,4836,4341,1,1,0.265,0.755,0.343,9177
dorky,0.484,87,78,1,1,0.302,0.48,0.39,165
recruitment,0.484,87,78,1,1,0.479,0.645,0.591,165
oppressive,0.484,166,149,1,1,0.276,0.59,0.667,315
puss,0.484,117,105,1,1,0.306,0.582,0.236,222
sou,0.483,127,114,1,1,0.48,0.39,0.412,241
mile,0.483,777,698,1,1,0.521,0.417,0.456,1475
stylish,0.483,68,61,1,1,0.885,0.49,0.689,129
crude,0.483,88,79,1,1,0.198,0.402,0.357,167
twin,0.483,1423,1279,1,1,0.688,0.363,0.453,2702
shoot,0.483,2616,2352,1,1,0.092,0.926,0.625,4968
painful,0.482,6105,5494,1,1,0.05,0.742,0.33,11599
meridian,0.482,19,17,1,1,0.51,0.324,0.558,36
copper,0.482,69,62,1,1,0.58,0.26,0.5,131
mutilation,0.482,19,17,1,1,0.122,0.782,0.456,36
weakling,0.482,39,35,1,1,0.194,0.294,0.087,74
obi,0.482,49,44,1,1,0.469,0.442,0.414,93
unpublished,0.482,19,17,1,1,0.406,0.48,0.481,36
layout,0.482,209,188,1,1,0.615,0.442,0.557,397
scenic,0.482,49,44,1,1,0.684,0.548,0.756,93
tyre,0.482,29,26,1,1,0.48,0.358,0.407,55
siege,0.482,129,116,1,1,0.271,0.75,0.567,245
peering,0.482,59,53,1,1,0.514,0.409,0.451,112
tux,0.482,19,17,1,1,0.531,0.365,0.462,36
brainy,0.482,19,17,1,1,0.708,0.52,0.648,36
piety,0.482,19,17,1,1,0.76,0.34,0.482,36
placard,0.482,19,17,1,1,0.388,0.442,0.5,36
geeky,0.482,69,62,1,1,0.479,0.431,0.454,131
sheepish,0.482,29,26,1,1,0.326,0.441,0.205,55
transcend,0.482,69,62,1,1,0.604,0.771,0.726,131
resonant,0.482,39,35,1,1,0.542,0.633,0.663,74
hump,0.482,129,116,1,1,0.296,0.462,0.25,245
latch,0.482,159,143,1,1,0.395,0.263,0.288,302
pity,0.481,3518,3168,1,1,0.16,0.398,0.114,6686
melt,0.481,664,598,1,1,0.448,0.615,0.312,1262
picture,0.481,6542,5893,1,1,0.714,0.308,0.462,12435
pug,0.481,120,108,1,1,0.6,0.298,0.462,228
squish,0.48,80,72,1,1,0.26,0.788,0.481,152
tome,0.48,80,72,1,1,0.429,0.316,0.492,152
examination,0.48,80,72,1,1,0.378,0.657,0.679,152
dummy,0.48,394,355,1,1,0.44,0.144,0.25,749
goon,0.48,70,63,1,1,0.312,0.481,0.361,133
mir,0.48,60,54,1,1,0.417,0.339,0.355,114
hindering,0.48,60,54,1,1,0.26,0.654,0.435,114
wire,0.48,233,210,1,1,0.48,0.33,0.245,443
bridge,0.48,1383,1247,1,1,0.625,0.324,0.519,2630
nana,0.48,560,505,1,1,0.765,0.255,0.375,1065
marrow,0.48,50,45,1,1,0.398,0.422,0.472,95
drinker,0.479,132,119,1,1,0.365,0.735,0.441,251
friends,0.479,183752,165793,1,1,0.929,0.51,0.625,349545
ecstatic,0.479,173,156,1,1,0.875,0.769,0.742,329
twilight,0.479,706,637,1,1,0.622,0.341,0.633,1343
darken,0.479,40,36,1,1,0.25,0.471,0.382,76
ancestor,0.479,40,36,1,1,0.592,0.388,0.594,76
valor,0.479,40,36,1,1,0.833,0.442,0.763,76
godless,0.479,81,73,1,1,0.316,0.557,0.358,154
antithesis,0.479,40,36,1,1,0.396,0.412,0.536,76
terrier,0.479,40,36,1,1,0.562,0.54,0.431,76
gardening,0.479,153,138,1,1,0.854,0.333,0.361,291
scatter,0.479,71,64,1,1,0.229,0.62,0.404,135
technological,0.479,71,64,1,1,0.68,0.452,0.815,135
scam,0.478,916,827,1,1,0.042,0.745,0.418,1743
fatherhood,0.478,30,27,1,1,0.885,0.519,0.682,57
dotted,0.478,30,27,1,1,0.48,0.347,0.426,57
solo,0.478,6160,5566,1,1,0.438,0.19,0.325,11726
drug,0.478,1949,1761,1,1,0.214,0.79,0.453,3710
drinking,0.477,6253,5652,1,1,0.562,0.459,0.317,11905
wilderness,0.477,906,819,1,1,0.281,0.333,0.29,1725
onset,0.477,93,84,1,1,0.673,0.497,0.5,177
shocker,0.477,93,84,1,1,0.235,0.804,0.616,177
smell,0.477,2529,2287,1,1,0.51,0.52,0.33,4816
pin,0.477,470,425,1,1,0.438,0.346,0.39,895
stimulation,0.477,198,179,1,1,0.708,0.821,0.702,377
everyman,0.476,20,18,1,1,0.522,0.333,0.535,38
seaweed,0.476,20,18,1,1,0.446,0.286,0.382,38
devilish,0.476,41,37,1,1,0.073,0.865,0.49,78
elixir,0.476,20,18,1,1,0.708,0.587,0.604,38
pamphlet,0.476,20,18,1,1,0.53,0.25,0.327,38
shaft,0.476,62,56,1,1,0.549,0.275,0.472,118
idolatry,0.476,20,18,1,1,0.365,0.571,0.625,38
writ,0.476,20,18,1,1,0.562,0.22,0.543,38
unconventional,0.476,62,56,1,1,0.177,0.509,0.288,118
knit,0.476,167,151,1,1,0.63,0.144,0.295,318
funday,0.476,20,18,1,1,0.743,0.549,0.525,38
mommy,0.476,1651,1494,1,1,0.854,0.353,0.422,3145
reduced,0.476,431,390,1,1,0.229,0.365,0.204,821
pancake,0.476,115,104,1,1,0.802,0.274,0.364,219
scoop,0.476,210,190,1,1,0.583,0.543,0.64,400
snake,0.476,938,849,1,1,0.276,0.75,0.549,1787
indescribable,0.476,221,200,1,1,0.448,0.529,0.648,421
stole,0.476,973,881,1,1,0.135,0.76,0.384,1854
telepathy,0.475,52,47,1,1,0.594,0.51,0.588,99
rewarding,0.475,593,537,1,1,0.958,0.637,0.783,1130
darling,0.475,3463,3137,1,1,0.885,0.37,0.608,6600
indicator,0.475,116,105,1,1,0.573,0.451,0.67,221
laughs,0.475,1563,1416,1,1,0.812,0.846,0.425,2979
increase,0.475,1161,1052,1,1,0.81,0.657,0.886,2213
wimpy,0.475,31,28,1,1,0.188,0.292,0.134,59
overestimate,0.475,31,28,1,1,0.367,0.796,0.444,59
divinity,0.475,63,57,1,1,0.896,0.559,0.774,120
magazine,0.475,469,425,1,1,0.615,0.332,0.377,894
cunning,0.474,74,67,1,1,0.604,0.685,0.683,141
practitioner,0.474,42,38,1,1,0.704,0.497,0.684,80
fang,0.474,42,38,1,1,0.175,0.491,0.455,80
telegraph,0.474,42,38,1,1,0.594,0.423,0.4,80
synonym,0.474,42,38,1,1,0.615,0.21,0.433,80
strawberry,0.474,322,292,1,1,0.833,0.27,0.336,614
refined,0.473,53,48,1,1,0.85,0.43,0.653,101
funky,0.473,215,195,1,1,0.531,0.755,0.389,410
cotton,0.473,215,195,1,1,0.639,0.071,0.24,410
bog,0.473,75,68,1,1,0.302,0.361,0.365,143
mob,0.473,814,739,1,1,0.296,0.788,0.567,1553
foggy,0.473,162,147,1,1,0.354,0.337,0.302,309
inkling,0.473,86,78,1,1,0.448,0.551,0.57,164
gig,0.472,556,505,1,1,0.816,0.755,0.594,1061
massage,0.472,578,525,1,1,0.708,0.356,0.413,1103
feature,0.472,678,616,1,1,0.667,0.314,0.679,1294
eager,0.472,459,417,1,1,0.521,0.812,0.306,876
background,0.472,2323,2111,1,1,0.399,0.357,0.498,4434
shoe,0.472,537,488,1,1,0.517,0.225,0.288,1025
send,0.472,14567,13242,1,1,0.663,0.48,0.537,27809
trinity,0.472,208,189,1,1,0.635,0.346,0.66,397
redundant,0.472,98,89,1,1,0.21,0.5,0.527,187
annihilate,0.472,21,19,1,1,0.115,0.918,0.681,40
impersonation,0.472,21,19,1,1,0.375,0.618,0.528,40
descending,0.472,65,59,1,1,0.219,0.493,0.25,124
yarn,0.472,54,49,1,1,0.51,0.265,0.233,103
meddle,0.472,32,29,1,1,0.302,0.77,0.526,61
distortion,0.472,43,39,1,1,0.299,0.57,0.38,82
primed,0.472,21,19,1,1,0.635,0.402,0.759,40
repertoire,0.472,21,19,1,1,0.633,0.594,0.667,40
mason,0.472,230,209,1,1,0.541,0.442,0.58,439
scab,0.472,32,29,1,1,0.354,0.33,0.272,61
adjacent,0.472,76,69,1,1,0.645,0.276,0.536,145
divergent,0.472,21,19,1,1,0.449,0.66,0.587,40
humorous,0.472,109,99,1,1,0.906,0.616,0.665,208
dingo,0.472,21,19,1,1,0.608,0.472,0.346,40
botanical,0.472,21,19,1,1,0.66,0.259,0.491,40
radar,0.471,220,200,1,1,0.521,0.615,0.579,420
chambers,0.471,165,150,1,1,0.542,0.442,0.388,315
swoop,0.471,88,80,1,1,0.479,0.618,0.446,168
original,0.47,2383,2169,1,1,0.765,0.48,0.746,4552
unfollow,0.47,692,630,1,1,0.281,0.337,0.293,1322
tour,0.47,3276,2983,1,1,0.663,0.545,0.543,6259
meaningful,0.47,1694,1543,1,1,0.77,0.5,0.802,3237
guacamole,0.469,44,40,1,1,0.684,0.317,0.282,84
cretins,0.469,44,40,1,1,0.094,0.741,0.328,84
nighttime,0.469,417,380,1,1,0.735,0.385,0.439,797
geographical,0.469,33,30,1,1,0.5,0.317,0.637,63
pallet,0.469,33,30,1,1,0.604,0.241,0.349,63
vamp,0.469,33,30,1,1,0.31,0.794,0.566,63
metallic,0.469,33,30,1,1,0.615,0.33,0.607,63
pacific,0.469,203,185,1,1,0.627,0.118,0.58,388
monastery,0.469,33,30,1,1,0.694,0.183,0.726,63
sally,0.469,305,278,1,1,0.604,0.39,0.451,583
cruise,0.468,442,403,1,1,0.74,0.442,0.683,845
poppy,0.468,204,186,1,1,0.635,0.392,0.357,390
provocative,0.468,56,51,1,1,0.438,0.814,0.684,107
usual,0.468,3710,3385,1,1,0.625,0.221,0.4,7095
magnificent,0.468,319,291,1,1,1,0.68,0.886,610
witty,0.468,228,208,1,1,0.857,0.707,0.759,436
cart,0.467,286,261,1,1,0.52,0.344,0.388,547
citadel,0.467,22,20,1,1,0.585,0.464,0.602,42
prehistoric,0.467,22,20,1,1,0.417,0.317,0.419,42
waxed,0.467,22,20,1,1,0.531,0.388,0.408,42
reciprocal,0.467,45,41,1,1,0.677,0.52,0.66,86
vigorous,0.467,22,20,1,1,0.857,0.77,0.897,42
divert,0.467,114,104,1,1,0.344,0.622,0.407,218
toffee,0.467,22,20,1,1,0.658,0.51,0.396,42
blasphemous,0.467,22,20,1,1,0.21,0.755,0.491,42
goof,0.467,114,104,1,1,0.448,0.49,0.272,218
philanthropist,0.467,22,20,1,1,0.704,0.463,0.623,42
charming,0.467,506,462,1,1,0.917,0.66,0.764,968
dub,0.467,276,252,1,1,0.51,0.48,0.387,528
sweep,0.467,219,200,1,1,0.448,0.385,0.383,419
revenge,0.467,718,656,1,1,0.23,0.94,0.627,1374
idealistic,0.466,57,52,1,1,0.812,0.469,0.755,109
familiarity,0.466,150,137,1,1,0.854,0.346,0.616,287
banner,0.466,301,275,1,1,0.521,0.408,0.474,576
city,0.466,12828,11727,1,1,0.847,0.531,0.508,24555
witch,0.466,1060,969,1,1,0.292,0.71,0.473,2029
intermission,0.466,34,31,1,1,0.49,0.36,0.402,65
clubhouse,0.466,34,31,1,1,0.694,0.571,0.493,65
galore,0.466,69,63,1,1,0.823,0.574,0.729,132
meanness,0.466,34,31,1,1,0.102,0.694,0.368,65
petty,0.466,1236,1130,1,1,0.21,0.537,0.236,2366
pest,0.466,81,74,1,1,0.188,0.68,0.452,155
attract,0.466,878,803,1,1,0.796,0.663,0.769,1681
weeping,0.465,386,353,1,1,0.082,0.688,0.168,739
flavor,0.465,269,246,1,1,0.885,0.479,0.392,515
letter,0.465,2149,1966,1,1,0.635,0.279,0.342,4115
congestion,0.465,46,42,1,1,0.271,0.654,0.491,88
thorn,0.465,105,96,1,1,0.296,0.541,0.427,201
availability,0.465,105,96,1,1,0.796,0.544,0.6,201
shatter,0.465,212,194,1,1,0.108,0.821,0.464,406
vigil,0.464,165,151,1,1,0.521,0.48,0.491,316
heart,0.464,71466,65445,1,1,0.827,0.5,0.693,136911
cocky,0.464,189,173,1,1,0.26,0.784,0.519,362
hippie,0.464,94,86,1,1,0.551,0.4,0.396,180
hour,0.464,10891,9974,1,1,0.552,0.265,0.336,20865
beer,0.464,2381,2181,1,1,0.592,0.654,0.5,4562
brat,0.464,393,360,1,1,0.312,0.44,0.231,753
deep,0.464,16683,15289,1,1,0.49,0.473,0.657,31972
winger,0.463,23,21,1,1,0.531,0.794,0.691,44
broth,0.463,35,32,1,1,0.5,0.245,0.168,67
encyclopedia,0.463,23,21,1,1,0.679,0.32,0.645,44
hick,0.463,23,21,1,1,0.357,0.442,0.314,44
velocity,0.463,23,21,1,1,0.673,0.769,0.783,44
wormhole,0.463,23,21,1,1,0.337,0.38,0.483,44
blackberry,0.463,23,21,1,1,0.667,0.413,0.453,44
amusing,0.463,251,230,1,1,0.96,0.829,0.632,481
virtuous,0.463,71,65,1,1,0.89,0.53,0.822,136
lien,0.463,23,21,1,1,0.396,0.58,0.441,44
backtrack,0.463,23,21,1,1,0.312,0.525,0.278,44
hefty,0.463,59,54,1,1,0.55,0.654,0.745,113
lore,0.463,179,164,1,1,0.719,0.373,0.768,343
relation,0.462,508,466,1,1,0.857,0.604,0.625,974
drinks,0.462,1733,1590,1,1,0.729,0.656,0.412,3323
sheer,0.462,606,556,1,1,0.604,0.25,0.481,1162
apathetic,0.462,169,155,1,1,0.188,0.292,0.333,324
eerie,0.462,291,267,1,1,0.265,0.771,0.442,558
faux,0.462,206,189,1,1,0.291,0.49,0.204,395
intensity,0.462,206,189,1,1,0.622,0.93,0.952,395
shadowy,0.462,60,55,1,1,0.135,0.373,0.33,115
tummy,0.462,305,280,1,1,0.427,0.365,0.23,585
sporadic,0.461,48,44,1,1,0.333,0.394,0.5,92
inwards,0.461,36,33,1,1,0.49,0.385,0.438,69
mantle,0.461,73,67,1,1,0.51,0.269,0.422,140
subliminal,0.461,36,33,1,1,0.41,0.528,0.464,69
seam,0.461,36,33,1,1,0.427,0.25,0.414,69
nameless,0.461,110,101,1,1,0.344,0.28,0.164,211
absent,0.461,530,487,1,1,0.177,0.221,0.116,1017
anonymity,0.461,135,124,1,1,0.469,0.255,0.43,259
cheered,0.46,322,296,1,1,0.875,0.648,0.79,618
stinky,0.46,198,182,1,1,0.092,0.558,0.176,380
dissertation,0.46,136,125,1,1,0.312,0.575,0.575,261
convey,0.46,323,297,1,1,0.719,0.633,0.708,620
palm,0.46,485,446,1,1,0.531,0.194,0.34,931
marijuana,0.46,186,171,1,1,0.312,0.779,0.558,357
nest,0.46,398,366,1,1,0.687,0.221,0.333,764
occasional,0.46,561,516,1,1,0.49,0.298,0.387,1077
badness,0.46,24,22,1,1,0.094,0.823,0.463,46
uncompromising,0.46,24,22,1,1,0.32,0.531,0.613,46
transcendental,0.46,24,22,1,1,0.635,0.652,0.842,46
pathway,0.459,137,126,1,1,0.646,0.41,0.519,263
seasonal,0.459,465,428,1,1,0.592,0.273,0.305,893
actress,0.459,415,382,1,1,0.633,0.556,0.596,797
horrid,0.459,403,371,1,1,0.052,0.765,0.419,774
intangible,0.459,37,34,1,1,0.525,0.48,0.473,71
snuggled,0.459,189,174,1,1,0.552,0.439,0.314,363
comeback,0.458,1471,1355,1,1,0.58,0.409,0.555,2826
greeted,0.458,215,198,1,1,0.781,0.317,0.454,413
undressed,0.458,50,46,1,1,0.375,0.755,0.356,96
beige,0.458,50,46,1,1,0.49,0.222,0.224,96
illustrate,0.458,63,58,1,1,0.75,0.43,0.69,121
downer,0.458,217,200,1,1,0.12,0.594,0.226,417
bugger,0.457,128,118,1,1,0.312,0.627,0.474,246
trail,0.457,541,499,1,1,0.6,0.322,0.455,1040
brunch,0.456,272,251,1,1,0.406,0.363,0.343,523
unequal,0.456,38,35,1,1,0.118,0.433,0.202,73
auburn,0.456,51,47,1,1,0.51,0.24,0.411,98
occupant,0.456,38,35,1,1,0.5,0.417,0.483,73
peek,0.456,194,179,1,1,0.486,0.36,0.411,373
hoot,0.456,77,71,1,1,0.449,0.56,0.43,148
kebab,0.456,38,35,1,1,0.531,0.431,0.377,73
cyberspace,0.456,38,35,1,1,0.677,0.594,0.611,73
undertaking,0.456,38,35,1,1,0.667,0.53,0.696,73
dumpling,0.456,25,23,1,1,0.58,0.321,0.36,48
liberate,0.456,64,59,1,1,0.76,0.632,0.708,123
vocalist,0.456,90,83,1,1,0.688,0.596,0.596,173
moderately,0.456,77,71,1,1,0.604,0.264,0.5,148
futile,0.456,221,204,1,1,0.122,0.332,0.158,425
revolving,0.456,182,168,1,1,0.602,0.57,0.58,350
alpha,0.456,575,531,1,1,0.708,0.34,0.755,1106
slayer,0.456,104,96,1,1,0.041,0.93,0.661,200
glorified,0.455,91,84,1,1,0.865,0.57,0.886,175
bandwagon,0.455,236,218,1,1,0.625,0.651,0.509,454
sperm,0.455,210,194,1,1,0.396,0.706,0.453,404
espresso,0.455,65,60,1,1,0.677,0.62,0.508,125
grouchy,0.455,65,60,1,1,0.143,0.708,0.407,125
cocktail,0.455,237,219,1,1,0.74,0.48,0.381,456
wrath,0.455,224,207,1,1,0.039,0.908,0.548,431
jerk,0.455,1005,929,1,1,0.194,0.63,0.238,1934
observer,0.455,105,97,1,1,0.663,0.363,0.603,202
freight,0.455,52,48,1,1,0.411,0.528,0.49,100
earrings,0.454,79,73,1,1,0.676,0.346,0.517,152
mount,0.454,199,184,1,1,0.5,0.292,0.348,383
hostility,0.454,119,110,1,1,0.122,0.775,0.465,229
wheel,0.454,1094,1012,1,1,0.615,0.31,0.446,2106
farm,0.454,1028,951,1,1,0.781,0.327,0.297,1979
bonus,0.454,721,667,1,1,0.857,0.62,0.682,1388
expression,0.454,1109,1026,1,1,0.79,0.65,0.721,2135
filler,0.454,106,98,1,1,0.531,0.347,0.529,204
sarcastic,0.454,455,421,1,1,0.397,0.781,0.298,876
contest,0.454,348,322,1,1,0.667,0.698,0.717,670
bong,0.454,187,173,1,1,0.333,0.566,0.375,360
knockout,0.453,26,24,1,1,0.388,0.755,0.664,50
artifact,0.453,26,24,1,1,0.51,0.5,0.566,50
singularity,0.453,161,149,1,1,0.582,0.348,0.654,310
melon,0.453,107,99,1,1,0.461,0.231,0.271,206
diversion,0.453,53,49,1,1,0.74,0.821,0.714,102
ex,0.453,6994,6479,1,1,0.25,0.52,0.306,13473
hack,0.453,502,465,1,1,0.135,0.717,0.534,967
tilting,0.453,108,100,1,1,0.459,0.384,0.34,208
disarm,0.452,40,37,1,1,0.292,0.528,0.613,77
ubiquitous,0.452,40,37,1,1,0.635,0.571,0.884,77
scooter,0.452,136,126,1,1,0.51,0.587,0.371,262
shield,0.452,616,571,1,1,0.51,0.373,0.663,1187
burning,0.452,1661,1540,1,1,0.229,0.76,0.412,3201
cemetery,0.452,260,241,1,1,0.051,0.63,0.417,501
artistry,0.452,54,50,1,1,0.823,0.346,0.769,104
tumble,0.452,54,50,1,1,0.276,0.556,0.272,104
disoriented,0.452,54,50,1,1,0.227,0.643,0.227,104
sunken,0.452,68,63,1,1,0.103,0.476,0.173,131
tally,0.451,82,76,1,1,0.542,0.42,0.518,158
guy,0.451,27438,25455,1,1,0.583,0.367,0.546,52893
selective,0.451,415,385,1,1,0.612,0.347,0.706,800
childish,0.451,1110,1030,1,1,0.573,0.442,0.23,2140
masked,0.451,138,128,1,1,0.375,0.549,0.518,266
woof,0.451,152,141,1,1,0.354,0.509,0.404,293
fidelity,0.45,41,38,1,1,0.765,0.58,0.709,79
burner,0.45,153,142,1,1,0.296,0.816,0.446,295
symbolically,0.45,13,12,1,1,0.582,0.385,0.648,25
enclose,0.45,13,12,1,1,0.531,0.477,0.473,25
basil,0.45,55,51,1,1,0.534,0.274,0.309,106
fuckoff,0.45,13,12,1,1,0.19,0.7,0.457,25
depreciation,0.45,13,12,1,1,0.143,0.571,0.386,25
sloop,0.45,13,12,1,1,0.48,0.375,0.38,25
berserk,0.45,41,38,1,1,0.398,0.556,0.48,79
beastly,0.45,13,12,1,1,0.146,0.874,0.843,25
jig,0.45,27,25,1,1,0.531,0.396,0.357,52
detritus,0.45,13,12,1,1,0.276,0.353,0.363,25
wildcat,0.45,13,12,1,1,0.458,0.632,0.481,25
hemorrhoids,0.45,13,12,1,1,0.133,0.702,0.304,25
molded,0.45,69,64,1,1,0.667,0.361,0.373,133
reimbursement,0.45,13,12,1,1,0.653,0.61,0.567,25
accordion,0.45,13,12,1,1,0.604,0.49,0.361,25
stow,0.45,13,12,1,1,0.615,0.365,0.523,25
objectionable,0.45,13,12,1,1,0.459,0.382,0.558,25
unveiling,0.45,13,12,1,1,0.569,0.57,0.675,25
waterfront,0.45,27,25,1,1,0.716,0.274,0.556,52
capitals,0.45,27,25,1,1,0.755,0.5,0.655,52
spammers,0.45,13,12,1,1,0.354,0.5,0.418,25
contemptuous,0.45,13,12,1,1,0.204,0.5,0.375,25
quiche,0.45,13,12,1,1,0.5,0.456,0.396,25
verbose,0.45,13,12,1,1,0.439,0.48,0.635,25
cultivation,0.45,13,12,1,1,0.625,0.324,0.462,25
boisterous,0.45,41,38,1,1,0.385,0.806,0.565,79
psycho,0.45,857,796,1,1,0.039,0.922,0.56,1653
stat,0.45,182,169,1,1,0.479,0.46,0.395,351
aggressively,0.45,267,248,1,1,0.25,0.926,0.688,515
costume,0.45,423,393,1,1,0.548,0.51,0.374,816
leading,0.449,1701,1581,1,1,0.823,0.698,0.954,3282
ascend,0.449,70,65,1,1,0.83,0.62,0.812,135
swine,0.449,70,65,1,1,0.34,0.519,0.277,135
winner,0.449,1036,963,1,1,0.96,0.81,0.886,1999
brim,0.449,56,52,1,1,0.469,0.333,0.33,108
nation,0.449,4038,3755,1,1,0.594,0.443,0.821,7793
waterfall,0.449,99,92,1,1,0.652,0.46,0.528,191
grease,0.449,99,92,1,1,0.255,0.404,0.306,191
nonfiction,0.449,42,39,1,1,0.426,0.315,0.431,81
synopsis,0.448,71,66,1,1,0.541,0.39,0.482,137
replace,0.448,1439,1339,1,1,0.417,0.52,0.5,2778
clock,0.448,1355,1261,1,1,0.677,0.173,0.407,2616
penthouse,0.448,100,93,1,1,0.592,0.43,0.395,193
snotty,0.448,28,26,1,1,0.18,0.382,0.2,54
preface,0.448,28,26,1,1,0.459,0.375,0.557,54
slink,0.448,28,26,1,1,0.46,0.546,0.314,54
prompting,0.448,28,26,1,1,0.587,0.423,0.571,54
spinner,0.448,28,26,1,1,0.458,0.593,0.471,54
landed,0.448,376,350,1,1,0.709,0.62,0.48,726
sweetness,0.448,202,188,1,1,0.906,0.474,0.528,390
discrete,0.448,28,26,1,1,0.585,0.231,0.429,54
egomaniac,0.448,28,26,1,1,0.133,0.708,0.596,54
interval,0.448,28,26,1,1,0.51,0.284,0.4,54
version,0.448,4007,3731,1,1,0.604,0.423,0.538,7738
ninja,0.448,275,256,1,1,0.542,0.844,0.682,531
immortal,0.448,464,432,1,1,0.812,0.75,0.795,896
hoy,0.448,188,175,1,1,0.583,0.298,0.471,363
sarcasm,0.448,421,392,1,1,0.125,0.685,0.346,813
dog,0.447,18775,17486,1,1,0.704,0.5,0.407,36261
radiant,0.447,101,94,1,1,0.888,0.717,0.791,195
address,0.447,1954,1820,1,1,0.65,0.327,0.567,3774
holiday,0.447,6355,5920,1,1,0.948,0.431,0.593,12275
snow,0.447,2252,2098,1,1,0.667,0.363,0.309,4350
deathly,0.447,204,190,1,1,0.073,0.771,0.682,394
blockbuster,0.447,43,40,1,1,0.73,0.676,0.883,83
prone,0.447,441,411,1,1,0.415,0.434,0.454,852
crawl,0.447,1163,1084,1,1,0.479,0.519,0.467,2247
mocha,0.447,58,54,1,1,0.5,0.396,0.311,112
cinematic,0.446,132,123,1,1,0.663,0.49,0.6,255
rotate,0.446,73,68,1,1,0.458,0.47,0.492,141
abandon,0.446,1586,1479,1,1,0.052,0.519,0.245,3065
hetero,0.446,177,165,1,1,0.589,0.405,0.435,342
twisted,0.446,1097,1023,1,1,0.071,0.736,0.311,2120
blank,0.446,997,930,1,1,0.531,0.229,0.25,1927
whiny,0.446,372,347,1,1,0.208,0.548,0.375,719
colored,0.446,208,194,1,1,0.806,0.317,0.275,402
alto,0.445,44,41,1,1,0.656,0.404,0.73,85
crouched,0.445,29,27,1,1,0.333,0.363,0.279,56
attribution,0.445,14,13,1,1,0.646,0.467,0.658,27
veal,0.445,14,13,1,1,0.438,0.337,0.41,27
laborious,0.445,14,13,1,1,0.393,0.635,0.709,27
lecherous,0.445,14,13,1,1,0.135,0.704,0.376,27
southwest,0.445,44,41,1,1,0.406,0.314,0.355,85
unassuming,0.445,14,13,1,1,0.49,0.23,0.471,27
furlough,0.445,14,13,1,1,0.531,0.432,0.772,27
womanly,0.445,14,13,1,1,0.909,0.615,0.473,27
gatekeeper,0.445,29,27,1,1,0.51,0.49,0.598,56
wingman,0.445,74,69,1,1,0.573,0.578,0.582,143
preppy,0.445,14,13,1,1,0.542,0.52,0.442,27
smuggling,0.445,14,13,1,1,0.229,0.783,0.51,27
pubic,0.445,29,27,1,1,0.406,0.57,0.509,56
discreet,0.445,89,83,1,1,0.552,0.216,0.532,172
puppeteer,0.445,14,13,1,1,0.337,0.491,0.39,27
watchdog,0.445,14,13,1,1,0.531,0.811,0.648,27
stranded,0.445,540,504,1,1,0.292,0.459,0.219,1044
unsolicited,0.445,165,154,1,1,0.094,0.339,0.28,319
attach,0.445,317,296,1,1,0.52,0.363,0.559,613
serpent,0.445,90,84,1,1,0.115,0.696,0.679,174
homage,0.444,75,70,1,1,0.833,0.56,0.737,145
fucking,0.444,57227,53465,1,1,0.229,0.812,0.39,110692
sun,0.444,7627,7126,1,1,0.877,0.4,0.681,14753
meow,0.444,380,355,1,1,0.51,0.51,0.412,735
chameleon,0.444,60,56,1,1,0.49,0.58,0.345,116
canoe,0.444,45,42,1,1,0.542,0.3,0.418,87
gamble,0.443,184,172,1,1,0.568,0.798,0.361,356
cafe,0.443,1110,1038,1,1,0.781,0.392,0.358,2148
puny,0.443,30,28,1,1,0.312,0.324,0.135,58
schoolgirl,0.443,30,28,1,1,0.76,0.521,0.415,58
oat,0.443,30,28,1,1,0.622,0.17,0.298,58
corrupting,0.443,30,28,1,1,0.062,0.804,0.38,58
bullpen,0.443,30,28,1,1,0.48,0.549,0.5,58
commanding,0.443,30,28,1,1,0.562,0.664,0.925,58
decadent,0.443,30,28,1,1,0.29,0.559,0.324,58
hovel,0.443,30,28,1,1,0.333,0.296,0.322,58
gage,0.443,30,28,1,1,0.552,0.451,0.473,58
puddle,0.443,170,159,1,1,0.396,0.302,0.298,329
bonding,0.443,388,363,1,1,0.594,0.442,0.509,751
corner,0.443,6087,5697,1,1,0.4,0.296,0.366,11784
complement,0.442,93,87,1,1,0.76,0.277,0.6,180
torrent,0.442,46,43,1,1,0.541,0.745,0.676,89
project,0.442,3020,2828,1,1,0.725,0.462,0.853,5848
thoughtless,0.442,62,58,1,1,0.194,0.58,0.452,120
incomparable,0.442,62,58,1,1,0.625,0.577,0.67,120
greyhound,0.442,62,58,1,1,0.52,0.49,0.44,120
mindless,0.442,220,206,1,1,0.184,0.333,0.153,426
ranking,0.442,220,206,1,1,0.54,0.592,0.68,426
dirty,0.442,2991,2802,1,1,0.153,0.46,0.17,5793
remorse,0.441,237,222,1,1,0.103,0.673,0.377,459
foxhole,0.441,15,14,1,1,0.312,0.539,0.389,29
spacecraft,0.441,31,29,1,1,0.646,0.698,0.68,60
savory,0.441,15,14,1,1,0.812,0.717,0.619,29
pix,0.441,95,89,1,1,0.521,0.373,0.364,184
checkpoint,0.441,15,14,1,1,0.571,0.323,0.812,29
jumper,0.441,95,89,1,1,0.615,0.336,0.481,184
unbeaten,0.441,15,14,1,1,0.854,0.76,0.828,29
leafy,0.441,31,29,1,1,0.653,0.53,0.7,60
trot,0.441,47,44,1,1,0.531,0.664,0.396,91
buckaroo,0.441,15,14,1,1,0.448,0.469,0.479,29
cider,0.441,111,104,1,1,0.53,0.346,0.398,215
moxie,0.441,15,14,1,1,0.531,0.49,0.366,29
ultimate,0.441,1334,1251,1,1,0.648,0.645,0.544,2585
excite,0.44,160,150,1,1,0.823,0.95,0.668,310
heck,0.44,1981,1858,1,1,0.24,0.728,0.56,3839
vogue,0.44,64,60,1,1,0.74,0.491,0.538,124
coven,0.44,64,60,1,1,0.458,0.578,0.591,124
cookout,0.44,48,45,1,1,0.68,0.406,0.482,93
complexity,0.44,146,137,1,1,0.479,0.62,0.595,283
standup,0.44,48,45,1,1,0.633,0.583,0.55,93
upright,0.44,97,91,1,1,0.667,0.373,0.6,188
portal,0.439,179,168,1,1,0.583,0.347,0.547,347
psychotic,0.439,311,292,1,1,0.198,0.856,0.474,603
death,0.439,14162,13301,1,1,0.031,0.72,0.472,27463
tempt,0.439,98,92,1,1,0.21,0.677,0.5,190
plateau,0.439,32,30,1,1,0.611,0.316,0.4,62
receding,0.439,32,30,1,1,0.224,0.418,0.333,62
fix,0.438,7831,7359,1,1,0.76,0.538,0.519,15190
loony,0.438,82,77,1,1,0.439,0.474,0.295,159
feeling,0.438,213462,200642,1,1,0.806,0.329,0.531,414104
sniper,0.438,99,93,1,1,0.167,0.87,0.853,192
plank,0.438,49,46,1,1,0.427,0.28,0.333,95
warming,0.438,516,485,1,1,0.594,0.637,0.58,1001
tempered,0.438,66,62,1,1,0.583,0.437,0.667,128
slug,0.438,83,78,1,1,0.276,0.37,0.16,161
serene,0.438,201,189,1,1,0.802,0.132,0.37,390
jester,0.437,134,126,1,1,0.388,0.67,0.264,260
rail,0.437,151,142,1,1,0.47,0.5,0.526,293
predominant,0.437,16,15,1,1,0.68,0.596,0.827,31
epoch,0.437,16,15,1,1,0.553,0.343,0.797,31
inquisitor,0.437,16,15,1,1,0.385,0.873,0.642,31
cameo,0.437,84,79,1,1,0.573,0.457,0.509,163
churn,0.437,33,31,1,1,0.316,0.491,0.407,64
foreigner,0.437,152,143,1,1,0.5,0.519,0.48,295
ox,0.437,33,31,1,1,0.417,0.396,0.412,64
wicket,0.437,16,15,1,1,0.5,0.5,0.471,31
lithium,0.437,33,31,1,1,0.417,0.33,0.43,64
trustee,0.437,16,15,1,1,0.531,0.442,0.658,31
barman,0.437,16,15,1,1,0.594,0.61,0.4,31
mash,0.437,118,111,1,1,0.44,0.363,0.283,229
luster,0.437,16,15,1,1,0.833,0.566,0.558,31
dazzle,0.437,16,15,1,1,0.73,0.782,0.683,31
spatial,0.437,16,15,1,1,0.604,0.625,0.645,31
random,0.437,6418,6042,1,1,0.49,0.52,0.321,12460
construct,0.437,170,160,1,1,0.75,0.648,0.792,330
agent,0.437,786,740,1,1,0.48,0.439,0.755,1526
pretended,0.437,290,273,1,1,0.167,0.556,0.227,563
poison,0.436,755,711,1,1,0.083,0.76,0.573,1466
testosterone,0.436,85,80,1,1,0.573,0.84,0.775,165
hint,0.436,946,891,1,1,0.602,0.33,0.517,1837
nigh,0.436,137,129,1,1,0.653,0.216,0.336,266
incoming,0.436,172,162,1,1,0.66,0.509,0.596,334
slot,0.436,172,162,1,1,0.469,0.337,0.337,334
insistent,0.436,51,48,1,1,0.552,0.635,0.701,99
grr,0.436,86,81,1,1,0.229,0.538,0.333,167
gaming,0.436,1078,1016,1,1,0.896,0.633,0.491,2094
memories,0.436,7674,7233,1,1,0.963,0.487,0.51,14907
ad,0.435,1413,1332,1,1,0.521,0.705,0.558,2745
tiger,0.435,541,510,1,1,0.479,0.765,0.664,1051
hound,0.435,139,131,1,1,0.417,0.528,0.582,270
bearded,0.435,104,98,1,1,0.439,0.337,0.391,202
glossy,0.435,34,32,1,1,0.802,0.519,0.807,66
meh,0.435,1177,1110,1,1,0.38,0.286,0.365,2287
petulant,0.435,87,82,1,1,0.247,0.685,0.491,169
sunshine,0.435,2077,1959,1,1,0.885,0.297,0.769,4036
scenery,0.435,334,315,1,1,0.745,0.253,0.592,649
inept,0.435,211,199,1,1,0.156,0.418,0.209,410
unsung,0.435,52,49,1,1,0.296,0.33,0.314,101
strolling,0.435,105,99,1,1,0.755,0.515,0.34,204
skateboard,0.435,52,49,1,1,0.677,0.55,0.353,101
alienated,0.434,710,670,1,1,0.41,0.423,0.559,1380
immaturity,0.434,88,83,1,1,0.146,0.567,0.221,171
daft,0.434,195,184,1,1,0.255,0.436,0.157,379
outsider,0.434,571,539,1,1,0.398,0.549,0.447,1110
cartoon,0.434,411,388,1,1,0.867,0.471,0.387,799
link,0.434,2365,2233,1,1,0.427,0.264,0.491,4598
radio,0.434,3085,2913,1,1,0.573,0.402,0.358,5998
ironic,0.434,950,897,1,1,0.435,0.55,0.5,1847
theme,0.434,2049,1935,1,1,0.541,0.176,0.427,3984
shortening,0.433,17,16,1,1,0.286,0.333,0.385,33
ascertain,0.433,17,16,1,1,0.56,0.53,0.625,33
versatility,0.433,17,16,1,1,0.878,0.585,0.75,33
noxious,0.433,17,16,1,1,0.177,0.585,0.379,33
mountaintop,0.433,53,50,1,1,0.653,0.541,0.713,103
skimpy,0.433,17,16,1,1,0.302,0.349,0.208,33
octave,0.433,17,16,1,1,0.438,0.38,0.482,33
disloyalty,0.433,35,33,1,1,0.187,0.716,0.267,68
junta,0.433,17,16,1,1,0.451,0.503,0.704,33
amass,0.433,17,16,1,1,0.552,0.465,0.465,33
retrace,0.433,17,16,1,1,0.25,0.482,0.317,33
palatable,0.433,35,33,1,1,0.823,0.5,0.594,68
pond,0.433,342,323,1,1,0.52,0.337,0.358,665
faraway,0.433,126,119,1,1,0.365,0.356,0.285,245
goofy,0.433,674,637,1,1,0.281,0.224,0.179,1311
vicious,0.433,565,534,1,1,0.208,0.694,0.407,1099
celebrity,0.433,748,707,1,1,0.76,0.619,0.855,1455
parade,0.432,495,468,1,1,0.792,0.685,0.509,963
lick,0.432,460,435,1,1,0.47,0.482,0.33,895
glue,0.432,221,209,1,1,0.45,0.345,0.349,430
demise,0.432,278,263,1,1,0.104,0.596,0.456,541
buffet,0.432,148,140,1,1,0.656,0.546,0.519,288
tofu,0.431,55,52,1,1,0.521,0.33,0.283,107
replicate,0.431,55,52,1,1,0.48,0.63,0.585,107
trendy,0.431,130,123,1,1,0.713,0.52,0.536,253
code,0.431,1442,1365,1,1,0.583,0.308,0.491,2807
magnetic,0.431,74,70,1,1,0.612,0.529,0.673,144
dumb,0.431,8693,8230,1,1,0.188,0.33,0.151,16923
ink,0.431,300,284,1,1,0.471,0.408,0.235,584
connect,0.431,4910,4649,1,1,0.724,0.299,0.536,9559
color,0.431,2309,2187,1,1,0.786,0.28,0.402,4496
blanket,0.43,1669,1581,1,1,0.74,0.132,0.391,3250
rhubarb,0.43,18,17,1,1,0.582,0.304,0.34,35
deliberation,0.43,18,17,1,1,0.561,0.678,0.596,35
maudlin,0.43,18,17,1,1,0.337,0.417,0.368,35
forbidding,0.43,18,17,1,1,0.198,0.781,0.5,35
evangelist,0.43,18,17,1,1,0.582,0.464,0.702,35
carver,0.43,18,17,1,1,0.418,0.5,0.5,35
embroidery,0.43,18,17,1,1,0.781,0.358,0.28,35
presumptuous,0.43,37,35,1,1,0.265,0.596,0.616,72
eeek,0.43,18,17,1,1,0.333,0.49,0.302,35
cocoa,0.43,113,107,1,1,0.776,0.255,0.322,220
leftout,0.43,18,17,1,1,0.229,0.365,0.245,35
observance,0.43,18,17,1,1,0.531,0.315,0.632,35
lightness,0.43,37,35,1,1,0.794,0.36,0.526,72
gamma,0.43,18,17,1,1,0.48,0.429,0.491,35
errant,0.43,18,17,1,1,0.205,0.602,0.375,35
skeet,0.43,18,17,1,1,0.469,0.549,0.413,35
invite,0.43,3379,3202,1,1,0.745,0.655,0.611,6581
junior,0.43,783,742,1,1,0.635,0.343,0.304,1525
incessant,0.43,114,108,1,1,0.438,0.76,0.544,222
disposition,0.43,95,90,1,1,0.663,0.542,0.734,185
vocabulary,0.43,172,163,1,1,0.53,0.247,0.585,335
research,0.43,2659,2521,1,1,0.633,0.663,0.741,5180
earring,0.429,57,54,1,1,0.583,0.52,0.5,111
pen,0.429,874,829,1,1,0.622,0.194,0.25,1703
compelling,0.429,213,202,1,1,0.698,0.57,0.87,415
bear,0.429,4339,4116,1,1,0.448,0.57,0.475,8455
nectar,0.429,38,36,1,1,0.746,0.331,0.398,74
foodie,0.429,38,36,1,1,0.781,0.465,0.484,74
charlatan,0.429,38,36,1,1,0.2,0.64,0.352,74
dignified,0.429,77,73,1,1,0.766,0.481,0.635,150
kingdom,0.429,1171,1111,1,1,0.714,0.547,0.91,2282
recognition,0.429,607,576,1,1,0.833,0.587,0.726,1183
mummy,0.429,411,390,1,1,0.4,0.588,0.415,801
slime,0.429,215,204,1,1,0.3,0.37,0.183,419
pretending,0.428,3034,2880,1,1,0.378,0.42,0.317,5914
boots,0.428,433,411,1,1,0.602,0.255,0.35,844
undesirable,0.428,197,187,1,1,0.177,0.644,0.26,384
activity,0.428,1168,1109,1,1,0.701,0.66,0.807,2277
leadership,0.428,1458,1385,1,1,0.87,0.69,0.983,2843
wrinkle,0.428,39,37,1,1,0.15,0.37,0.274,76
giddy,0.428,159,151,1,1,0.438,0.847,0.611,310
transcendence,0.428,19,18,1,1,0.656,0.608,0.754,37
buzzard,0.428,19,18,1,1,0.35,0.5,0.225,37
streetcar,0.428,19,18,1,1,0.39,0.569,0.566,37
repel,0.428,39,37,1,1,0.224,0.62,0.441,76
excruciating,0.428,259,246,1,1,0.083,0.837,0.345,505
mug,0.428,379,360,1,1,0.542,0.214,0.382,739
cigarette,0.427,602,572,1,1,0.219,0.528,0.304,1174
silk,0.427,160,152,1,1,0.76,0.115,0.3,312
flock,0.427,281,267,1,1,0.5,0.546,0.543,548
adorable,0.427,1281,1218,1,1,0.969,0.519,0.457,2499
lamp,0.427,406,386,1,1,0.51,0.26,0.309,792
static,0.427,223,212,1,1,0.297,0.25,0.366,435
wavelength,0.427,101,96,1,1,0.604,0.442,0.516,197
vague,0.426,347,330,1,1,0.271,0.335,0.083,677
antique,0.426,40,38,1,1,0.634,0.29,0.518,78
grizzly,0.426,40,38,1,1,0.398,0.679,0.657,78
memory,0.426,3284,3124,1,1,0.792,0.378,0.573,6408
surf,0.426,123,117,1,1,0.847,0.65,0.5,240
consist,0.426,206,196,1,1,0.823,0.386,0.58,402
extinction,0.426,144,137,1,1,0.104,0.75,0.611,281
dove,0.426,227,216,1,1,0.729,0.235,0.437,443
trooper,0.426,82,78,1,1,0.458,0.694,0.713,160
shiver,0.425,145,138,1,1,0.26,0.765,0.236,283
parasite,0.425,145,138,1,1,0.092,0.442,0.324,283
visiting,0.425,1403,1336,1,1,0.729,0.44,0.519,2739
congregate,0.425,41,39,1,1,0.653,0.53,0.733,80
interdependence,0.425,20,19,1,1,0.608,0.618,0.639,39
cello,0.425,41,39,1,1,0.635,0.324,0.528,80
pecan,0.425,20,19,1,1,0.552,0.316,0.358,39
assassinate,0.425,20,19,1,1,0.051,0.969,0.722,39
postage,0.425,20,19,1,1,0.56,0.471,0.527,39
prim,0.425,20,19,1,1,0.54,0.37,0.473,39
scale,0.425,782,745,1,1,0.31,0.35,0.577,1527
noble,0.425,402,383,1,1,0.906,0.345,0.61,785
aloof,0.425,190,181,1,1,0.189,0.423,0.302,371
intimate,0.424,936,892,1,1,0.724,0.598,0.393,1828
leave,0.424,64576,61546,1,1,0.375,0.315,0.295,126122
gaining,0.424,513,489,1,1,0.837,0.618,0.883,1002
ladybug,0.424,42,40,1,1,0.602,0.4,0.224,82
tread,0.424,193,184,1,1,0.51,0.52,0.426,377
new,0.424,63576,60632,1,1,0.917,0.49,0.582,124208
soggy,0.424,64,61,1,1,0.312,0.35,0.241,125
pains,0.424,1214,1158,1,1,0.106,0.673,0.362,2372
mad,0.423,13735,13106,1,1,0.219,0.873,0.277,26841
gash,0.423,21,20,1,1,0.429,0.56,0.406,41
quotation,0.423,21,20,1,1,0.796,0.59,0.461,41
villainous,0.423,21,20,1,1,0.122,0.84,0.47,41
reinstall,0.423,43,41,1,1,0.458,0.5,0.745,84
repulsion,0.423,21,20,1,1,0.247,0.673,0.353,41
orient,0.423,21,20,1,1,0.667,0.422,0.667,41
sleek,0.423,21,20,1,1,0.75,0.484,0.643,41
simpleton,0.423,43,41,1,1,0.429,0.144,0.358,84
conduit,0.423,21,20,1,1,0.47,0.302,0.413,41
motorbike,0.423,43,41,1,1,0.552,0.608,0.616,84
melodramatic,0.423,87,83,1,1,0.235,0.692,0.368,170
probing,0.423,21,20,1,1,0.385,0.47,0.463,41
pretext,0.423,21,20,1,1,0.418,0.427,0.365,41
grimy,0.423,43,41,1,1,0.112,0.597,0.283,84
concrete,0.423,462,441,1,1,0.633,0.42,0.547,903
demo,0.423,220,210,1,1,0.51,0.314,0.423,430
provoke,0.422,110,105,1,1,0.3,0.871,0.735,215
rack,0.422,177,169,1,1,0.385,0.373,0.409,346
provision,0.422,88,84,1,1,0.75,0.45,0.692,172
seeds,0.422,311,297,1,1,0.731,0.269,0.418,608
tint,0.422,44,42,1,1,0.582,0.292,0.273,86
unfeeling,0.422,44,42,1,1,0.235,0.377,0.345,86
archer,0.422,89,85,1,1,0.573,0.622,0.661,174
square,0.422,903,863,1,1,0.509,0.34,0.291,1766
hue,0.422,112,107,1,1,0.507,0.416,0.417,219
cashier,0.421,271,259,1,1,0.615,0.413,0.484,530
creep,0.421,1386,1325,1,1,0.354,0.647,0.361,2711
feed,0.421,3829,3661,1,1,0.812,0.429,0.739,7490
philosopher,0.421,137,131,1,1,0.684,0.316,0.72,268
optic,0.421,22,21,1,1,0.663,0.384,0.594,43
grouch,0.421,22,21,1,1,0.342,0.593,0.411,43
manure,0.421,22,21,1,1,0.25,0.471,0.241,43
teensy,0.421,22,21,1,1,0.52,0.427,0.347,43
condescension,0.421,22,21,1,1,0.521,0.377,0.565,43
molten,0.421,22,21,1,1,0.417,0.49,0.339,43
strobe,0.421,22,21,1,1,0.49,0.633,0.537,43
hidden,0.42,1812,1734,1,1,0.208,0.43,0.327,3546
bandit,0.42,92,88,1,1,0.094,0.796,0.567,180
deed,0.42,162,155,1,1,0.52,0.32,0.592,317
rowdy,0.42,69,66,1,1,0.255,0.9,0.518,135
beach,0.42,3035,2905,1,1,0.885,0.529,0.455,5940
discarded,0.42,163,156,1,1,0.229,0.46,0.308,319
fantastic,0.42,2394,2292,1,1,0.969,0.696,0.831,4686
trout,0.42,46,44,1,1,0.516,0.387,0.298,90
null,0.42,46,44,1,1,0.253,0.147,0.152,90
revel,0.42,117,112,1,1,0.74,0.705,0.684,229
lemon,0.419,356,341,1,1,0.596,0.317,0.316,697
skating,0.419,237,227,1,1,0.745,0.673,0.435,464
college,0.419,10246,9816,1,1,0.7,0.467,0.746,20062
titan,0.419,142,136,1,1,0.598,0.653,0.811,278
emergence,0.419,23,22,1,1,0.276,0.857,0.676,45
hitter,0.419,23,22,1,1,0.418,0.683,0.713,45
transaction,0.419,71,68,1,1,0.65,0.577,0.579,139
steward,0.419,23,22,1,1,0.633,0.238,0.55,45
dilute,0.419,23,22,1,1,0.275,0.192,0.349,45
freshman,0.419,552,529,1,1,0.677,0.57,0.441,1081
plot,0.419,1253,1201,1,1,0.469,0.567,0.51,2454
deception,0.419,241,231,1,1,0.09,0.745,0.37,472
crossing,0.418,681,653,1,1,0.549,0.349,0.451,1334
await,0.418,194,186,1,1,0.448,0.264,0.276,380
wicked,0.418,952,913,1,1,0.138,0.8,0.627,1865
douche,0.418,293,281,1,1,0.49,0.413,0.397,574
godforsaken,0.418,48,46,1,1,0.439,0.52,0.422,94
forming,0.418,391,375,1,1,0.729,0.343,0.8,766
transform,0.418,294,282,1,1,0.735,0.667,0.696,576
latte,0.418,122,117,1,1,0.615,0.32,0.311,239
bustle,0.418,73,70,1,1,0.347,0.814,0.445,143
sassy,0.418,197,189,1,1,0.271,0.704,0.32,386
scrub,0.417,123,118,1,1,0.417,0.42,0.5,241
indistinguishable,0.417,24,23,1,1,0.346,0.458,0.548,47
exec,0.417,49,47,1,1,0.64,0.352,0.769,96
ski,0.417,124,119,1,1,0.684,0.67,0.471,243
photogenic,0.417,24,23,1,1,0.78,0.5,0.495,47
ape,0.417,150,144,1,1,0.548,0.389,0.336,294
copyright,0.417,75,72,1,1,0.458,0.402,0.663,147
sunlight,0.416,406,390,1,1,0.906,0.407,0.639,796
driver,0.416,1810,1739,1,1,0.553,0.538,0.637,3549
wink,0.416,357,343,1,1,0.688,0.557,0.304,700
scented,0.416,76,73,1,1,0.865,0.509,0.431,149
crack,0.416,1260,1211,1,1,0.302,0.625,0.4,2471
craft,0.416,488,469,1,1,0.76,0.321,0.539,957
workshop,0.416,334,321,1,1,0.531,0.426,0.51,655
sabbatical,0.416,25,24,1,1,0.771,0.24,0.427,49
inexperience,0.416,25,24,1,1,0.208,0.614,0.151,49
pusher,0.416,25,24,1,1,0.323,0.828,0.585,49
sneaker,0.416,25,24,1,1,0.794,0.479,0.389,49
ruckus,0.416,25,24,1,1,0.271,0.706,0.411,49
scrappy,0.416,25,24,1,1,0.301,0.375,0.406,49
fancy,0.415,1305,1255,1,1,0.854,0.673,0.534,2560
shark,0.415,365,351,1,1,0.26,0.845,0.596,716
trader,0.415,156,150,1,1,0.562,0.632,0.854,306
supply,0.415,575,553,1,1,0.708,0.519,0.603,1128
aura,0.415,314,302,1,1,0.76,0.333,0.5,616
breathtaking,0.415,157,151,1,1,0.936,0.792,0.921,308
ragged,0.415,78,75,1,1,0.198,0.519,0.226,153
manifested,0.415,105,101,1,1,0.58,0.618,0.667,206
bore,0.415,344,331,1,1,0.417,0.44,0.455,675
irreplaceable,0.415,185,178,1,1,0.479,0.58,0.833,363
withdrawn,0.414,160,154,1,1,0.182,0.368,0.221,314
sounding,0.414,672,647,1,1,0.69,0.5,0.558,1319
flagstaff,0.414,26,25,1,1,0.52,0.517,0.5,51
retention,0.414,26,25,1,1,0.344,0.49,0.558,51
sultan,0.414,26,25,1,1,0.529,0.423,0.821,51
olden,0.414,26,25,1,1,0.284,0.213,0.425,51
wedge,0.414,53,51,1,1,0.49,0.29,0.278,104
bully,0.414,1302,1254,1,1,0.257,0.755,0.564,2556
session,0.414,1358,1308,1,1,0.51,0.481,0.491,2666
habitat,0.414,108,104,1,1,0.633,0.343,0.553,212
hanging,0.414,5249,5057,1,1,0.378,0.471,0.389,10306
unimportant,0.413,493,475,1,1,0.281,0.24,0.175,968
dormant,0.413,54,52,1,1,0.385,0.245,0.245,106
circuit,0.413,82,79,1,1,0.586,0.461,0.707,161
surface,0.413,858,827,1,1,0.448,0.375,0.604,1685
revival,0.413,110,106,1,1,0.823,0.664,0.597,216
hole,0.413,4190,4039,1,1,0.531,0.31,0.33,8229
quantify,0.413,27,26,1,1,0.719,0.459,0.721,53
biceps,0.413,27,26,1,1,0.592,0.588,0.602,53
skunk,0.413,55,53,1,1,0.284,0.491,0.38,108
hiker,0.413,27,26,1,1,0.694,0.802,0.644,53
boardwalk,0.413,27,26,1,1,0.643,0.481,0.549,53
den,0.413,587,566,1,1,0.51,0.347,0.398,1153
heartland,0.413,27,26,1,1,0.812,0.51,0.675,53
coal,0.413,195,188,1,1,0.36,0.241,0.34,383
fruitful,0.412,112,108,1,1,0.73,0.618,0.637,220
ambiguous,0.412,84,81,1,1,0.265,0.462,0.358,165
reflection,0.412,1676,1617,1,1,0.71,0.5,0.528,3293
squad,0.412,1677,1618,1,1,0.552,0.711,0.806,3295
origin,0.412,255,246,1,1,0.729,0.435,0.591,501
describe,0.412,2474,2387,1,1,0.542,0.472,0.555,4861
deficiency,0.412,56,54,1,1,0.073,0.373,0.179,110
respite,0.412,142,137,1,1,0.6,0.373,0.42,279
linger,0.412,257,248,1,1,0.48,0.311,0.412,505
solve,0.412,1818,1755,1,1,0.656,0.53,0.688,3573
buildup,0.411,28,27,1,1,0.49,0.509,0.623,55
recesses,0.411,28,27,1,1,0.367,0.47,0.379,55
unfettered,0.411,28,27,1,1,0.569,0.65,0.586,55
infer,0.411,28,27,1,1,0.449,0.49,0.453,55
ley,0.411,28,27,1,1,0.604,0.389,0.764,55
randy,0.411,173,167,1,1,0.49,0.394,0.481,340
igloo,0.411,28,27,1,1,0.569,0.302,0.345,55
vane,0.411,28,27,1,1,0.561,0.28,0.231,55
description,0.411,551,532,1,1,0.582,0.425,0.596,1083
man,0.411,82591,79758,1,1,0.688,0.427,0.767,162349
gorgeous,0.411,1842,1779,1,1,0.92,0.56,0.741,3621
hero,0.411,2810,2715,1,1,0.94,0.806,0.881,5525
humankind,0.411,88,85,1,1,0.885,0.394,0.714,173
animal,0.411,2915,2817,1,1,0.521,0.51,0.513,5732
lint,0.41,29,28,1,1,0.388,0.173,0.214,57
subdue,0.41,29,28,1,1,0.275,0.64,0.784,57
miserably,0.41,331,320,1,1,0.28,0.545,0.15,651
tango,0.41,90,87,1,1,0.622,0.56,0.43,177
integration,0.41,90,87,1,1,0.771,0.48,0.737,177
shameless,0.41,243,235,1,1,0.274,0.713,0.407,478
defiant,0.41,60,58,1,1,0.25,0.792,0.769,118
enjoyment,0.41,457,442,1,1,0.93,0.612,0.716,899
brand,0.41,1713,1657,1,1,0.562,0.284,0.547,3370
eradicate,0.409,91,88,1,1,0.26,0.69,0.686,179
blinding,0.409,122,118,1,1,0.304,0.596,0.406,240
borrow,0.409,399,386,1,1,0.398,0.573,0.282,785
north,0.409,1816,1757,1,1,0.531,0.255,0.45,3573
jimmy,0.409,615,595,1,1,0.579,0.321,0.311,1210
inconsequential,0.409,61,59,1,1,0.25,0.48,0.345,120
gazillion,0.409,30,29,1,1,0.531,0.534,0.538,59
academy,0.409,340,329,1,1,0.704,0.473,0.792,669
smiley,0.409,154,149,1,1,0.865,0.47,0.571,303
unneeded,0.409,92,89,1,1,0.177,0.375,0.245,181
sixth,0.409,216,209,1,1,0.521,0.275,0.366,425
inverse,0.409,30,29,1,1,0.459,0.337,0.319,59
purring,0.409,123,119,1,1,0.748,0.33,0.271,242
root,0.409,783,758,1,1,0.602,0.279,0.508,1541
route,0.408,862,835,1,1,0.583,0.353,0.518,1697
symmetry,0.408,31,30,1,1,0.604,0.274,0.5,61
undertake,0.408,31,30,1,1,0.796,0.702,0.754,61
meatloaf,0.408,31,30,1,1,0.625,0.389,0.375,61
golfer,0.408,31,30,1,1,0.602,0.402,0.578,61
avert,0.408,31,30,1,1,0.51,0.388,0.465,61
circus,0.408,386,374,1,1,0.724,0.637,0.432,760
tragic,0.408,1709,1656,1,1,0.048,0.904,0.396,3365
rejected,0.408,2097,2032,1,1,0.102,0.48,0.25,4129
burger,0.408,484,469,1,1,0.688,0.568,0.398,953
distract,0.407,2025,1963,1,1,0.241,0.609,0.336,3988
detrimental,0.407,228,221,1,1,0.203,0.679,0.387,449
moronic,0.407,130,126,1,1,0.122,0.5,0.224,256
hypothesis,0.407,65,63,1,1,0.552,0.37,0.509,128
comic,0.407,992,962,1,1,0.917,0.459,0.387,1954
boost,0.407,664,644,1,1,0.865,0.73,0.75,1308
society,0.407,7022,6811,1,1,0.674,0.464,0.782,13833
pied,0.407,66,64,1,1,0.594,0.433,0.35,130
verse,0.407,1008,978,1,1,0.667,0.269,0.336,1986
alter,0.406,370,359,1,1,0.333,0.694,0.654,729
park,0.406,4145,4023,1,1,0.816,0.343,0.414,8168
outrun,0.406,33,32,1,1,0.531,0.833,0.573,65
illiterate,0.406,135,131,1,1,0.12,0.41,0.151,266
tonic,0.406,67,65,1,1,0.541,0.36,0.5,132
spark,0.406,786,763,1,1,0.688,0.745,0.529,1549
groom,0.406,102,99,1,1,0.698,0.5,0.605,201
sparkly,0.406,68,66,1,1,0.885,0.59,0.726,134
disjointed,0.405,34,33,1,1,0.323,0.518,0.365,67
pleasures,0.405,209,203,1,1,0.896,0.654,0.705,412
feverish,0.405,34,33,1,1,0.385,0.696,0.436,67
mismatched,0.405,34,33,1,1,0.25,0.557,0.302,67
ninety,0.405,34,33,1,1,0.479,0.349,0.436,67
repress,0.405,70,68,1,1,0.208,0.612,0.536,138
unpaid,0.405,142,138,1,1,0.3,0.413,0.365,280
raggedy,0.405,71,69,1,1,0.198,0.531,0.314,140
factor,0.404,864,840,1,1,0.635,0.365,0.678,1704
nap,0.404,2020,1964,1,1,0.66,0.098,0.342,3984
confidant,0.404,72,70,1,1,0.837,0.633,0.631,142
leech,0.404,109,106,1,1,0.25,0.623,0.268,215
detached,0.404,514,500,1,1,0.28,0.396,0.216,1014
banjo,0.404,73,71,1,1,0.469,0.4,0.37,144
cent,0.404,184,179,1,1,0.439,0.367,0.402,363
livestock,0.404,36,35,1,1,0.729,0.42,0.519,71
impress,0.404,480,467,1,1,0.816,0.744,0.895,947
animation,0.403,298,290,1,1,0.888,0.75,0.549,588
box,0.403,3706,3607,1,1,0.5,0.179,0.312,7313
artistic,0.403,300,292,1,1,0.802,0.646,0.632,592
calling,0.403,7422,7226,1,1,0.646,0.59,0.483,14648
sinking,0.403,834,812,1,1,0.135,0.439,0.342,1646
simultaneous,0.403,37,36,1,1,0.691,0.577,0.554,73
possum,0.403,37,36,1,1,0.408,0.471,0.306,73
sulk,0.403,190,185,1,1,0.25,0.58,0.406,375
depart,0.403,115,112,1,1,0.398,0.48,0.444,227
unwittingly,0.402,38,37,1,1,0.312,0.51,0.264,75
liner,0.402,155,151,1,1,0.469,0.396,0.4,306
rouge,0.402,77,75,1,1,0.562,0.4,0.382,152
lava,0.402,116,113,1,1,0.28,0.539,0.615,229
bed,0.402,29765,29006,1,1,0.604,0.173,0.327,58771
outgrow,0.402,78,76,1,1,0.51,0.529,0.722,154
gambling,0.402,238,232,1,1,0.365,0.806,0.347,470
unconnected,0.402,39,38,1,1,0.188,0.265,0.213,77
drive,0.402,8378,8169,1,1,0.625,0.689,0.713,16547
claws,0.401,160,156,1,1,0.281,0.698,0.562,316
musk,0.401,120,117,1,1,0.469,0.454,0.453,237
quest,0.401,810,790,1,1,0.643,0.716,0.545,1600
older,0.401,9422,9190,1,1,0.385,0.255,0.317,18612
friendship,0.401,7001,6831,1,1,0.958,0.343,0.694,13832
involuntary,0.401,82,80,1,1,0.354,0.49,0.231,162
mermaid,0.401,248,242,1,1,0.765,0.623,0.452,490
weekend,0.4,13238,12922,1,1,0.844,0.625,0.519,26160
vegan,0.4,754,736,1,1,0.49,0.226,0.357,1490
brute,0.4,41,40,1,1,0.115,0.547,0.379,81
confusion,0.4,1401,1368,1,1,0.255,0.667,0.277,2769
viral,0.4,342,334,1,1,0.24,0.612,0.518,676
crossed,0.4,1116,1090,1,1,0.431,0.49,0.508,2206
perished,0.4,42,41,1,1,0.135,0.596,0.225,83
abundance,0.4,301,294,1,1,0.812,0.69,0.852,595
window,0.4,3470,3390,1,1,0.542,0.276,0.385,6860
spoils,0.4,86,84,1,1,0.388,0.76,0.481,170
odor,0.399,43,42,1,1,0.337,0.363,0.404,85
pedal,0.399,43,42,1,1,0.5,0.32,0.342,85
noose,0.399,87,85,1,1,0.356,0.3,0.33,172
uncaring,0.399,132,129,1,1,0.177,0.245,0.321,261
schmuck,0.399,44,43,1,1,0.363,0.412,0.375,87
faker,0.399,44,43,1,1,0.245,0.63,0.48,87
tease,0.399,406,397,1,1,0.317,0.79,0.432,803
become,0.399,19250,18826,1,1,0.641,0.583,0.643,38076
tee,0.399,227,222,1,1,0.459,0.373,0.377,449
peep,0.398,684,669,1,1,0.573,0.317,0.269,1353
contemplation,0.398,91,89,1,1,0.552,0.324,0.627,180
cola,0.398,92,90,1,1,0.469,0.325,0.24,182
rib,0.398,233,228,1,1,0.49,0.349,0.351,461
hardened,0.398,93,91,1,1,0.406,0.618,0.764,184
alley,0.398,376,368,1,1,0.347,0.5,0.355,744
arrival,0.398,235,230,1,1,0.678,0.51,0.474,465
trapped,0.398,3228,3160,1,1,0.135,0.615,0.38,6388
numb,0.398,2801,2742,1,1,0.108,0.42,0.352,5543
shot,0.398,4423,4330,1,1,0.144,0.75,0.569,8753
john,0.398,4616,4519,1,1,0.562,0.382,0.327,9135
roc,0.397,47,46,1,1,0.427,0.51,0.415,93
giggles,0.397,287,281,1,1,0.865,0.684,0.346,568
creativity,0.397,673,659,1,1,0.938,0.684,0.815,1332
hold,0.397,26609,26059,1,1,0.448,0.29,0.364,52668
noob,0.397,96,94,1,1,0.417,0.43,0.267,190
alcohol,0.397,2473,2422,1,1,0.323,0.667,0.377,4895
unravel,0.397,97,95,1,1,0.378,0.598,0.455,192
recreational,0.397,48,47,1,1,0.896,0.686,0.479,95
condemnation,0.397,98,96,1,1,0.133,0.725,0.449,194
trainer,0.396,251,246,1,1,0.698,0.719,0.824,497
stinking,0.396,100,98,1,1,0.041,0.657,0.264,198
acres,0.396,101,99,1,1,0.51,0.363,0.5,200
boom,0.396,1082,1061,1,1,0.604,0.655,0.731,2143
solitary,0.396,1705,1672,1,1,0.224,0.202,0.268,3377
flutter,0.396,103,101,1,1,0.479,0.548,0.33,204
sleeve,0.396,313,307,1,1,0.531,0.27,0.273,620
flaming,0.396,104,102,1,1,0.406,0.645,0.558,206
infused,0.395,52,51,1,1,0.385,0.473,0.546,103
sustained,0.395,105,103,1,1,0.649,0.34,0.58,208
carter,0.395,265,260,1,1,0.312,0.48,0.431,525
remembrance,0.395,159,156,1,1,0.812,0.25,0.519,315
pave,0.395,53,52,1,1,0.594,0.49,0.509,105
shelters,0.395,215,211,1,1,0.582,0.333,0.482,426
stagnant,0.395,162,159,1,1,0.3,0.5,0.208,321
handmade,0.395,54,53,1,1,0.776,0.383,0.475,107
swift,0.395,937,920,1,1,0.76,0.776,0.698,1857
infamous,0.395,110,108,1,1,0.146,0.58,0.472,218
underdog,0.394,55,54,1,1,0.25,0.41,0.226,109
wealth,0.394,787,773,1,1,0.857,0.637,0.858,1560
bar,0.394,4617,4535,1,1,0.5,0.531,0.481,9152
spooky,0.394,904,888,1,1,0.104,0.858,0.38,1792
withstand,0.394,169,166,1,1,0.37,0.548,0.571,335
sic,0.394,56,55,1,1,0.37,0.459,0.38,111
dehydration,0.394,56,55,1,1,0.188,0.472,0.259,111
penetrate,0.394,56,55,1,1,0.287,0.877,0.732,111
brown,0.394,1797,1766,1,1,0.396,0.202,0.293,3563
crown,0.394,927,911,1,1,0.708,0.572,0.737,1838
manly,0.394,174,171,1,1,0.698,0.633,0.846,345
combined,0.394,524,515,1,1,0.622,0.37,0.5,1039
subconscious,0.394,291,286,1,1,0.531,0.375,0.415,577
soulmate,0.393,2237,2199,1,1,0.89,0.5,0.628,4436
blink,0.393,589,579,1,1,0.552,0.316,0.324,1168
royalty,0.393,117,115,1,1,0.832,0.571,0.833,232
brick,0.393,419,412,1,1,0.217,0.418,0.368,831
crass,0.393,59,58,1,1,0.223,0.49,0.466,117
weirdo,0.393,1261,1240,1,1,0.173,0.539,0.328,2501
bag,0.393,3151,3099,1,1,0.5,0.25,0.314,6250
introduction,0.393,183,180,1,1,0.612,0.413,0.64,363
sessions,0.392,751,739,1,1,0.646,0.578,0.65,1490
committed,0.392,1884,1854,1,1,0.71,0.542,0.712,3738
clutches,0.392,62,61,1,1,0.542,0.373,0.528,123
shanghai,0.392,62,61,1,1,0.551,0.45,0.509,123
versatile,0.392,63,62,1,1,0.906,0.625,0.714,125
bite,0.392,1234,1215,1,1,0.219,0.796,0.51,2449
predictable,0.392,194,191,1,1,0.312,0.296,0.42,385
wondrous,0.391,66,65,1,1,0.854,0.679,0.818,131
sporting,0.391,134,132,1,1,0.917,0.656,0.675,266
lone,0.391,2228,2195,1,1,0.198,0.204,0.367,4423
season,0.391,9685,9542,1,1,0.792,0.41,0.519,19227
lawn,0.391,271,267,1,1,0.686,0.153,0.192,538
tribe,0.391,1097,1081,1,1,0.664,0.486,0.516,2178
crusade,0.391,138,136,1,1,0.592,0.72,0.709,274
forthcoming,0.391,69,68,1,1,0.66,0.509,0.6,137
hall,0.391,1263,1245,1,1,0.51,0.34,0.424,2508
video,0.39,13759,13567,1,1,0.646,0.577,0.427,27326
adventurous,0.39,143,141,1,1,0.969,0.898,0.722,284
stressed,0.39,5544,5468,1,1,0.167,0.74,0.502,11012
ciao,0.39,74,73,1,1,0.542,0.426,0.409,147
burdensome,0.39,74,73,1,1,0.229,0.696,0.419,147
asleep,0.389,7408,7314,1,1,0.604,0.1,0.27,14722
drop,0.389,6085,6008,1,1,0.479,0.321,0.291,12093
black,0.389,11696,11549,1,1,0.326,0.339,0.39,23245
hell,0.389,22159,21882,1,1,0.02,0.918,0.565,44041
crave,0.389,2411,2381,1,1,0.625,0.51,0.731,4792
remarkably,0.389,80,79,1,1,0.688,0.618,0.868,159
imprisonment,0.389,80,79,1,1,0.133,0.63,0.471,159
calls,0.389,5304,5239,1,1,0.608,0.431,0.551,10543
narcissistic,0.388,580,573,1,1,0.323,0.708,0.655,1153
south,0.388,2413,2384,1,1,0.562,0.265,0.429,4797
ice,0.388,3759,3715,1,1,0.44,0.265,0.219,7474
puffy,0.388,85,84,1,1,0.333,0.54,0.387,169
tick,0.388,345,341,1,1,0.521,0.386,0.412,686
drawing,0.388,1748,1728,1,1,0.698,0.216,0.333,3476
buster,0.388,89,88,1,1,0.469,0.491,0.483,177
embrace,0.387,3962,3918,1,1,0.949,0.49,0.452,7880
goodies,0.387,95,94,1,1,0.95,0.622,0.424,189
radius,0.387,95,94,1,1,0.521,0.324,0.5,189
ay,0.386,691,684,1,1,0.5,0.557,0.255,1375
mutually,0.386,202,200,1,1,0.844,0.49,0.582,402
sharp,0.386,616,610,1,1,0.459,0.585,0.585,1226
brilliant,0.386,2093,2073,1,1,0.939,0.575,0.923,4166
destructive,0.386,742,735,1,1,0.177,0.87,0.713,1477
role,0.385,2758,2734,1,1,0.552,0.26,0.464,5492
performer,0.385,114,113,1,1,0.541,0.53,0.708,227
stool,0.385,115,114,1,1,0.448,0.269,0.302,229
gem,0.385,468,464,1,1,0.917,0.48,0.582,932
snowing,0.385,118,117,1,1,0.586,0.49,0.387,235
track,0.385,3217,3190,1,1,0.448,0.433,0.526,6407
harassing,0.385,358,355,1,1,0.12,0.873,0.446,713
agh,0.385,119,118,1,1,0.26,0.5,0.4,237
cosy,0.384,122,121,1,1,0.847,0.255,0.518,243
saga,0.384,251,249,1,1,0.635,0.44,0.6,500
distorted,0.384,126,125,1,1,0.25,0.521,0.28,251
reckless,0.384,384,381,1,1,0.262,0.788,0.279,765
wine,0.384,4021,3990,1,1,0.792,0.417,0.457,8011
bonds,0.384,539,535,1,1,0.74,0.472,0.583,1074
soaking,0.383,144,143,1,1,0.438,0.324,0.375,287
inevitable,0.383,1032,1025,1,1,0.316,0.419,0.623,2057
carve,0.383,151,150,1,1,0.469,0.443,0.598,301
kicking,0.383,1378,1369,1,1,0.327,0.802,0.51,2747
shun,0.383,153,152,1,1,0.418,0.604,0.389,305
quiz,0.383,307,305,1,1,0.462,0.61,0.527,612
penny,0.383,472,469,1,1,0.615,0.302,0.324,941
intriguing,0.383,160,159,1,1,0.422,0.713,0.462,319
grasping,0.382,163,162,1,1,0.327,0.561,0.561,325
hilarious,0.382,1501,1492,1,1,0.75,0.64,0.537,2993
gradually,0.382,342,340,1,1,0.583,0.385,0.464,682
flick,0.382,173,172,1,1,0.688,0.541,0.515,345
dangerous,0.382,6659,6621,1,1,0.02,0.941,0.658,13280
culture,0.382,3373,3354,1,1,0.753,0.304,0.675,6727
dollar,0.382,714,710,1,1,0.755,0.632,0.694,1424
character,0.382,6083,6049,1,1,0.667,0.373,0.686,12132
mocking,0.382,378,376,1,1,0.082,0.755,0.394,754
drip,0.382,193,192,1,1,0.392,0.193,0.175,385
sport,0.381,993,988,1,1,0.865,0.7,0.657,1981
humility,0.381,207,206,1,1,0.74,0.118,0.444,413
myth,0.381,420,418,1,1,0.458,0.432,0.338,838
lowering,0.381,210,209,1,1,0.286,0.363,0.236,419
convert,0.381,218,217,1,1,0.551,0.538,0.704,435
capital,0.381,447,445,1,1,0.52,0.5,0.798,892
cult,0.381,915,911,1,1,0.448,0.535,0.648,1826
clay,0.381,231,230,1,1,0.542,0.25,0.267,461
remains,0.381,1173,1168,1,1,0.61,0.24,0.565,2341
sailing,0.381,236,235,1,1,0.667,0.52,0.5,471
passage,0.381,238,237,1,1,0.429,0.314,0.37,475
happiness,0.381,17741,17667,1,1,0.96,0.732,0.85,35408
loner,0.38,3534,3520,1,1,0.347,0.152,0.221,7054
cream,0.38,2281,2273,1,1,0.688,0.259,0.22,4554
shine,0.38,3720,3707,1,1,0.844,0.539,0.741,7427
trace,0.379,326,325,1,1,0.573,0.346,0.483,651
phoenix,0.379,397,396,1,1,0.653,0.481,0.594,793
mock,0.379,447,446,1,1,0.36,0.606,0.618,893
legend,0.378,1023,1021,1,1,0.837,0.519,0.75,2044
clingy,0.378,1620,1617,1,1,0.224,0.46,0.37,3237
include,0.378,1663,1660,1,1,0.729,0.449,0.702,3323
kid,0.378,11993,11974,1,1,0.76,0.453,0.298,23967
lifetime,0.378,2116,2113,1,1,0.816,0.559,0.736,4229
tag,0.378,2191,2188,1,1,0.612,0.353,0.375,4379
bury,0.378,780,779,1,1,0.077,0.571,0.346,1559
meaningless,0.377,1073,1072,1,1,0.156,0.314,0.143,2145
scrapbook,0.376,17,17,1,1,0.562,0.274,0.432,34
outlines,0.376,28,28,1,1,0.656,0.402,0.651,56
seashore,0.376,23,23,1,1,0.796,0.31,0.375,46
initiation,0.376,28,28,1,1,0.698,0.529,0.527,56
parentage,0.376,13,13,1,1,0.903,0.382,0.595,26
ineffable,0.376,21,21,1,1,0.551,0.577,0.585,42
raucous,0.376,20,20,1,1,0.316,0.74,0.538,40
nutcracker,0.376,14,14,1,1,0.635,0.378,0.522,28
chauvinist,0.376,16,16,1,1,0.31,0.539,0.527,32
pharaoh,0.376,30,30,1,1,0.656,0.491,0.798,60
imitation,0.376,39,39,1,1,0.406,0.592,0.343,78
primordial,0.376,34,34,1,1,0.625,0.569,0.771,68
propagate,0.376,28,28,1,1,0.561,0.609,0.63,56
oscillate,0.376,13,13,1,1,0.449,0.58,0.397,26
seer,0.376,20,20,1,1,0.604,0.481,0.74,40
bedtime,0.376,334,334,1,1,0.673,0.314,0.373,668
garb,0.376,19,19,1,1,0.562,0.37,0.508,38
crotch,0.376,81,81,1,1,0.521,0.637,0.447,162
winged,0.376,45,45,1,1,0.646,0.469,0.519,90
verb,0.376,62,62,1,1,0.582,0.312,0.414,124
lopsided,0.376,25,25,1,1,0.125,0.5,0.272,50
eleventh,0.376,19,19,1,1,0.594,0.329,0.357,38
onboard,0.376,48,48,1,1,0.612,0.451,0.491,96
plodding,0.376,20,20,1,1,0.449,0.481,0.439,40
brash,0.376,29,29,1,1,0.36,0.814,0.552,58
pottery,0.376,26,26,1,1,0.594,0.286,0.422,52
drier,0.376,26,26,1,1,0.306,0.347,0.392,52
relativity,0.376,14,14,1,1,0.594,0.393,0.615,28
dojo,0.376,21,21,1,1,0.5,0.435,0.455,42
punctuality,0.376,16,16,1,1,0.81,0.406,0.758,32
kamikaze,0.376,21,21,1,1,0.204,0.81,0.645,42
indoor,0.376,134,134,1,1,0.615,0.245,0.347,268
moustache,0.376,36,36,1,1,0.47,0.236,0.409,72
offspring,0.376,156,156,1,1,0.656,0.435,0.6,312
chump,0.376,75,75,1,1,0.375,0.451,0.304,150
allusion,0.376,16,16,1,1,0.44,0.308,0.462,32
wring,0.376,28,28,1,1,0.36,0.656,0.348,56
hygienic,0.376,13,13,1,1,0.719,0.245,0.702,26
neighboring,0.376,32,32,1,1,0.656,0.306,0.481,64
booming,0.376,73,73,1,1,0.688,0.554,0.661,146
serendipity,0.376,143,143,1,1,0.677,0.413,0.5,286
salient,0.376,18,18,1,1,0.6,0.573,0.702,36
pinching,0.376,37,37,1,1,0.25,0.788,0.345,74
feudal,0.376,15,15,1,1,0.367,0.37,0.61,30
farther,0.376,294,294,1,1,0.418,0.5,0.43,588
spotless,0.376,68,68,1,1,0.792,0.327,0.726,136
panties,0.376,295,295,1,1,0.594,0.529,0.312,590
weakened,0.376,74,74,1,1,0.373,0.304,0.092,148
whirlpool,0.376,26,26,1,1,0.71,0.415,0.442,52
fireplace,0.376,127,127,1,1,0.667,0.38,0.417,254
finality,0.376,24,24,1,1,0.615,0.368,0.627,48
ballsy,0.376,18,18,1,1,0.531,0.491,0.414,36
encompass,0.376,27,27,1,1,0.52,0.298,0.661,54
addresses,0.376,128,128,1,1,0.51,0.354,0.45,256
huckleberry,0.376,15,15,1,1,0.6,0.279,0.296,30
swirl,0.376,48,48,1,1,0.49,0.726,0.639,96
pedantic,0.376,28,28,1,1,0.229,0.608,0.253,56
stomachache,0.376,18,18,1,1,0.03,0.745,0.316,36
reap,0.376,238,238,1,1,0.677,0.422,0.623,476
bleep,0.376,20,20,1,1,0.479,0.667,0.345,40
conceivable,0.376,15,15,1,1,0.73,0.35,0.613,30
blazer,0.376,30,30,1,1,0.635,0.385,0.417,60
conductor,0.376,35,35,1,1,0.677,0.663,0.621,70
deficient,0.376,45,45,1,1,0.24,0.464,0.132,90
impetus,0.376,20,20,1,1,0.521,0.74,0.635,40
catchphrase,0.376,24,24,1,1,0.698,0.423,0.433,48
bathing,0.376,146,146,1,1,0.74,0.276,0.361,292
satire,0.376,89,89,1,1,0.458,0.655,0.472,178
marketable,0.376,16,16,1,1,0.746,0.545,0.664,32
jubilant,0.376,13,13,1,1,0.844,0.673,0.664,26
gumbo,0.376,16,16,1,1,0.5,0.422,0.361,32
burly,0.376,21,21,1,1,0.562,0.65,0.75,42
adobe,0.376,26,26,1,1,0.5,0.319,0.328,52
lair,0.376,63,63,1,1,0.469,0.438,0.392,126
shabby,0.376,49,49,1,1,0.235,0.519,0.259,98
chimera,0.376,19,19,1,1,0.292,0.582,0.372,38
mince,0.376,84,84,1,1,0.417,0.529,0.378,168
dexterity,0.376,14,14,1,1,0.771,0.673,0.864,28
shittest,0.376,76,76,1,1,0.076,0.673,0.232,152
freeman,0.376,45,45,1,1,0.823,0.454,0.618,90
shaman,0.376,33,33,1,1,0.49,0.531,0.604,66
vivid,0.376,275,275,1,1,0.698,0.627,0.667,550
plucky,0.376,15,15,1,1,0.816,0.817,0.88,30
decoy,0.376,17,17,1,1,0.149,0.46,0.33,34
peekaboo,0.376,19,19,1,1,0.592,0.607,0.412,38
antagonistic,0.376,22,22,1,1,0.296,0.604,0.565,44
checker,0.376,19,19,1,1,0.33,0.417,0.553,38
lackey,0.376,16,16,1,1,0.26,0.51,0.166,32
porter,0.376,108,108,1,1,0.571,0.375,0.654,216
informant,0.376,13,13,1,1,0.604,0.612,0.719,26
decadence,0.376,32,32,1,1,0.237,0.455,0.291,64
quince,0.376,19,19,1,1,0.557,0.368,0.474,38
rue,0.376,63,63,1,1,0.323,0.394,0.246,126
shawl,0.376,19,19,1,1,0.72,0.365,0.23,38
baritone,0.376,16,16,1,1,0.592,0.529,0.5,32
microcosm,0.376,21,21,1,1,0.5,0.5,0.52,42
pithy,0.376,21,21,1,1,0.48,0.36,0.635,42
bombardment,0.376,13,13,1,1,0.146,0.959,0.742,26
splatter,0.376,15,15,1,1,0.312,0.596,0.352,30
accurate,0.376,1143,1143,1,1,0.743,0.36,0.737,2286
cheetah,0.376,56,56,1,1,0.469,0.77,0.667,112
forty,0.376,156,156,1,1,0.458,0.367,0.482,312
garnet,0.376,25,25,1,1,0.643,0.418,0.368,50
damper,0.376,33,33,1,1,0.459,0.378,0.473,66
profane,0.376,16,16,1,1,0.167,0.701,0.436,32
pound,0.376,332,332,1,1,0.57,0.337,0.443,664
mandarin,0.376,52,52,1,1,0.625,0.398,0.491,104
mingled,0.376,14,14,1,1,0.521,0.392,0.357,28
ogre,0.376,63,63,1,1,0.135,0.698,0.51,126
influx,0.376,42,42,1,1,0.622,0.635,0.575,84
magnify,0.376,40,40,1,1,0.729,0.561,0.839,80
solidify,0.376,37,37,1,1,0.583,0.318,0.754,74
malt,0.376,26,26,1,1,0.75,0.373,0.324,52
dabble,0.376,20,20,1,1,0.55,0.53,0.491,40
murky,0.376,40,40,1,1,0.143,0.618,0.37,80
apache,0.376,18,18,1,1,0.687,0.469,0.5,36
peppy,0.376,17,17,1,1,0.677,0.529,0.438,34
cog,0.376,40,40,1,1,0.427,0.343,0.363,80
cellophane,0.376,14,14,1,1,0.648,0.282,0.289,28
scanner,0.376,27,27,1,1,0.531,0.356,0.567,54
airborne,0.376,18,18,1,1,0.542,0.519,0.385,36
rock,0.376,4797,4797,1,1,0.623,0.236,0.557,9594
blather,0.376,16,16,1,1,0.344,0.481,0.382,32
seminar,0.376,130,130,1,1,0.583,0.36,0.623,260
fabrication,0.376,19,19,1,1,0.573,0.587,0.705,38
tracing,0.376,52,52,1,1,0.418,0.591,0.565,104
incendiary,0.376,13,13,1,1,0.281,0.81,0.598,26
knickers,0.376,43,43,1,1,0.552,0.428,0.328,86
tram,0.376,56,56,1,1,0.667,0.628,0.492,112
hangover,0.376,205,205,1,1,0.188,0.565,0.267,410
unclaimed,0.376,18,18,1,1,0.316,0.346,0.278,36
wax,0.376,145,145,1,1,0.436,0.245,0.309,290
wartime,0.376,22,22,1,1,0.1,0.912,0.726,44
compressed,0.376,30,30,1,1,0.323,0.396,0.388,60
inflate,0.376,21,21,1,1,0.305,0.569,0.462,42
occupational,0.376,35,35,1,1,0.583,0.469,0.596,70
slough,0.376,14,14,1,1,0.265,0.39,0.2,28
scotch,0.376,98,98,1,1,0.578,0.52,0.615,196
sorcery,0.376,38,38,1,1,0.279,0.74,0.64,76
rejoicing,0.376,66,66,1,1,0.811,0.637,0.592,132
powerhouse,0.376,36,36,1,1,0.63,0.755,0.787,72
stature,0.376,41,41,1,1,0.47,0.353,0.664,82
brimstone,0.376,20,20,1,1,0.357,0.52,0.44,40
appropriation,0.376,38,38,1,1,0.51,0.632,0.717,76
gobble,0.376,19,19,1,1,0.39,0.623,0.455,38
icebox,0.376,13,13,1,1,0.56,0.222,0.37,26
convoy,0.376,21,21,1,1,0.5,0.671,0.639,42
permanence,0.376,23,23,1,1,0.771,0.37,0.708,46
inventive,0.376,19,19,1,1,0.78,0.627,0.721,38
dogged,0.376,42,42,1,1,0.255,0.75,0.594,84
sequence,0.376,166,166,1,1,0.543,0.35,0.529,332
propelled,0.376,20,20,1,1,0.633,0.736,0.731,40
mule,0.376,39,39,1,1,0.32,0.337,0.254,78
momentous,0.376,17,17,1,1,0.792,0.587,0.76,34
unwashed,0.376,40,40,1,1,0.365,0.427,0.36,80
seals,0.376,59,59,1,1,0.412,0.241,0.402,118
impatiently,0.376,41,41,1,1,0.194,0.75,0.539,82
choral,0.376,14,14,1,1,0.852,0.29,0.421,28
shindig,0.376,13,13,1,1,0.552,0.56,0.491,26
replete,0.376,13,13,1,1,0.552,0.497,0.67,26
cappuccino,0.376,25,25,1,1,0.792,0.279,0.384,50
whim,0.376,127,127,1,1,0.378,0.68,0.467,254
clam,0.376,78,78,1,1,0.442,0.302,0.272,156
filmmaker,0.376,38,38,1,1,0.704,0.51,0.635,76
minivan,0.376,17,17,1,1,0.592,0.356,0.452,34
unrelenting,0.376,79,79,1,1,0.5,0.79,0.875,158
hairdo,0.376,14,14,1,1,0.552,0.32,0.435,28
perilous,0.376,33,33,1,1,0.143,0.862,0.575,66
compute,0.376,30,30,1,1,0.531,0.408,0.564,60
mover,0.376,16,16,1,1,0.615,0.539,0.466,32
tgif,0.376,32,32,1,1,0.542,0.471,0.436,64
ascending,0.376,31,31,1,1,0.826,0.644,0.777,62
bastion,0.376,44,44,1,1,0.531,0.5,0.596,88
racist,0.376,2736,2736,1,1,0.061,0.673,0.482,5472
nominate,0.376,127,127,1,1,0.615,0.471,0.669,254
decree,0.376,31,31,1,1,0.552,0.478,0.746,62
tepid,0.376,15,15,1,1,0.337,0.327,0.237,30
nutritious,0.376,26,26,1,1,0.833,0.337,0.655,52
mill,0.376,145,145,1,1,0.531,0.382,0.347,290
coronation,0.376,20,20,1,1,0.792,0.592,0.836,40
misnomer,0.376,13,13,1,1,0.296,0.528,0.284,26
affiliated,0.376,53,53,1,1,0.673,0.519,0.535,106
ashtray,0.376,26,26,1,1,0.406,0.382,0.265,52
emaciated,0.376,13,13,1,1,0.103,0.541,0.151,26
wok,0.376,13,13,1,1,0.583,0.375,0.5,26
improvised,0.376,22,22,1,1,0.61,0.673,0.443,44
upward,0.376,96,96,1,1,0.792,0.481,0.62,192
organism,0.376,37,37,1,1,0.457,0.559,0.8,74
embroidered,0.376,14,14,1,1,0.677,0.279,0.407,28
branching,0.376,34,34,1,1,0.52,0.422,0.472,68
beckon,0.376,30,30,1,1,0.663,0.455,0.452,60
solitude,0.374,9421,9442,1,1,0.208,0.226,0.358,18863
climb,0.374,887,889,1,1,0.615,0.66,0.604,1776
guilt,0.374,2294,2300,1,1,0.208,0.567,0.206,4594
hatred,0.373,2431,2439,1,1,0.037,0.847,0.424,4870
angel,0.373,5806,5826,1,1,0.906,0.158,0.704,11632
ward,0.372,498,500,1,1,0.469,0.255,0.254,998
artist,0.372,3247,3261,1,1,0.802,0.442,0.732,6508
blur,0.372,207,208,1,1,0.268,0.471,0.205,415
retirement,0.371,615,618,1,1,0.25,0.324,0.255,1233
guardian,0.371,820,824,1,1,0.656,0.686,0.789,1644
humor,0.371,1319,1326,1,1,0.89,0.633,0.462,2645
tiny,0.371,3578,3597,1,1,0.479,0.196,0.125,7175
stars,0.371,6785,6822,1,1,0.796,0.521,0.484,13607
tier,0.371,360,362,1,1,0.52,0.245,0.56,722
hood,0.37,667,671,1,1,0.357,0.459,0.306,1338
lie,0.37,10175,10236,1,1,0.13,0.725,0.272,20411
production,0.37,499,502,1,1,0.694,0.594,0.781,1001
righteousness,0.37,159,160,1,1,0.802,0.66,0.897,319
pea,0.37,150,151,1,1,0.58,0.275,0.298,301
invitation,0.37,444,447,1,1,0.802,0.549,0.647,891
handful,0.369,712,717,1,1,0.521,0.481,0.4,1429
rag,0.369,141,142,1,1,0.255,0.226,0.18,283
untouched,0.369,138,139,1,1,0.531,0.276,0.6,277
morn,0.369,137,138,1,1,0.542,0.284,0.345,275
slim,0.369,266,268,1,1,0.562,0.18,0.296,534
truck,0.369,1056,1064,1,1,0.531,0.368,0.546,2120
sniff,0.369,255,257,1,1,0.396,0.5,0.318,512
begun,0.368,506,510,1,1,0.677,0.5,0.404,1016
performance,0.368,1643,1656,1,1,0.75,0.52,0.672,3299
separation,0.368,861,868,1,1,0.198,0.592,0.409,1729
lasting,0.368,487,491,1,1,0.804,0.535,0.745,978
secretly,0.368,1217,1227,1,1,0.525,0.404,0.479,2444
lighten,0.368,237,239,1,1,0.688,0.438,0.362,476
vindictive,0.368,118,119,1,1,0.092,0.83,0.5,237
crisp,0.368,117,118,1,1,0.776,0.692,0.508,235
spout,0.368,114,115,1,1,0.438,0.357,0.309,229
twenty,0.367,1006,1015,1,1,0.52,0.292,0.286,2021
feet,0.367,3801,3835,1,1,0.51,0.24,0.292,7636
reel,0.367,109,110,1,1,0.449,0.332,0.395,219
freaky,0.367,327,330,1,1,0.19,0.615,0.384,657
lettuce,0.367,108,109,1,1,0.594,0.163,0.291,217
chocolate,0.367,2287,2308,1,1,0.885,0.48,0.418,4595
addicted,0.367,1521,1535,1,1,0.156,0.712,0.483,3056
masquerade,0.367,107,108,1,1,0.431,0.633,0.446,215
leather,0.367,214,216,1,1,0.51,0.324,0.341,430
fake,0.367,17366,17528,1,1,0.073,0.554,0.268,34894
naive,0.367,637,643,1,1,0.406,0.26,0.375,1280
nursery,0.367,105,106,1,1,0.894,0.406,0.389,211
crossover,0.367,103,104,1,1,0.559,0.55,0.5,207
gifts,0.367,1548,1563,1,1,0.865,0.755,0.509,3111
whine,0.367,615,621,1,1,0.342,0.686,0.218,1236
residential,0.367,101,102,1,1,0.72,0.21,0.589,203
emperor,0.367,203,205,1,1,0.651,0.704,0.962,408
sos,0.366,496,501,1,1,0.354,0.675,0.386,997
nasty,0.366,1913,1933,1,1,0.115,0.62,0.264,3846
headline,0.366,279,282,1,1,0.63,0.241,0.685,561
crystal,0.366,460,465,1,1,0.618,0.27,0.508,925
cement,0.365,89,90,1,1,0.544,0.265,0.527,179
scarce,0.365,88,89,1,1,0.292,0.324,0.218,177
cardboard,0.365,170,172,1,1,0.5,0.173,0.309,342
disband,0.364,83,84,1,1,0.302,0.491,0.417,167
yawn,0.364,167,169,1,1,0.385,0.12,0.139,336
laughable,0.364,164,166,1,1,0.592,0.627,0.298,330
overjoyed,0.364,81,82,1,1,0.908,0.708,0.755,163
actor,0.364,809,819,1,1,0.653,0.561,0.629,1628
japan,0.364,2300,2329,1,1,0.667,0.482,0.58,4629
wool,0.363,76,77,1,1,0.583,0.132,0.345,153
tortured,0.363,459,465,1,1,0.062,0.89,0.361,924
crooked,0.363,301,305,1,1,0.146,0.594,0.305,606
compulsion,0.363,74,75,1,1,0.118,0.76,0.604,149
xmas,0.363,2455,2488,1,1,0.906,0.717,0.615,4943
roach,0.363,147,149,1,1,0.146,0.598,0.259,296
premiere,0.363,143,145,1,1,0.776,0.596,0.573,288
communicate,0.363,1938,1965,1,1,0.823,0.41,0.696,3903
toby,0.362,213,216,1,1,0.427,0.375,0.33,429
joyous,0.362,284,288,1,1,0.958,0.58,0.728,572
sympathetic,0.362,282,286,1,1,0.796,0.434,0.609,568
laziness,0.362,210,213,1,1,0.271,0.24,0.132,423
marathon,0.362,539,547,1,1,0.646,0.778,0.74,1086
cards,0.362,1342,1362,1,1,0.568,0.317,0.32,2704
hut,0.362,267,271,1,1,0.633,0.27,0.375,538
structure,0.361,463,470,1,1,0.562,0.356,0.712,933
flyer,0.361,65,66,1,1,0.48,0.3,0.362,131
mutual,0.361,2241,2275,1,1,0.729,0.321,0.464,4516
mercury,0.361,391,397,1,1,0.337,0.312,0.475,788
amplify,0.361,129,131,1,1,0.677,0.735,0.827,260
shy,0.361,3572,3627,1,1,0.28,0.153,0.132,7199
explicit,0.36,124,126,1,1,0.562,0.694,0.734,250
ruler,0.36,122,124,1,1,0.44,0.4,0.631,246
sandwich,0.36,599,609,1,1,0.672,0.314,0.31,1208
gaga,0.36,534,543,1,1,0.479,0.396,0.26,1077
voicemail,0.36,117,119,1,1,0.458,0.453,0.406,236
astronomy,0.359,57,58,1,1,0.613,0.474,0.722,115
bollocks,0.359,172,175,1,1,0.448,0.471,0.327,347
polished,0.359,56,57,1,1,0.667,0.413,0.491,113
expansive,0.359,56,57,1,1,0.708,0.65,0.778,113
scientist,0.359,337,343,1,1,0.562,0.5,0.79,680
outline,0.359,168,171,1,1,0.542,0.365,0.509,339
inaccessible,0.359,55,56,1,1,0.083,0.585,0.446,111
banquet,0.359,55,56,1,1,0.765,0.571,0.6,111
upload,0.358,377,384,1,1,0.638,0.683,0.696,761
weekday,0.358,106,108,1,1,0.49,0.469,0.52,214
ana,0.358,530,540,1,1,0.541,0.3,0.314,1070
goodmorning,0.357,262,267,1,1,0.922,0.461,0.552,529
ratchet,0.357,104,106,1,1,0.449,0.52,0.343,210
motionless,0.357,51,52,1,1,0.323,0.21,0.246,103
block,0.357,3426,3492,1,1,0.286,0.35,0.402,6918
underground,0.357,359,366,1,1,0.396,0.455,0.452,725
effects,0.357,1377,1404,1,1,0.47,0.578,0.379,2781
unfinished,0.357,151,154,1,1,0.188,0.368,0.264,305
crafts,0.357,99,101,1,1,0.667,0.38,0.391,200
oxymoron,0.357,49,50,1,1,0.427,0.481,0.398,99
consultant,0.356,98,100,1,1,0.77,0.344,0.808,198
whiteness,0.356,48,49,1,1,0.688,0.235,0.519,97
agriculture,0.356,48,49,1,1,0.64,0.357,0.465,97
sophomore,0.356,195,199,1,1,0.653,0.415,0.427,394
charisma,0.356,97,99,1,1,0.938,0.591,0.759,196
chlorine,0.356,48,49,1,1,0.306,0.327,0.332,97
cape,0.356,243,248,1,1,0.531,0.235,0.357,491
squishy,0.356,96,98,1,1,0.516,0.333,0.307,194
bare,0.356,1435,1465,1,1,0.333,0.717,0.296,2900
napping,0.355,189,193,1,1,0.765,0.046,0.306,382
lime,0.355,141,144,1,1,0.594,0.24,0.415,285
immaculate,0.355,46,47,1,1,0.698,0.33,0.688,93
suv,0.355,46,47,1,1,0.552,0.431,0.446,93
chapman,0.355,46,47,1,1,0.562,0.529,0.465,93
maximize,0.355,46,47,1,1,0.823,0.765,0.792,93
notebook,0.355,323,330,1,1,0.449,0.167,0.442,653
bastards,0.355,553,565,1,1,0.082,0.68,0.422,1118
shortcut,0.355,45,46,1,1,0.594,0.308,0.426,91
wildlife,0.355,182,186,1,1,0.656,0.53,0.561,368
fooling,0.355,227,232,1,1,0.167,0.755,0.384,459
nutshell,0.354,180,184,1,1,0.458,0.407,0.31,364
computer,0.354,1626,1662,1,1,0.802,0.356,0.639,3288
soaked,0.354,179,183,1,1,0.365,0.462,0.358,362
gaby,0.354,44,45,1,1,0.51,0.347,0.377,89
ghastly,0.354,44,45,1,1,0.125,0.79,0.472,89
eyes,0.354,25191,25754,1,1,0.76,0.279,0.432,50945
egotistical,0.354,133,136,1,1,0.156,0.667,0.363,269
stunning,0.354,535,547,1,1,0.888,0.673,0.858,1082
symbol,0.354,355,363,1,1,0.643,0.388,0.527,718
memorable,0.354,308,315,1,1,0.939,0.51,0.769,623
quicksand,0.354,43,44,1,1,0.219,0.74,0.508,87
immature,0.354,615,629,1,1,0.114,0.5,0.2,1244
nourishment,0.354,43,44,1,1,0.786,0.29,0.631,87
dealership,0.354,43,44,1,1,0.541,0.43,0.629,87
folk,0.354,1362,1393,1,1,0.663,0.433,0.432,2755
coke,0.354,479,490,1,1,0.404,0.461,0.397,969
hymn,0.354,86,88,1,1,0.735,0.292,0.634,174
player,0.354,2130,2179,1,1,0.557,0.688,0.644,4309
nuance,0.353,85,87,1,1,0.408,0.282,0.411,172
tweak,0.353,42,43,1,1,0.44,0.462,0.452,85
copying,0.353,85,87,1,1,0.448,0.315,0.404,172
grits,0.353,42,43,1,1,0.458,0.333,0.346,85
wit,0.353,4486,4591,1,1,0.844,0.484,0.775,9077
agony,0.353,725,742,1,1,0.083,0.775,0.393,1467
suspended,0.353,424,434,1,1,0.224,0.402,0.368,858
precision,0.353,41,42,1,1,0.677,0.431,0.875,83
monster,0.353,2290,2345,1,1,0.133,0.935,0.596,4635
gaze,0.353,747,765,1,1,0.633,0.588,0.586,1512
softness,0.353,82,84,1,1,0.875,0.086,0.402,166
spacious,0.353,82,84,1,1,0.88,0.365,0.557,166
paragraph,0.352,206,211,1,1,0.51,0.164,0.269,417
pour,0.352,861,882,1,1,0.448,0.57,0.375,1743
backseat,0.352,163,167,1,1,0.388,0.33,0.237,330
alternating,0.352,40,41,1,1,0.48,0.494,0.542,81
features,0.352,571,585,1,1,0.667,0.433,0.509,1156
tear,0.352,2371,2430,1,1,0.404,0.62,0.327,4801
copy,0.352,1200,1230,1,1,0.46,0.24,0.263,2430
gregarious,0.352,39,40,1,1,0.551,0.471,0.529,79
highness,0.352,39,40,1,1,0.74,0.67,0.931,79
resourceful,0.352,39,40,1,1,0.906,0.704,0.886,79
minefield,0.352,39,40,1,1,0.188,0.839,0.684,79
yellow,0.352,1197,1227,1,1,0.671,0.275,0.387,2424
remaining,0.351,713,731,1,1,0.449,0.29,0.296,1444
throbbing,0.351,78,80,1,1,0.645,0.808,0.491,158
depot,0.351,78,80,1,1,0.635,0.255,0.471,158
tweet,0.351,20309,20827,1,1,0.659,0.49,0.537,41136
entertaining,0.351,978,1003,1,1,0.833,0.658,0.66,1981
helicopter,0.351,116,119,1,1,0.714,0.806,0.617,235
cluster,0.351,115,118,1,1,0.49,0.458,0.446,233
christmas,0.351,27417,28128,1,1,0.959,0.52,0.741,55545
loop,0.351,845,867,1,1,0.516,0.343,0.317,1712
beware,0.35,412,423,1,1,0.151,0.596,0.518,835
clever,0.35,559,574,1,1,0.896,0.353,0.729,1133
forum,0.35,446,458,1,1,0.556,0.49,0.632,904
hex,0.35,36,37,1,1,0.41,0.51,0.363,73
chuckle,0.349,363,373,1,1,0.844,0.736,0.481,736
get,0.349,264504,271802,1,1,0.74,0.594,0.667,536306
investigator,0.349,35,36,1,1,0.615,0.509,0.779,71
attain,0.349,107,110,1,1,0.806,0.51,0.719,217
thirds,0.349,35,36,1,1,0.402,0.327,0.345,71
tiff,0.349,71,73,1,1,0.531,0.415,0.343,144
turf,0.349,71,73,1,1,0.531,0.192,0.295,144
pathological,0.349,141,145,1,1,0.22,0.602,0.58,286
forge,0.349,141,145,1,1,0.52,0.424,0.686,286
small,0.348,14846,15268,1,1,0.542,0.205,0.12,30114
pupil,0.348,34,35,1,1,0.729,0.406,0.368,69
marital,0.348,104,107,1,1,0.76,0.529,0.5,211
bubbly,0.348,209,215,1,1,0.698,0.608,0.462,424
legalize,0.348,34,35,1,1,0.51,0.46,0.818,69
generous,0.348,450,463,1,1,1,0.41,0.81,913
layer,0.348,207,213,1,1,0.5,0.208,0.366,420
offices,0.348,311,320,1,1,0.469,0.312,0.534,631
clan,0.348,345,355,1,1,0.562,0.491,0.686,700
commodity,0.347,67,69,1,1,0.615,0.394,0.537,136
slender,0.347,67,69,1,1,0.812,0.548,0.664,136
illicit,0.347,33,34,1,1,0.188,0.794,0.39,67
clouded,0.347,101,104,1,1,0.24,0.213,0.302,205
kennel,0.347,101,104,1,1,0.43,0.48,0.406,205
playful,0.347,304,313,1,1,0.892,0.688,0.463,617
ordinary,0.347,675,695,1,1,0.375,0.312,0.286,1370
impulsive,0.347,234,241,1,1,0.365,0.864,0.607,475
grammar,0.347,364,375,1,1,0.56,0.287,0.607,739
swimmer,0.346,32,33,1,1,0.657,0.698,0.61,65
swimsuit,0.346,32,33,1,1,0.74,0.373,0.269,65
caricature,0.346,32,33,1,1,0.604,0.373,0.383,65
inventor,0.346,32,33,1,1,0.781,0.667,0.847,65
badger,0.346,65,67,1,1,0.344,0.429,0.357,132
outlaw,0.346,98,101,1,1,0.255,0.662,0.482,199
media,0.346,13840,14260,1,1,0.5,0.33,0.464,28100
rooted,0.346,327,337,1,1,0.51,0.527,0.718,664
return,0.346,4240,4370,1,1,0.602,0.412,0.463,8610
illuminating,0.346,64,66,1,1,0.949,0.613,0.773,130
coherent,0.346,96,99,1,1,0.698,0.281,0.5,195
daisy,0.346,354,365,1,1,0.562,0.367,0.333,719
real,0.346,44985,46381,1,1,0.719,0.51,0.717,91366
clasp,0.346,31,32,1,1,0.448,0.375,0.241,63
neural,0.346,31,32,1,1,0.582,0.426,0.391,63
anemic,0.346,31,32,1,1,0.167,0.279,0.155,63
page,0.346,2974,3067,1,1,0.677,0.224,0.278,6041
bland,0.345,190,196,1,1,0.3,0.226,0.157,386
post,0.345,13133,13546,1,1,0.52,0.426,0.548,26679
blurred,0.345,94,97,1,1,0.32,0.367,0.231,191
jade,0.345,282,291,1,1,0.604,0.41,0.455,573
indulge,0.345,282,291,1,1,0.833,0.716,0.669,573
cultural,0.345,564,582,1,1,0.802,0.39,0.623,1146
applause,0.345,124,128,1,1,0.953,0.857,0.621,252
fragile,0.345,1123,1159,1,1,0.302,0.163,0.126,2282
eliminate,0.345,311,321,1,1,0.265,0.67,0.324,632
buddhism,0.345,30,31,1,1,0.51,0.115,0.673,61
darkside,0.345,61,63,1,1,0.102,0.69,0.365,124
interstate,0.345,61,63,1,1,0.52,0.443,0.6,124
mastery,0.345,61,63,1,1,0.755,0.648,0.873,124
basket,0.345,402,415,1,1,0.458,0.227,0.336,817
mortal,0.344,338,349,1,1,0.196,0.786,0.51,687
surplus,0.344,60,62,1,1,0.602,0.68,0.63,122
candle,0.344,637,658,1,1,0.602,0.221,0.344,1295
golfing,0.344,90,93,1,1,0.625,0.427,0.455,183
flea,0.344,59,61,1,1,0.286,0.353,0.218,120
advertising,0.344,299,309,1,1,0.622,0.608,0.632,608
nemesis,0.344,59,61,1,1,0.271,0.688,0.647,120
pharmaceutical,0.344,29,30,1,1,0.5,0.435,0.562,59
unbecoming,0.344,29,30,1,1,0.123,0.471,0.288,59
prestige,0.344,59,61,1,1,0.918,0.594,0.907,120
protector,0.343,177,183,1,1,0.779,0.36,0.824,360
traveling,0.343,2191,2265,1,1,0.9,0.75,0.582,4456
rhythm,0.343,528,546,1,1,0.771,0.759,0.573,1074
desirable,0.343,175,181,1,1,0.74,0.735,0.75,356
transport,0.343,467,483,1,1,0.613,0.627,0.605,950
rainfall,0.342,28,29,1,1,0.604,0.314,0.378,57
mechanic,0.342,86,89,1,1,0.571,0.433,0.566,175
sled,0.342,28,29,1,1,0.635,0.547,0.446,57
tripod,0.342,28,29,1,1,0.406,0.388,0.483,57
fanfare,0.342,28,29,1,1,0.656,0.64,0.437,57
derelict,0.342,28,29,1,1,0.208,0.47,0.237,57
cornbread,0.342,28,29,1,1,0.643,0.304,0.302,57
respond,0.342,2719,2813,1,1,0.573,0.435,0.594,5532
ale,0.342,170,176,1,1,0.53,0.45,0.358,346
provoked,0.342,56,58,1,1,0.271,0.676,0.528,114
stump,0.342,56,58,1,1,0.449,0.51,0.34,114
couple,0.342,12125,12553,1,1,0.806,0.605,0.607,24678
cousins,0.342,1413,1463,1,1,0.76,0.409,0.464,2876
rehearsal,0.341,111,115,1,1,0.667,0.47,0.5,226
audition,0.341,111,115,1,1,0.75,0.685,0.615,226
immobile,0.341,27,28,1,1,0.225,0.217,0.298,55
moderator,0.341,27,28,1,1,0.519,0.354,0.802,55
delicate,0.341,277,287,1,1,0.583,0.294,0.366,564
ukulele,0.341,82,85,1,1,0.513,0.358,0.365,167
hallucination,0.341,54,56,1,1,0.396,0.706,0.37,110
main,0.34,5107,5295,1,1,0.667,0.51,0.811,10402
unadulterated,0.34,26,27,1,1,0.57,0.42,0.528,53
apparition,0.34,26,27,1,1,0.406,0.573,0.636,53
impregnate,0.34,26,27,1,1,0.51,0.721,0.655,53
astute,0.34,26,27,1,1,0.776,0.658,0.827,53
hanger,0.34,53,55,1,1,0.439,0.462,0.461,108
distinctive,0.34,26,27,1,1,0.885,0.52,0.604,53
borderline,0.34,481,499,1,1,0.449,0.52,0.49,980
red,0.34,7198,7468,1,1,0.427,0.385,0.377,14666
bitchy,0.339,265,275,1,1,0.188,0.7,0.373,540
simultaneously,0.339,769,798,1,1,0.656,0.49,0.609,1567
frown,0.339,291,302,1,1,0.214,0.602,0.433,593
carrot,0.339,158,164,1,1,0.5,0.235,0.279,322
blend,0.339,237,246,1,1,0.469,0.452,0.463,483
thriving,0.339,554,575,1,1,0.865,0.521,0.779,1129
mere,0.339,704,731,1,1,0.396,0.221,0.176,1435
picker,0.339,25,26,1,1,0.534,0.34,0.609,51
overview,0.339,25,26,1,1,0.615,0.38,0.539,51
odyssey,0.339,103,107,1,1,0.622,0.692,0.71,210
gruesome,0.339,77,80,1,1,0.094,0.837,0.474,157
emulate,0.339,51,53,1,1,0.438,0.34,0.549,104
transcendent,0.339,25,26,1,1,0.667,0.6,0.824,51
homily,0.339,25,26,1,1,0.621,0.358,0.425,51
stiff,0.338,154,160,1,1,0.158,0.459,0.569,314
nonexistent,0.338,231,240,1,1,0.208,0.429,0.149,471
vessel,0.338,231,240,1,1,0.49,0.398,0.538,471
excitement,0.338,899,934,1,1,0.896,0.684,0.731,1833
word,0.338,11194,11631,1,1,0.552,0.255,0.482,22825
place,0.338,49073,50990,1,1,0.573,0.261,0.398,100063
successful,0.338,2788,2897,1,1,0.949,0.724,0.938,5685
jammed,0.338,50,52,1,1,0.235,0.817,0.411,102
unstable,0.338,815,847,1,1,0.167,0.587,0.15,1662
pooch,0.338,50,52,1,1,0.355,0.36,0.347,102
conversation,0.338,7421,7713,1,1,0.75,0.51,0.609,15134
status,0.338,2046,2127,1,1,0.658,0.377,0.588,4173
exterior,0.337,100,104,1,1,0.542,0.4,0.627,204
callous,0.337,100,104,1,1,0.245,0.5,0.386,204
joy,0.337,7510,7808,1,1,0.98,0.824,0.794,15318
shattered,0.337,704,732,1,1,0.097,0.806,0.309,1436
cruelty,0.337,477,496,1,1,0.092,0.836,0.536,973
money,0.337,21729,22596,1,1,0.844,0.608,0.827,44325
chariot,0.337,24,25,1,1,0.684,0.55,0.491,49
erection,0.337,49,51,1,1,0.64,0.856,0.695,100
imbecile,0.337,99,103,1,1,0.082,0.569,0.26,202
fishy,0.337,99,103,1,1,0.224,0.601,0.471,202
trappings,0.337,24,25,1,1,0.458,0.462,0.37,49
marshmallow,0.337,74,77,1,1,0.74,0.441,0.391,151
rob,0.337,796,828,1,1,0.112,0.84,0.5,1624
seldom,0.337,248,258,1,1,0.323,0.379,0.287,506
atlas,0.337,123,128,1,1,0.531,0.306,0.554,251
museum,0.336,392,408,1,1,0.792,0.206,0.481,800
chair,0.336,1536,1599,1,1,0.562,0.082,0.276,3135
chaotic,0.336,559,582,1,1,0.115,0.847,0.442,1141
sue,0.336,559,582,1,1,0.219,0.731,0.679,1141
plunge,0.336,72,75,1,1,0.307,0.69,0.55,147
newspaper,0.336,242,252,1,1,0.602,0.283,0.444,494
section,0.336,1261,1313,1,1,0.5,0.269,0.421,2574
blowing,0.336,917,955,1,1,0.521,0.472,0.434,1872
beard,0.336,409,426,1,1,0.49,0.261,0.371,835
friend,0.336,75532,78674,1,1,0.906,0.413,0.573,154206
mores,0.336,23,24,1,1,0.582,0.317,0.684,47
squat,0.336,71,74,1,1,0.33,0.55,0.453,145
flawless,0.336,143,149,1,1,0.729,0.42,0.741,292
patronize,0.336,23,24,1,1,0.43,0.451,0.591,47
cedar,0.336,47,49,1,1,0.56,0.267,0.577,96
washed,0.336,671,699,1,1,0.542,0.314,0.392,1370
glance,0.335,406,423,1,1,0.625,0.357,0.454,829
pretentious,0.335,166,173,1,1,0.156,0.736,0.444,339
entirety,0.335,308,321,1,1,0.854,0.46,0.804,629
verified,0.335,117,122,1,1,0.781,0.367,0.677,239
reject,0.335,801,835,1,1,0.06,0.647,0.37,1636
inauguration,0.335,46,48,1,1,0.847,0.712,0.769,94
crescent,0.335,46,48,1,1,0.698,0.382,0.407,94
organic,0.335,163,170,1,1,0.719,0.343,0.535,333
designer,0.334,233,243,1,1,0.875,0.519,0.67,476
aboard,0.334,139,145,1,1,0.698,0.284,0.481,284
instrumental,0.334,232,242,1,1,0.74,0.472,0.647,474
homework,0.334,1087,1134,1,1,0.396,0.412,0.459,2221
recluse,0.334,207,216,1,1,0.24,0.49,0.446,423
cranky,0.334,253,264,1,1,0.194,0.776,0.396,517
familiar,0.334,2054,2143,1,1,0.906,0.33,0.615,4197
uppity,0.334,22,23,1,1,0.465,0.546,0.417,45
courtyard,0.334,45,47,1,1,0.503,0.365,0.355,92
tenuous,0.334,22,23,1,1,0.398,0.263,0.276,45
communicative,0.334,22,23,1,1,0.847,0.56,0.637,45
prevalence,0.334,45,47,1,1,0.618,0.52,0.815,92
sully,0.334,45,47,1,1,0.378,0.55,0.37,92
puffing,0.334,22,23,1,1,0.396,0.612,0.375,45
silicone,0.334,22,23,1,1,0.48,0.34,0.333,45
villa,0.334,182,190,1,1,0.698,0.29,0.345,372
needle,0.334,182,190,1,1,0.25,0.472,0.36,372
adoption,0.333,318,332,1,1,0.625,0.566,0.589,650
defender,0.333,204,213,1,1,0.639,0.708,0.75,417
continuity,0.333,67,70,1,1,0.781,0.439,0.684,137
rancid,0.333,44,46,1,1,0.156,0.451,0.214,90
duke,0.333,224,234,1,1,0.667,0.44,0.669,458
controversy,0.332,110,115,1,1,0.25,0.819,0.6,225
bittersweet,0.332,576,602,1,1,0.469,0.569,0.474,1178
paint,0.332,1059,1107,1,1,0.667,0.343,0.413,2166
plain,0.332,1102,1152,1,1,0.5,0.167,0.311,2254
chronological,0.332,21,22,1,1,0.594,0.445,0.6,43
counterfeit,0.332,21,22,1,1,0.094,0.694,0.451,43
dogmatic,0.332,21,22,1,1,0.448,0.52,0.654,43
stifle,0.332,43,45,1,1,0.24,0.764,0.427,88
ribbon,0.332,109,114,1,1,0.719,0.288,0.357,223
joint,0.331,609,637,1,1,0.615,0.392,0.566,1246
dive,0.331,542,567,1,1,0.583,0.531,0.5,1109
cinnamon,0.331,194,203,1,1,0.6,0.25,0.292,397
drawer,0.331,194,203,1,1,0.429,0.196,0.292,397
escape,0.331,5001,5232,1,1,0.367,0.765,0.448,10233
deformed,0.331,42,44,1,1,0.198,0.435,0.308,86
acquiring,0.331,42,44,1,1,0.735,0.51,0.817,86
heritage,0.331,214,224,1,1,0.842,0.512,0.815,438
indefinite,0.331,42,44,1,1,0.448,0.292,0.296,86
puberty,0.331,149,156,1,1,0.552,0.786,0.504,305
fire,0.33,6243,6536,1,1,0.38,0.804,0.635,12779
vine,0.33,210,220,1,1,0.531,0.292,0.405,430
colors,0.33,1074,1125,1,1,0.875,0.349,0.34,2199
experiment,0.33,378,396,1,1,0.479,0.72,0.675,774
disperse,0.33,20,21,1,1,0.375,0.569,0.434,41
onyx,0.33,20,21,1,1,0.571,0.461,0.38,41
gander,0.33,20,21,1,1,0.51,0.41,0.353,41
dangit,0.33,20,21,1,1,0.396,0.606,0.358,41
contraception,0.33,20,21,1,1,0.296,0.518,0.525,41
cauldron,0.33,20,21,1,1,0.51,0.486,0.418,41
grope,0.33,62,65,1,1,0.42,0.559,0.358,127
effect,0.33,2047,2145,1,1,0.57,0.518,0.608,4192
bourbon,0.329,124,130,1,1,0.602,0.49,0.517,254
geez,0.329,515,540,1,1,0.417,0.396,0.39,1055
sing,0.329,7047,7390,1,1,0.858,0.606,0.42,14437
nuances,0.329,40,42,1,1,0.49,0.375,0.527,82
disgraced,0.329,81,85,1,1,0.071,0.661,0.25,166
monte,0.329,40,42,1,1,0.589,0.33,0.391,82
volleyball,0.328,101,106,1,1,0.64,0.7,0.458,207
undeniable,0.328,101,106,1,1,0.552,0.473,0.778,207
unofficial,0.328,60,63,1,1,0.26,0.302,0.255,123
formative,0.328,60,63,1,1,0.688,0.442,0.8,123
shop,0.328,2958,3104,1,1,0.725,0.632,0.565,6062
excluding,0.328,140,147,1,1,0.271,0.55,0.324,287
venom,0.328,301,316,1,1,0.125,0.77,0.491,617
weather,0.328,4104,4308,1,1,0.755,0.404,0.567,8412
peruse,0.328,19,20,1,1,0.503,0.27,0.439,39
resistant,0.328,59,62,1,1,0.592,0.585,0.815,121
pique,0.328,19,20,1,1,0.417,0.5,0.426,39
herpes,0.328,79,83,1,1,0.11,0.6,0.309,162
obedient,0.328,79,83,1,1,0.8,0.179,0.518,162
playback,0.328,19,20,1,1,0.656,0.559,0.639,39
oddball,0.328,39,41,1,1,0.316,0.36,0.357,80
potter,0.327,538,565,1,1,0.573,0.417,0.482,1103
pair,0.327,1376,1445,1,1,0.552,0.317,0.304,2821
binge,0.327,1291,1356,1,1,0.304,0.65,0.5,2647
dreadful,0.327,415,436,1,1,0.092,0.786,0.348,851
douchebags,0.327,58,61,1,1,0.327,0.587,0.366,119
canyon,0.326,136,143,1,1,0.468,0.731,0.634,279
reptile,0.326,38,40,1,1,0.35,0.566,0.365,78
hog,0.326,96,101,1,1,0.317,0.509,0.271,197
elevate,0.326,173,182,1,1,0.812,0.5,0.804,355
gimmick,0.326,57,60,1,1,0.38,0.663,0.519,117
ledge,0.325,114,120,1,1,0.406,0.235,0.339,234
catching,0.325,1031,1085,1,1,0.49,0.788,0.644,2116
kidding,0.325,1959,2062,1,1,0.622,0.625,0.457,4021
surpassing,0.325,18,19,1,1,0.719,0.66,0.72,37
unsuitable,0.325,18,19,1,1,0.188,0.528,0.3,37
boxer,0.325,94,99,1,1,0.49,0.81,0.802,193
firework,0.325,56,59,1,1,0.786,0.904,0.593,115
peri,0.325,18,19,1,1,0.448,0.433,0.37,37
chai,0.325,151,159,1,1,0.5,0.375,0.363,310
magma,0.325,18,19,1,1,0.323,0.623,0.609,37
lapdog,0.325,18,19,1,1,0.388,0.49,0.269,37
recipient,0.325,75,79,1,1,0.604,0.324,0.679,154
subversion,0.325,18,19,1,1,0.347,0.608,0.415,37
rephrase,0.325,75,79,1,1,0.547,0.451,0.549,154
breakaway,0.325,18,19,1,1,0.479,0.802,0.519,37
inviting,0.325,699,736,1,1,0.938,0.571,0.538,1435
bunch,0.325,6061,6382,1,1,0.552,0.358,0.473,12443
blind,0.325,2261,2381,1,1,0.156,0.36,0.184,4642
purity,0.325,187,197,1,1,0.823,0.205,0.712,384
danger,0.324,1784,1879,1,1,0.115,0.923,0.673,3663
panther,0.324,130,137,1,1,0.303,0.594,0.682,267
dodo,0.324,55,58,1,1,0.438,0.306,0.353,113
tedious,0.324,166,175,1,1,0.104,0.406,0.241,341
sleep,0.324,32782,34549,1,1,0.719,0.09,0.339,67331
hen,0.324,184,194,1,1,0.385,0.276,0.241,378
preacher,0.324,110,116,1,1,0.551,0.388,0.741,226
strike,0.324,793,836,1,1,0.271,0.811,0.571,1629
clutch,0.323,183,193,1,1,0.383,0.5,0.491,376
madame,0.323,91,96,1,1,0.604,0.5,0.635,187
website,0.323,1120,1181,1,1,0.615,0.442,0.526,2301
dart,0.323,54,57,1,1,0.417,0.608,0.5,111
avoidance,0.323,109,115,1,1,0.47,0.481,0.466,224
golf,0.323,549,579,1,1,0.573,0.358,0.447,1128
segregated,0.323,54,57,1,1,0.164,0.575,0.411,111
zodiac,0.323,219,231,1,1,0.594,0.429,0.426,450
textbook,0.323,108,114,1,1,0.622,0.235,0.526,222
maid,0.323,344,363,1,1,0.406,0.324,0.3,707
cartridge,0.322,17,18,1,1,0.458,0.5,0.407,35
lieu,0.322,53,56,1,1,0.427,0.41,0.312,109
wanton,0.322,17,18,1,1,0.427,0.739,0.5,35
occult,0.322,35,37,1,1,0.292,0.382,0.406,72
jointly,0.322,17,18,1,1,0.708,0.425,0.602,35
effectiveness,0.322,35,37,1,1,0.64,0.654,0.812,72
laughingstock,0.322,17,18,1,1,0.427,0.779,0.312,35
decomposed,0.322,17,18,1,1,0.073,0.442,0.231,35
swing,0.322,737,778,1,1,0.602,0.51,0.481,1515
whiplash,0.322,53,56,1,1,0.257,0.76,0.5,109
athletics,0.322,35,37,1,1,0.831,0.691,0.74,72
fiesta,0.322,35,37,1,1,0.927,0.779,0.655,72
litany,0.322,17,18,1,1,0.51,0.365,0.482,35
tea,0.322,4220,4455,1,1,0.698,0.163,0.37,8675
jackass,0.322,196,207,1,1,0.188,0.692,0.279,403
taste,0.322,3246,3428,1,1,0.802,0.406,0.465,6674
buried,0.322,961,1015,1,1,0.133,0.53,0.37,1976
fanatic,0.322,88,93,1,1,0.573,0.78,0.629,181
gritty,0.322,70,74,1,1,0.417,0.373,0.375,144
ungrateful,0.321,495,523,1,1,0.219,0.461,0.275,1018
german,0.321,725,766,1,1,0.438,0.29,0.57,1491
friendly,0.321,3590,3793,1,1,0.917,0.398,0.598,7383
swerve,0.321,52,55,1,1,0.276,0.612,0.357,107
devious,0.321,52,55,1,1,0.25,0.519,0.259,107
scarlet,0.321,140,148,1,1,0.507,0.39,0.411,288
fabulous,0.321,667,705,1,1,0.979,0.66,0.797,1372
proximity,0.321,174,184,1,1,0.677,0.508,0.569,358
breakup,0.321,979,1035,1,1,0.25,0.72,0.357,2014
bundle,0.321,156,165,1,1,0.51,0.343,0.434,321
component,0.32,86,91,1,1,0.531,0.382,0.525,177
arrangement,0.32,173,183,1,1,0.625,0.382,0.683,356
slap,0.32,797,843,1,1,0.1,0.804,0.518,1640
cheeky,0.32,155,164,1,1,0.434,0.679,0.41,319
napkin,0.32,51,54,1,1,0.469,0.142,0.209,105
blending,0.32,51,54,1,1,0.56,0.418,0.637,105
enthusiastic,0.32,155,164,1,1,0.885,0.868,0.848,319
hearty,0.32,51,54,1,1,0.76,0.684,0.792,105
yawning,0.32,68,72,1,1,0.323,0.216,0.15,140
automated,0.32,85,90,1,1,0.578,0.402,0.632,175
asap,0.32,1666,1763,1,1,0.571,0.5,0.552,3429
doom,0.32,393,416,1,1,0.073,0.75,0.442,809
downright,0.319,170,180,1,1,0.625,0.454,0.679,350
flair,0.319,50,53,1,1,0.775,0.471,0.676,103
dominion,0.319,33,35,1,1,0.542,0.704,0.89,68
uniformed,0.319,16,17,1,1,0.469,0.519,0.589,33
inject,0.319,67,71,1,1,0.406,0.735,0.596,138
historian,0.319,50,53,1,1,0.688,0.27,0.637,103
cadence,0.319,33,35,1,1,0.427,0.473,0.355,68
obliterate,0.319,16,17,1,1,0.25,0.539,0.569,33
marred,0.319,16,17,1,1,0.181,0.561,0.233,33
conspicuous,0.319,16,17,1,1,0.479,0.52,0.596,33
dilapidated,0.319,16,17,1,1,0.229,0.618,0.286,33
commission,0.319,237,251,1,1,0.677,0.48,0.571,488
condom,0.319,101,107,1,1,0.406,0.637,0.5,208
moody,0.319,625,662,1,1,0.245,0.811,0.595,1287
spin,0.319,591,626,1,1,0.551,0.422,0.345,1217
enduring,0.319,320,339,1,1,0.633,0.459,0.768,659
creek,0.319,151,160,1,1,0.552,0.392,0.33,311
sphere,0.319,117,124,1,1,0.633,0.277,0.5,241
sunday,0.319,5002,5299,1,1,0.776,0.196,0.394,10301
developing,0.319,504,534,1,1,0.833,0.587,0.714,1038
fee,0.319,487,516,1,1,0.354,0.386,0.556,1003
bank,0.318,1610,1706,1,1,0.562,0.327,0.675,3316
tout,0.318,66,70,1,1,0.48,0.538,0.375,136
scientific,0.318,250,265,1,1,0.653,0.51,0.836,515
skeleton,0.318,298,316,1,1,0.183,0.464,0.343,614
mango,0.318,165,175,1,1,0.765,0.327,0.29,340
sanctuary,0.318,496,526,1,1,0.863,0.226,0.575,1022
husky,0.318,148,157,1,1,0.63,0.45,0.49,305
boogie,0.318,148,157,1,1,0.59,0.543,0.4,305
shove,0.318,412,437,1,1,0.306,0.69,0.602,849
moo,0.317,131,139,1,1,0.438,0.355,0.3,270
monarch,0.317,32,34,1,1,0.583,0.559,0.87,66
chops,0.317,65,69,1,1,0.612,0.42,0.269,134
rapport,0.317,32,34,1,1,0.771,0.664,0.567,66
eagerness,0.317,32,34,1,1,0.406,0.621,0.443,66
midtown,0.317,32,34,1,1,0.479,0.442,0.538,66
subversive,0.317,32,34,1,1,0.198,0.765,0.5,66
conceal,0.317,114,121,1,1,0.312,0.436,0.306,235
descend,0.317,81,86,1,1,0.385,0.535,0.231,167
mail,0.317,817,867,1,1,0.615,0.231,0.548,1684
rival,0.317,146,155,1,1,0.286,0.605,0.574,301
tripe,0.317,48,51,1,1,0.312,0.361,0.438,99
notably,0.317,48,51,1,1,0.792,0.533,0.689,99
womanhood,0.317,48,51,1,1,0.812,0.656,0.602,99
feud,0.317,48,51,1,1,0.146,0.796,0.312,99
pilot,0.317,357,379,1,1,0.688,0.68,0.736,736
curiosity,0.317,438,465,1,1,0.75,0.755,0.463,903
generation,0.317,2778,2949,1,1,0.903,0.48,0.685,5727
jet,0.316,323,343,1,1,0.612,0.721,0.606,666
hormone,0.316,80,85,1,1,0.49,0.75,0.621,165
maple,0.316,96,102,1,1,0.541,0.39,0.339,198
risky,0.316,387,411,1,1,0.224,0.922,0.7,798
senior,0.316,1754,1863,1,1,0.561,0.415,0.536,3617
blush,0.316,224,238,1,1,0.698,0.61,0.445,462
capricious,0.316,15,16,1,1,0.221,0.65,0.5,31
footwear,0.316,15,16,1,1,0.643,0.337,0.275,31
aspiring,0.316,127,135,1,1,0.844,0.582,0.604,262
zeta,0.316,15,16,1,1,0.385,0.29,0.38,31
tryouts,0.316,15,16,1,1,0.49,0.602,0.594,31
sedate,0.316,15,16,1,1,0.656,0.157,0.345,31
sacrament,0.316,31,33,1,1,0.69,0.316,0.7,64
memento,0.316,15,16,1,1,0.708,0.36,0.536,31
cardigan,0.316,31,33,1,1,0.599,0.324,0.264,64
dowry,0.316,15,16,1,1,0.604,0.453,0.544,31
desist,0.316,15,16,1,1,0.22,0.358,0.291,31
weir,0.316,15,16,1,1,0.375,0.385,0.363,31
upscale,0.316,15,16,1,1,0.698,0.526,0.846,31
imminent,0.316,95,101,1,1,0.49,0.784,0.643,196
universality,0.316,15,16,1,1,0.796,0.41,0.84,31
pleasurable,0.316,47,50,1,1,0.948,0.529,0.669,97
cheeks,0.315,923,981,1,1,0.708,0.324,0.282,1904
bicycle,0.315,126,134,1,1,0.708,0.519,0.425,260
curious,0.315,1835,1951,1,1,0.635,0.6,0.483,3786
shadow,0.315,2732,2905,1,1,0.302,0.343,0.158,5637
admiral,0.315,62,66,1,1,0.844,0.49,0.847,128
honesty,0.315,2251,2394,1,1,0.938,0.411,0.728,4645
rid,0.315,2518,2678,1,1,0.194,0.408,0.327,5196
passenger,0.315,298,317,1,1,0.717,0.413,0.481,615
grump,0.314,46,49,1,1,0.26,0.469,0.425,95
spinning,0.314,514,547,1,1,0.594,0.61,0.481,1061
covered,0.314,1479,1574,1,1,0.562,0.34,0.644,3053
kidnap,0.314,217,231,1,1,0.032,0.923,0.535,448
fitting,0.314,621,661,1,1,0.612,0.441,0.638,1282
campus,0.314,1769,1883,1,1,0.604,0.388,0.519,3652
tangle,0.314,30,32,1,1,0.354,0.545,0.254,62
communal,0.314,185,197,1,1,0.592,0.321,0.556,382
dell,0.314,30,32,1,1,0.458,0.38,0.453,62
taps,0.314,138,147,1,1,0.448,0.378,0.409,285
consecutive,0.313,168,179,1,1,0.663,0.418,0.643,347
reborn,0.313,168,179,1,1,0.802,0.618,0.737,347
assorted,0.313,45,48,1,1,0.602,0.46,0.472,93
swamped,0.313,45,48,1,1,0.156,0.48,0.27,93
insulting,0.313,425,453,1,1,0.094,0.84,0.412,878
carousel,0.313,75,80,1,1,0.704,0.5,0.412,155
novelty,0.313,75,80,1,1,0.673,0.521,0.74,155
yield,0.312,90,96,1,1,0.719,0.578,0.618,186
beef,0.312,514,548,1,1,0.582,0.312,0.492,1062
compliment,0.312,589,628,1,1,0.82,0.49,0.651,1217
sign,0.312,5659,6034,1,1,0.62,0.481,0.397,11693
library,0.312,1790,1909,1,1,0.776,0.122,0.549,3699
meet,0.312,19765,21080,1,1,0.76,0.51,0.58,40845
hopeless,0.312,3784,4036,1,1,0.094,0.298,0.112,7820
swimming,0.312,870,928,1,1,0.76,0.559,0.524,1798
chaste,0.312,29,31,1,1,0.408,0.248,0.453,60
deference,0.312,14,15,1,1,0.51,0.396,0.447,29
recapture,0.312,14,15,1,1,0.333,0.656,0.658,29
bypass,0.312,59,63,1,1,0.429,0.418,0.353,122
mesa,0.312,44,47,1,1,0.604,0.191,0.319,91
stalemate,0.312,14,15,1,1,0.296,0.354,0.267,29
triple,0.312,329,351,1,1,0.585,0.385,0.481,680
outdo,0.312,14,15,1,1,0.771,0.75,0.873,29
ascent,0.312,14,15,1,1,0.755,0.627,0.833,29
macarena,0.312,14,15,1,1,0.802,0.601,0.368,29
fluke,0.312,29,31,1,1,0.446,0.45,0.432,60
infidel,0.312,14,15,1,1,0.177,0.74,0.404,29
feisty,0.312,44,47,1,1,0.592,0.853,0.789,91
anarchy,0.312,89,95,1,1,0.146,0.755,0.62,184
hairbrush,0.312,14,15,1,1,0.454,0.216,0.263,29
published,0.312,494,527,1,1,0.667,0.429,0.57,1021
getup,0.312,14,15,1,1,0.541,0.582,0.455,29
forgotten,0.312,4765,5083,1,1,0.235,0.28,0.184,9848
approaching,0.312,688,734,1,1,0.74,0.557,0.491,1422
queer,0.312,1616,1724,1,1,0.286,0.61,0.304,3340
finished,0.312,3667,3912,1,1,0.51,0.387,0.57,7579
duh,0.312,731,780,1,1,0.357,0.461,0.364,1511
station,0.311,1655,1766,1,1,0.688,0.367,0.519,3421
draw,0.311,2577,2750,1,1,0.704,0.449,0.481,5327
proceeds,0.311,221,236,1,1,0.677,0.47,0.585,457
unavailable,0.311,295,315,1,1,0.323,0.281,0.159,610
grass,0.311,767,819,1,1,0.604,0.164,0.333,1586
darkness,0.311,8454,9027,1,1,0.102,0.602,0.418,17481
mobile,0.311,825,881,1,1,0.615,0.569,0.481,1706
release,0.31,2568,2743,1,1,0.74,0.606,0.741,5311
flash,0.31,718,767,1,1,0.571,0.59,0.657,1485
sticker,0.31,219,234,1,1,0.583,0.306,0.346,453
caramel,0.31,87,93,1,1,0.901,0.363,0.4,180
gaggle,0.31,43,46,1,1,0.542,0.529,0.664,89
narrowing,0.31,28,30,1,1,0.354,0.593,0.357,58
fireball,0.31,28,30,1,1,0.302,0.777,0.664,58
straightforward,0.31,115,123,1,1,0.78,0.15,0.38,238
supplement,0.31,57,61,1,1,0.745,0.406,0.491,118
reverting,0.31,28,30,1,1,0.562,0.385,0.544,58
greenhouse,0.31,28,30,1,1,0.719,0.438,0.384,58
falling,0.31,6942,7421,1,1,0.202,0.716,0.306,14363
buy,0.31,10400,11118,1,1,0.771,0.769,0.612,21518
enrich,0.309,129,138,1,1,0.896,0.731,0.705,267
hectic,0.309,360,385,1,1,0.167,0.811,0.438,745
reception,0.309,201,215,1,1,0.694,0.375,0.567,416
jelly,0.309,244,261,1,1,0.651,0.294,0.256,505
radiate,0.309,114,122,1,1,0.719,0.735,0.738,236
pivot,0.309,42,45,1,1,0.458,0.382,0.44,87
gambler,0.309,42,45,1,1,0.458,0.694,0.618,87
yucky,0.309,42,45,1,1,0.142,0.806,0.237,87
endemic,0.309,42,45,1,1,0.406,0.48,0.483,87
quack,0.309,42,45,1,1,0.53,0.451,0.625,87
heavens,0.309,457,489,1,1,0.806,0.273,0.683,946
heterosexual,0.309,170,182,1,1,0.561,0.612,0.557,352
slow,0.308,3943,4221,1,1,0.357,0.073,0.131,8164
heroic,0.308,155,166,1,1,0.89,0.77,0.912,321
grasp,0.308,750,803,1,1,0.56,0.623,0.57,1553
slash,0.308,98,105,1,1,0.26,0.5,0.509,203
chain,0.308,734,786,1,1,0.378,0.5,0.547,1520
brink,0.308,211,226,1,1,0.375,0.413,0.356,437
stain,0.308,225,241,1,1,0.453,0.324,0.264,466
trashy,0.308,168,180,1,1,0.071,0.38,0.161,348
interesting,0.307,5115,5480,1,1,0.927,0.726,0.731,10595
heirs,0.307,27,29,1,1,0.796,0.519,0.698,56
hooligan,0.307,13,14,1,1,0.295,0.712,0.455,27
choreographer,0.307,13,14,1,1,0.646,0.639,0.625,27
circumvent,0.307,13,14,1,1,0.316,0.642,0.383,27
implicate,0.307,13,14,1,1,0.25,0.67,0.434,27
dishonorable,0.307,13,14,1,1,0.112,0.641,0.28,27
coalesce,0.307,13,14,1,1,0.479,0.434,0.529,27
synthesis,0.307,13,14,1,1,0.604,0.315,0.377,27
infuse,0.307,13,14,1,1,0.38,0.705,0.589,27
airbag,0.307,13,14,1,1,0.51,0.402,0.433,27
cricket,0.307,307,329,1,1,0.423,0.539,0.37,636
overtired,0.307,13,14,1,1,0.21,0.357,0.273,27
biter,0.307,13,14,1,1,0.26,0.598,0.5,27
algorithm,0.307,153,164,1,1,0.448,0.394,0.559,317
stealthy,0.307,13,14,1,1,0.38,0.363,0.534,27
euthanasia,0.307,41,44,1,1,0.229,0.716,0.325,85
fanciful,0.307,13,14,1,1,0.677,0.592,0.342,27
amulet,0.307,13,14,1,1,0.781,0.26,0.63,27
ripper,0.307,41,44,1,1,0.219,0.887,0.642,85
comics,0.307,642,688,1,1,0.69,0.556,0.384,1330
beam,0.307,306,328,1,1,0.584,0.349,0.382,634
fell,0.307,5407,5795,1,1,0.255,0.462,0.25,11202
drone,0.307,180,193,1,1,0.429,0.686,0.596,373
praised,0.307,165,177,1,1,0.95,0.441,0.721,342
fall,0.307,16585,17784,1,1,0.177,0.657,0.221,34369
pardon,0.306,234,251,1,1,0.552,0.413,0.542,485
generosity,0.306,151,162,1,1,0.958,0.443,0.692,313
loathsome,0.306,68,73,1,1,0.12,0.694,0.343,141
denim,0.306,68,73,1,1,0.52,0.382,0.327,141
griffin,0.306,137,147,1,1,0.418,0.337,0.36,284
tang,0.306,68,73,1,1,0.594,0.383,0.34,141
bizarre,0.306,521,559,1,1,0.379,0.62,0.392,1080
murderous,0.306,150,161,1,1,0.017,0.94,0.682,311
exhibit,0.306,191,205,1,1,0.688,0.633,0.708,396
medal,0.306,95,102,1,1,0.854,0.555,0.746,197
disturbing,0.306,998,1071,1,1,0.146,0.792,0.439,2069
vulture,0.306,40,43,1,1,0.316,0.604,0.472,83
custard,0.306,40,43,1,1,0.618,0.26,0.293,83
spell,0.306,955,1025,1,1,0.385,0.38,0.368,1980
ostracized,0.306,217,233,1,1,0.115,0.69,0.377,450
cork,0.305,67,72,1,1,0.347,0.25,0.281,139
ready,0.305,19871,21338,1,1,0.77,0.388,0.648,41209
principle,0.305,283,304,1,1,0.75,0.306,0.629,587
unintended,0.305,53,57,1,1,0.438,0.385,0.349,110
faculties,0.305,26,28,1,1,0.643,0.431,0.76,54
axis,0.305,53,57,1,1,0.209,0.25,0.356,110
enema,0.305,26,28,1,1,0.281,0.673,0.268,54
perfume,0.304,254,273,1,1,0.74,0.472,0.463,527
wayward,0.304,66,71,1,1,0.344,0.573,0.409,137
implication,0.304,66,71,1,1,0.337,0.528,0.69,137
conformity,0.304,66,71,1,1,0.645,0.363,0.579,137
shampoo,0.304,133,143,1,1,0.604,0.18,0.25,276
hill,0.304,2513,2701,1,1,0.615,0.353,0.518,5214
tat,0.304,199,214,1,1,0.429,0.38,0.404,413
attractiveness,0.304,39,42,1,1,0.938,0.667,0.755,81
thoughtfulness,0.304,39,42,1,1,0.867,0.269,0.667,81
psychiatry,0.304,39,42,1,1,0.191,0.663,0.698,81
pathology,0.304,39,42,1,1,0.271,0.56,0.558,81
eight,0.304,638,686,1,1,0.54,0.199,0.315,1324
blurry,0.304,172,185,1,1,0.059,0.385,0.218,357
distinguish,0.304,132,142,1,1,0.675,0.471,0.6,274
carriage,0.304,92,99,1,1,0.65,0.538,0.491,191
libido,0.304,52,56,1,1,0.77,0.602,0.571,108
feeble,0.304,105,113,1,1,0.157,0.28,0.109,218
notify,0.303,65,70,1,1,0.643,0.471,0.573,135
invariably,0.303,65,70,1,1,0.458,0.365,0.55,135
business,0.303,7160,7704,1,1,0.688,0.569,0.755,14864
inside,0.303,22295,23992,1,1,0.612,0.404,0.472,46287
masks,0.303,352,379,1,1,0.51,0.472,0.241,731
dense,0.303,182,196,1,1,0.354,0.343,0.536,378
fly,0.302,3200,3446,1,1,0.76,0.775,0.676,6646
traverse,0.302,38,41,1,1,0.571,0.59,0.629,79
crediting,0.302,12,13,1,1,0.673,0.55,0.741,25
pose,0.302,285,307,1,1,0.427,0.33,0.361,592
brainless,0.302,103,111,1,1,0.138,0.31,0.224,214
crease,0.302,25,27,1,1,0.44,0.286,0.3,52
stepson,0.302,12,13,1,1,0.614,0.406,0.48,25
conjecture,0.302,25,27,1,1,0.396,0.398,0.534,52
foray,0.302,12,13,1,1,0.418,0.618,0.676,25
annoyin,0.302,25,27,1,1,0.26,0.573,0.352,52
tailgate,0.302,25,27,1,1,0.323,0.34,0.398,52
commie,0.302,77,83,1,1,0.385,0.519,0.454,160
thump,0.302,38,41,1,1,0.28,0.792,0.608,79
tinfoil,0.302,25,27,1,1,0.448,0.284,0.311,52
redness,0.302,12,13,1,1,0.151,0.47,0.417,25
smarten,0.302,12,13,1,1,0.602,0.49,0.551,25
psychosomatic,0.302,12,13,1,1,0.25,0.58,0.473,25
deadlock,0.302,12,13,1,1,0.17,0.418,0.323,25
architectural,0.302,12,13,1,1,0.729,0.39,0.67,25
narcotic,0.302,12,13,1,1,0.102,0.858,0.45,25
adherence,0.302,25,27,1,1,0.76,0.307,0.63,52
lyrics,0.302,5103,5496,1,1,0.582,0.214,0.333,10599
repetitive,0.302,232,250,1,1,0.32,0.438,0.362,482
haircut,0.302,206,222,1,1,0.677,0.343,0.307,428
impulse,0.302,283,305,1,1,0.53,0.84,0.611,588
ruby,0.302,360,388,1,1,0.663,0.408,0.544,748
productivity,0.302,231,249,1,1,0.958,0.691,0.857,480
comment,0.301,3794,4089,1,1,0.667,0.417,0.379,7883
orange,0.301,1578,1701,1,1,0.646,0.132,0.296,3279
laurel,0.301,63,68,1,1,0.646,0.146,0.302,131
insightful,0.301,242,261,1,1,0.664,0.691,0.713,503
harry,0.301,2296,2476,1,1,0.52,0.409,0.39,4772
invoke,0.301,50,54,1,1,0.583,0.74,0.579,104
unreachable,0.301,101,109,1,1,0.208,0.679,0.557,210
marbles,0.3,75,81,1,1,0.714,0.345,0.241,156
infiltrate,0.3,37,40,1,1,0.408,0.745,0.587,77
denial,0.3,721,778,1,1,0.194,0.435,0.318,1499
crest,0.3,37,40,1,1,0.458,0.333,0.333,77
poser,0.3,37,40,1,1,0.469,0.385,0.316,77
crocodile,0.3,75,81,1,1,0.344,0.708,0.61,156
custom,0.3,214,231,1,1,0.552,0.382,0.688,445
movies,0.3,7775,8390,1,1,0.724,0.426,0.472,16165
chemical,0.3,315,340,1,1,0.337,0.56,0.508,655
chime,0.3,100,108,1,1,0.573,0.541,0.464,208
recommendation,0.3,201,217,1,1,0.912,0.388,0.664,418
generate,0.3,125,135,1,1,0.771,0.423,0.772,260
annual,0.3,427,461,1,1,0.552,0.236,0.5,888
mop,0.3,112,121,1,1,0.396,0.442,0.296,233
gym,0.299,3175,3429,1,1,0.635,0.69,0.613,6604
hissing,0.299,49,53,1,1,0.5,0.454,0.4,102
standstill,0.299,24,26,1,1,0.441,0.203,0.5,50
promoter,0.299,24,26,1,1,0.646,0.573,0.817,50
four,0.299,3767,4070,1,1,0.552,0.28,0.383,7837
match,0.299,2722,2941,1,1,0.599,0.573,0.5,5663
imposing,0.299,61,66,1,1,0.392,0.731,0.836,127
coincidence,0.299,370,400,1,1,0.612,0.45,0.518,770
calmness,0.299,172,186,1,1,0.934,0.105,0.394,358
victor,0.298,246,266,1,1,0.802,0.587,0.796,512
alphabet,0.298,73,79,1,1,0.562,0.204,0.672,152
lagging,0.298,36,39,1,1,0.135,0.538,0.277,75
pretend,0.298,5421,5861,1,1,0.49,0.528,0.542,11282
promote,0.298,738,798,1,1,0.83,0.596,0.853,1536
call,0.298,38816,41968,1,1,0.594,0.627,0.558,80784
gold,0.298,2210,2390,1,1,0.939,0.686,0.692,4600
funny,0.298,12807,13852,1,1,0.918,0.61,0.566,26659
unwanted,0.298,3336,3609,1,1,0.177,0.546,0.205,6945
explosive,0.298,60,65,1,1,0.156,0.943,0.663,125
dread,0.297,1301,1408,1,1,0.153,0.792,0.368,2709
sever,0.297,72,78,1,1,0.156,0.635,0.451,150
desiring,0.297,84,91,1,1,0.814,0.821,0.632,175
hawk,0.297,108,117,1,1,0.583,0.53,0.631,225
reed,0.297,120,130,1,1,0.49,0.35,0.307,250
overall,0.297,1337,1448,1,1,0.583,0.37,0.67,2785
feast,0.297,240,260,1,1,0.979,0.724,0.68,500
boogeyman,0.296,23,25,1,1,0.292,0.559,0.567,48
combative,0.296,23,25,1,1,0.381,0.69,0.816,48
garner,0.296,71,77,1,1,0.479,0.46,0.5,148
dichotomy,0.296,71,77,1,1,0.323,0.482,0.483,148
campsite,0.296,23,25,1,1,0.68,0.49,0.547,48
gentleness,0.296,47,51,1,1,0.927,0.278,0.447,98
oily,0.296,35,38,1,1,0.276,0.533,0.385,73
saving,0.296,2118,2295,1,1,0.663,0.23,0.621,4413
choir,0.296,298,323,1,1,0.704,0.298,0.473,621
grant,0.296,678,735,1,1,0.719,0.38,0.667,1413
acting,0.296,4179,4530,1,1,0.698,0.643,0.5,8709
poof,0.296,118,128,1,1,0.469,0.387,0.21,246
barks,0.296,118,128,1,1,0.427,0.694,0.325,246
down,0.295,65680,71216,1,1,0.208,0.33,0.264,136896
ruth,0.295,248,269,1,1,0.469,0.427,0.444,517
workload,0.295,70,76,1,1,0.231,0.792,0.49,146
twelve,0.295,247,268,1,1,0.49,0.298,0.412,515
lounging,0.295,58,63,1,1,0.735,0.167,0.449,121
pas,0.295,223,242,1,1,0.49,0.344,0.262,465
distinct,0.295,164,178,1,1,0.542,0.578,0.509,342
dim,0.295,623,676,1,1,0.398,0.321,0.273,1299
lunatic,0.295,293,318,1,1,0.125,0.792,0.442,611
taunt,0.295,46,50,1,1,0.083,0.696,0.355,96
hustle,0.295,433,470,1,1,0.406,0.661,0.427,903
commonly,0.294,116,126,1,1,0.604,0.17,0.574,242
master,0.294,1870,2030,1,1,0.694,0.49,0.849,3900
ginger,0.294,303,329,1,1,0.406,0.375,0.316,632
poltergeist,0.294,34,37,1,1,0.271,0.784,0.544,71
addictive,0.294,640,695,1,1,0.302,0.683,0.472,1335
artists,0.294,1831,1989,1,1,0.796,0.667,0.741,3820
industrial,0.294,138,150,1,1,0.469,0.6,0.875,288
brilliance,0.293,103,112,1,1,0.99,0.673,0.83,215
field,0.293,2217,2409,1,1,0.64,0.38,0.336,4626
art,0.293,7137,7756,1,1,0.812,0.36,0.603,14893
simmering,0.293,22,24,1,1,0.382,0.613,0.412,46
psyche,0.293,206,224,1,1,0.427,0.375,0.435,430
endorsement,0.293,68,74,1,1,0.834,0.36,0.611,142
cornfield,0.293,22,24,1,1,0.719,0.31,0.349,46
outlandish,0.293,45,49,1,1,0.448,0.737,0.657,94
hamlet,0.293,68,74,1,1,0.573,0.27,0.397,142
symptomatic,0.293,22,24,1,1,0.367,0.434,0.491,46
harmonize,0.293,22,24,1,1,0.939,0.461,0.609,46
scroll,0.293,651,708,1,1,0.375,0.63,0.409,1359
infectious,0.292,79,86,1,1,0.142,0.76,0.422,165
measure,0.292,616,670,1,1,0.51,0.375,0.365,1286
warp,0.292,56,61,1,1,0.344,0.417,0.373,117
picked,0.292,1994,2169,1,1,0.74,0.518,0.67,4163
stunt,0.292,238,259,1,1,0.387,0.555,0.526,497
boast,0.292,90,98,1,1,0.52,0.586,0.569,188
mischief,0.292,90,98,1,1,0.385,0.834,0.292,188
epiphany,0.292,306,333,1,1,0.625,0.596,0.526,639
tangerine,0.292,33,36,1,1,0.571,0.271,0.395,69
makeover,0.292,33,36,1,1,0.771,0.51,0.596,69
mare,0.292,101,110,1,1,0.541,0.32,0.417,211
seventy,0.292,33,36,1,1,0.625,0.353,0.446,69
snowstorm,0.291,44,48,1,1,0.204,0.833,0.629,92
calculate,0.291,89,97,1,1,0.49,0.452,0.44,186
vulgar,0.291,89,97,1,1,0.083,0.82,0.445,186
image,0.291,2078,2263,1,1,0.653,0.241,0.453,4341
bloody,0.291,1446,1575,1,1,0.031,0.91,0.518,3021
consenting,0.291,55,60,1,1,0.727,0.406,0.693,115
kin,0.291,234,255,1,1,0.543,0.441,0.457,489
maker,0.291,424,462,1,1,0.698,0.544,0.706,886
strife,0.291,122,133,1,1,0.344,0.898,0.63,255
moron,0.291,792,863,1,1,0.133,0.587,0.183,1655
realm,0.291,490,534,1,1,0.708,0.509,0.878,1024
imperfection,0.29,77,84,1,1,0.19,0.567,0.321,161
broad,0.29,389,424,1,1,0.762,0.365,0.637,813
giant,0.29,1481,1614,1,1,0.646,0.814,0.963,3095
greeting,0.29,277,302,1,1,0.854,0.556,0.51,579
stem,0.29,288,314,1,1,0.615,0.191,0.336,602
catastrophe,0.29,99,108,1,1,0.146,0.952,0.67,207
humiliate,0.29,99,108,1,1,0.052,0.714,0.275,207
inferior,0.29,220,240,1,1,0.26,0.254,0.106,460
trick,0.29,1058,1154,1,1,0.542,0.7,0.409,2212
friday,0.289,6788,7404,1,1,0.624,0.411,0.341,14192
profess,0.289,54,59,1,1,0.633,0.42,0.643,113
deafness,0.289,21,23,1,1,0.125,0.413,0.219,44
worn,0.289,593,647,1,1,0.35,0.482,0.189,1240
unmitigated,0.289,21,23,1,1,0.649,0.427,0.422,44
template,0.289,43,47,1,1,0.479,0.311,0.411,90
unidentified,0.289,32,35,1,1,0.385,0.361,0.199,67
groundhog,0.289,32,35,1,1,0.385,0.324,0.377,67
grain,0.289,164,179,1,1,0.39,0.198,0.302,343
pubes,0.289,21,23,1,1,0.49,0.513,0.349,44
fore,0.289,87,95,1,1,0.667,0.417,0.654,182
savagery,0.289,21,23,1,1,0.219,0.907,0.711,44
bal,0.289,32,35,1,1,0.49,0.412,0.432,67
yeahhhh,0.289,87,95,1,1,0.865,0.721,0.44,182
handheld,0.289,21,23,1,1,0.646,0.35,0.586,44
smashed,0.289,196,214,1,1,0.143,0.66,0.256,410
hating,0.289,2875,3138,1,1,0.083,0.82,0.434,6013
universal,0.289,762,832,1,1,0.802,0.417,0.833,1594
repeat,0.289,2822,3081,1,1,0.49,0.529,0.552,5903
attribute,0.288,86,94,1,1,0.781,0.439,0.795,180
cheap,0.288,1233,1347,1,1,0.612,0.471,0.272,2580
summary,0.288,237,259,1,1,0.729,0.26,0.427,496
grade,0.288,1773,1937,1,1,0.698,0.36,0.6,3710
dynamics,0.288,161,176,1,1,0.745,0.682,0.774,337
ball,0.288,2295,2508,1,1,0.74,0.427,0.317,4803
friction,0.287,42,46,1,1,0.271,0.778,0.534,88
stellar,0.287,128,140,1,1,0.796,0.58,0.769,268
succession,0.287,42,46,1,1,0.698,0.481,0.587,88
withdrawals,0.287,85,93,1,1,0.427,0.404,0.464,178
partition,0.287,42,46,1,1,0.615,0.469,0.567,88
elementary,0.287,396,433,1,1,0.594,0.286,0.686,829
wishful,0.287,117,128,1,1,0.885,0.712,0.606,245
controller,0.287,149,163,1,1,0.469,0.712,0.868,312
sip,0.287,545,596,1,1,0.375,0.38,0.213,1141
recreate,0.287,106,116,1,1,0.724,0.545,0.616,222
decline,0.287,448,490,1,1,0.173,0.491,0.24,938
unlucky,0.287,266,291,1,1,0.073,0.395,0.198,557
thousand,0.287,2135,2335,1,1,0.663,0.355,0.48,4470
ominous,0.287,95,104,1,1,0.255,0.73,0.51,199
rigorous,0.287,31,34,1,1,0.438,0.818,0.847,65
soar,0.287,159,174,1,1,0.79,0.74,0.718,333
compel,0.287,31,34,1,1,0.2,0.847,0.625,65
handbook,0.287,31,34,1,1,0.6,0.224,0.567,65
fortune,0.286,488,534,1,1,0.926,0.731,0.873,1022
concept,0.286,2220,2429,1,1,0.573,0.265,0.632,4649
tighten,0.286,84,92,1,1,0.388,0.487,0.627,176
neck,0.286,1846,2020,1,1,0.541,0.245,0.345,3866
edible,0.286,105,115,1,1,0.75,0.425,0.497,220
marker,0.286,73,80,1,1,0.5,0.333,0.605,153
shooting,0.286,1115,1221,1,1,0.276,0.931,0.602,2336
introspection,0.286,199,218,1,1,0.603,0.337,0.575,417
default,0.286,420,460,1,1,0.459,0.343,0.712,880
roast,0.286,304,333,1,1,0.521,0.541,0.311,637
privilege,0.285,1040,1139,1,1,0.847,0.625,0.821,2179
malady,0.285,20,22,1,1,0.19,0.686,0.304,42
shear,0.285,20,22,1,1,0.286,0.647,0.388,42
akin,0.285,188,206,1,1,0.639,0.343,0.523,394
tasty,0.285,188,206,1,1,0.959,0.786,0.555,394
daydreaming,0.285,209,229,1,1,0.776,0.36,0.479,438
treble,0.285,20,22,1,1,0.358,0.471,0.466,42
naval,0.285,41,45,1,1,0.542,0.449,0.679,86
cheerleading,0.285,20,22,1,1,0.698,0.769,0.404,42
adept,0.285,41,45,1,1,0.594,0.539,0.789,86
deceived,0.285,177,194,1,1,0.059,0.673,0.302,371
bases,0.285,135,148,1,1,0.569,0.236,0.591,283
unbalanced,0.285,72,79,1,1,0.302,0.596,0.343,151
dimension,0.285,280,307,1,1,0.592,0.415,0.627,587
overwhelming,0.285,3088,3385,1,1,0.327,0.83,0.64,6473
prop,0.285,155,170,1,1,0.51,0.427,0.436,325
ant,0.284,300,329,1,1,0.448,0.216,0.216,629
surprisingly,0.284,559,613,1,1,0.847,0.793,0.819,1172
circle,0.284,2674,2932,1,1,0.48,0.29,0.343,5606
evident,0.284,227,249,1,1,0.633,0.444,0.664,476
shed,0.284,1148,1259,1,1,0.427,0.402,0.47,2407
inning,0.284,30,33,1,1,0.602,0.315,0.52,63
simulation,0.284,154,169,1,1,0.552,0.574,0.567,323
prologue,0.284,30,33,1,1,0.571,0.392,0.546,63
thrash,0.284,30,33,1,1,0.26,0.51,0.472,63
caucus,0.284,61,67,1,1,0.418,0.311,0.491,128
primer,0.284,30,33,1,1,0.625,0.363,0.688,63
bridesmaid,0.284,30,33,1,1,0.748,0.519,0.618,63
erase,0.284,556,610,1,1,0.24,0.26,0.321,1166
simplicity,0.284,133,146,1,1,0.667,0.25,0.337,279
participation,0.283,112,123,1,1,0.781,0.7,0.702,235
homemade,0.283,194,213,1,1,0.869,0.34,0.398,407
offering,0.283,994,1091,1,1,0.688,0.462,0.585,2085
bike,0.283,758,832,1,1,0.708,0.5,0.333,1590
vanguard,0.283,40,44,1,1,0.693,0.64,0.78,84
railing,0.283,40,44,1,1,0.551,0.298,0.44,84
imply,0.283,204,224,1,1,0.542,0.67,0.533,428
full,0.283,25794,28314,1,1,0.602,0.255,0.704,54108
assistant,0.283,367,403,1,1,0.625,0.39,0.536,770
enhance,0.283,142,156,1,1,0.802,0.578,0.814,298
premises,0.283,50,55,1,1,0.5,0.306,0.285,105
elder,0.283,376,413,1,1,0.448,0.153,0.462,789
chronic,0.283,1791,1967,1,1,0.255,0.615,0.464,3758
sheriff,0.283,111,122,1,1,0.602,0.541,0.802,233
mow,0.283,60,66,1,1,0.42,0.559,0.393,126
useless,0.282,3627,3984,1,1,0.052,0.342,0.184,7611
sour,0.282,375,412,1,1,0.276,0.594,0.373,787
delve,0.282,70,77,1,1,0.469,0.529,0.684,147
haunted,0.282,1256,1380,1,1,0.264,0.731,0.52,2636
leopard,0.282,90,99,1,1,0.542,0.755,0.611,189
backyard,0.282,302,332,1,1,0.552,0.28,0.302,634
boxing,0.282,311,342,1,1,0.427,0.854,0.645,653
immigrant,0.282,331,364,1,1,0.357,0.663,0.509,695
sensation,0.281,381,419,1,1,0.781,0.663,0.673,800
quote,0.281,2368,2604,1,1,0.68,0.55,0.43,4972
dangle,0.281,19,21,1,1,0.362,0.469,0.375,40
coincidental,0.281,19,21,1,1,0.646,0.481,0.337,40
lingo,0.281,39,43,1,1,0.448,0.364,0.447,82
flurry,0.281,19,21,1,1,0.302,0.76,0.559,40
snuff,0.281,59,65,1,1,0.357,0.47,0.377,124
humid,0.281,49,54,1,1,0.375,0.324,0.366,103
vexed,0.281,19,21,1,1,0.115,0.802,0.413,40
sentry,0.281,19,21,1,1,0.47,0.547,0.684,40
circling,0.281,99,109,1,1,0.51,0.654,0.336,208
gahhh,0.281,19,21,1,1,0.323,0.557,0.278,40
hairless,0.281,29,32,1,1,0.136,0.235,0.139,61
hanky,0.281,19,21,1,1,0.46,0.276,0.25,40
talkative,0.281,338,372,1,1,0.562,0.673,0.535,710
frame,0.281,646,711,1,1,0.469,0.333,0.42,1357
dark,0.281,27481,30244,1,1,0.198,0.398,0.426,57725
cup,0.28,2434,2679,1,1,0.615,0.167,0.231,5113
risk,0.28,3556,3914,1,1,0.24,0.816,0.438,7470
curling,0.28,138,152,1,1,0.583,0.592,0.4,290
greet,0.28,603,664,1,1,0.885,0.539,0.618,1267
brain,0.28,10441,11496,1,1,0.667,0.441,0.823,21937
comical,0.28,88,97,1,1,0.844,0.737,0.327,185
undefeated,0.28,78,86,1,1,0.833,0.752,0.825,164
drenched,0.28,147,162,1,1,0.302,0.361,0.388,309
branch,0.279,412,454,1,1,0.538,0.206,0.25,866
colony,0.279,117,129,1,1,0.716,0.353,0.593,246
tape,0.279,559,616,1,1,0.531,0.277,0.254,1175
upcoming,0.279,705,777,1,1,0.688,0.46,0.55,1482
patrol,0.279,204,225,1,1,0.427,0.664,0.736,429
marked,0.279,243,268,1,1,0.592,0.358,0.554,511
heartless,0.279,711,784,1,1,0.071,0.652,0.4,1495
adoptive,0.279,77,85,1,1,0.531,0.469,0.52,162
sordid,0.279,38,42,1,1,0.219,0.555,0.447,80
insufficient,0.279,77,85,1,1,0.188,0.38,0.093,162
humble,0.279,1081,1192,1,1,0.867,0.236,0.483,2273
cheek,0.279,964,1063,1,1,0.67,0.314,0.421,2027
suddenly,0.279,8248,9095,1,1,0.67,0.51,0.456,17343
bucket,0.278,425,469,1,1,0.408,0.167,0.336,894
royal,0.278,502,554,1,1,0.796,0.43,0.759,1056
motel,0.278,260,287,1,1,0.531,0.372,0.45,547
sponsorship,0.278,28,31,1,1,0.854,0.608,0.696,59
ploy,0.278,86,95,1,1,0.458,0.559,0.741,181
prejudiced,0.278,28,31,1,1,0.235,0.625,0.345,59
refrain,0.278,202,223,1,1,0.314,0.373,0.277,425
fourteen,0.277,76,84,1,1,0.552,0.279,0.308,160
spontaneous,0.277,201,222,1,1,0.78,0.578,0.655,423
drink,0.277,9145,10096,1,1,0.65,0.552,0.474,19241
hooked,0.277,489,540,1,1,0.61,0.661,0.454,1029
meditative,0.277,47,52,1,1,0.614,0.12,0.454,99
inhabited,0.277,47,52,1,1,0.667,0.361,0.51,99
intimately,0.277,114,126,1,1,0.806,0.573,0.59,240
bake,0.277,449,496,1,1,0.867,0.418,0.519,945
integrate,0.277,66,73,1,1,0.729,0.39,0.7,139
noun,0.277,85,94,1,1,0.531,0.23,0.477,179
humiliating,0.277,190,210,1,1,0.062,0.716,0.279,400
lunch,0.277,4472,4941,1,1,0.88,0.41,0.542,9413
revisit,0.277,142,157,1,1,0.552,0.53,0.509,299
click,0.276,978,1081,1,1,0.536,0.365,0.268,2059
glorification,0.276,18,20,1,1,0.821,0.541,0.817,38
individuality,0.276,170,188,1,1,0.612,0.469,0.527,358
ocarina,0.276,18,20,1,1,0.541,0.392,0.366,38
cheque,0.276,37,41,1,1,0.698,0.529,0.66,78
brad,0.276,246,272,1,1,0.49,0.385,0.402,518
shithead,0.276,94,104,1,1,0.12,0.645,0.302,198
cruiser,0.276,18,20,1,1,0.737,0.49,0.608,38
infrequently,0.276,18,20,1,1,0.204,0.25,0.327,38
ingenuity,0.276,18,20,1,1,0.708,0.59,0.868,38
number,0.276,7828,8655,1,1,0.406,0.231,0.471,16483
perform,0.276,936,1035,1,1,0.765,0.555,0.773,1971
card,0.276,2230,2466,1,1,0.531,0.269,0.436,4696
wig,0.276,348,385,1,1,0.722,0.279,0.18,733
rife,0.276,65,72,1,1,0.57,0.561,0.692,137
bomb,0.275,903,999,1,1,0.167,0.912,0.75,1902
shit,0.275,82170,90921,1,1,0,0.678,0.294,173091
bet,0.275,5945,6579,1,1,0.385,0.698,0.432,12524
principal,0.275,177,196,1,1,0.65,0.353,0.709,373
study,0.275,3449,3818,1,1,0.653,0.361,0.768,7267
roost,0.275,27,30,1,1,0.5,0.41,0.345,57
hallowed,0.275,27,30,1,1,0.74,0.5,0.728,57
neatly,0.275,55,61,1,1,0.802,0.412,0.588,116
zit,0.275,27,30,1,1,0.337,0.41,0.381,57
madden,0.275,55,61,1,1,0.329,0.602,0.457,116
squint,0.275,27,30,1,1,0.385,0.461,0.452,57
trek,0.274,288,319,1,1,0.469,0.53,0.535,607
bees,0.274,260,288,1,1,0.562,0.635,0.412,548
significant,0.274,2850,3156,1,1,0.827,0.649,0.786,6006
brook,0.274,92,102,1,1,0.594,0.347,0.412,194
sixteen,0.274,129,143,1,1,0.583,0.29,0.324,272
homeland,0.274,101,112,1,1,0.663,0.439,0.868,213
rebuke,0.274,101,112,1,1,0.115,0.677,0.429,213
deserted,0.274,564,625,1,1,0.156,0.48,0.214,1189
hip,0.274,610,676,1,1,0.448,0.415,0.345,1286
challenger,0.274,36,40,1,1,0.417,0.755,0.652,76
sacrificial,0.274,36,40,1,1,0.198,0.755,0.452,76
goofball,0.274,36,40,1,1,0.561,0.55,0.382,76
prison,0.273,3375,3741,1,1,0.112,0.677,0.491,7116
legs,0.273,1447,1604,1,1,0.479,0.407,0.228,3051
lily,0.273,497,551,1,1,0.64,0.245,0.263,1048
niche,0.273,229,254,1,1,0.459,0.413,0.318,483
marketplace,0.273,45,50,1,1,0.698,0.42,0.525,95
deport,0.273,54,60,1,1,0.167,0.667,0.546,114
fin,0.273,173,192,1,1,0.333,0.34,0.377,365
thief,0.273,292,324,1,1,0.088,0.888,0.443,616
buddha,0.273,127,141,1,1,0.69,0.198,0.604,268
stolen,0.272,721,800,1,1,0.156,0.646,0.308,1521
sociable,0.272,355,394,1,1,0.854,0.459,0.627,749
electric,0.272,574,637,1,1,0.458,0.708,0.512,1211
roll,0.271,2343,2603,1,1,0.469,0.51,0.172,4946
communication,0.271,1476,1640,1,1,0.837,0.4,0.649,3116
grownup,0.271,35,39,1,1,0.735,0.4,0.683,74
paddy,0.271,62,69,1,1,0.653,0.33,0.33,131
confessional,0.271,35,39,1,1,0.458,0.392,0.629,74
archaeology,0.271,17,19,1,1,0.596,0.358,0.691,36
vowel,0.271,17,19,1,1,0.49,0.283,0.311,36
fizz,0.271,26,29,1,1,0.459,0.708,0.349,55
amnesia,0.271,143,159,1,1,0.296,0.33,0.308,302
providence,0.271,53,59,1,1,0.603,0.337,0.755,112
shuddering,0.271,17,19,1,1,0.302,0.802,0.638,36
drowsy,0.271,26,29,1,1,0.375,0.18,0.24,55
defendant,0.271,17,19,1,1,0.25,0.71,0.491,36
lieutenant,0.271,35,39,1,1,0.594,0.612,0.92,74
clearance,0.271,71,79,1,1,0.542,0.459,0.473,150
sardine,0.271,17,19,1,1,0.541,0.236,0.236,36
underbelly,0.271,17,19,1,1,0.406,0.423,0.361,36
foyer,0.271,17,19,1,1,0.552,0.37,0.443,36
elicit,0.271,26,29,1,1,0.406,0.594,0.658,55
condensed,0.271,17,19,1,1,0.598,0.415,0.623,36
ska,0.271,35,39,1,1,0.458,0.575,0.245,74
dimwit,0.271,26,29,1,1,0.255,0.459,0.175,55
euphemism,0.271,35,39,1,1,0.418,0.453,0.491,74
cynicism,0.27,106,118,1,1,0.104,0.78,0.454,224
battered,0.27,106,118,1,1,0.08,0.79,0.306,224
singing,0.27,6267,6970,1,1,0.885,0.594,0.528,13237
swiftly,0.27,97,108,1,1,0.66,0.885,0.618,205
beating,0.27,1350,1502,1,1,0.153,0.833,0.481,2852
argue,0.27,1304,1451,1,1,0.093,0.798,0.525,2755
actual,0.27,4242,4720,1,1,0.729,0.4,0.716,8962
publisher,0.27,70,78,1,1,0.571,0.392,0.691,148
guru,0.269,132,147,1,1,0.573,0.36,0.653,279
twist,0.269,787,876,1,1,0.375,0.469,0.337,1663
sitcom,0.269,52,58,1,1,0.562,0.537,0.407,110
missile,0.269,52,58,1,1,0.24,0.83,0.764,110
age,0.269,11354,12644,1,1,0.561,0.226,0.498,23998
soccer,0.269,386,430,1,1,0.698,0.837,0.644,816
apple,0.269,1150,1281,1,1,0.811,0.3,0.264,2431
overlap,0.268,78,87,1,1,0.594,0.615,0.627,165
publication,0.268,104,116,1,1,0.549,0.47,0.6,220
nape,0.268,34,38,1,1,0.427,0.268,0.298,72
oneness,0.268,104,116,1,1,0.745,0.272,0.72,220
hostess,0.268,34,38,1,1,0.792,0.604,0.688,72
magnet,0.268,130,145,1,1,0.571,0.318,0.553,275
fusion,0.268,95,106,1,1,0.635,0.561,0.741,201
packet,0.268,95,106,1,1,0.582,0.385,0.407,201
kind,0.268,29642,33042,1,1,0.918,0.24,0.618,62684
knuckle,0.268,60,67,1,1,0.655,0.333,0.393,127
cycle,0.268,2000,2230,1,1,0.635,0.4,0.533,4230
stash,0.268,86,96,1,1,0.344,0.63,0.361,182
breeze,0.267,1102,1229,1,1,0.837,0.284,0.37,2331
funnel,0.267,25,28,1,1,0.354,0.274,0.336,53
simulated,0.267,25,28,1,1,0.5,0.461,0.356,53
inland,0.267,25,28,1,1,0.51,0.417,0.423,53
dainty,0.267,25,28,1,1,0.604,0.284,0.424,53
streetlight,0.267,25,28,1,1,0.673,0.268,0.39,53
brightness,0.267,120,134,1,1,0.938,0.623,0.66,254
ram,0.267,206,230,1,1,0.406,0.452,0.388,436
acre,0.266,42,47,1,1,0.583,0.387,0.423,89
youngster,0.266,42,47,1,1,0.796,0.557,0.661,89
collar,0.266,205,229,1,1,0.656,0.442,0.446,434
addict,0.266,530,592,1,1,0.075,0.696,0.327,1122
rotting,0.266,255,285,1,1,0.188,0.462,0.255,540
lucky,0.265,6293,7032,1,1,0.96,0.61,0.793,13325
infrequent,0.265,16,18,1,1,0.312,0.377,0.192,34
genitalia,0.265,33,37,1,1,0.323,0.667,0.5,70
proclamation,0.265,16,18,1,1,0.708,0.767,0.871,34
gland,0.265,16,18,1,1,0.396,0.382,0.467,34
caravan,0.265,135,151,1,1,0.635,0.559,0.455,286
pancreas,0.265,16,18,1,1,0.469,0.302,0.366,34
hap,0.265,16,18,1,1,0.503,0.431,0.453,34
dissolution,0.265,16,18,1,1,0.204,0.464,0.349,34
permitting,0.265,16,18,1,1,0.724,0.481,0.661,34
granite,0.265,33,37,1,1,0.572,0.343,0.483,70
annex,0.265,16,18,1,1,0.594,0.35,0.458,34
nappy,0.265,33,37,1,1,0.529,0.333,0.207,70
unqualified,0.265,67,75,1,1,0.17,0.433,0.173,142
disciple,0.265,50,56,1,1,0.765,0.385,0.462,106
weeeee,0.265,16,18,1,1,0.562,0.63,0.283,34
yogi,0.265,50,56,1,1,0.653,0.347,0.349,106
mythic,0.265,16,18,1,1,0.635,0.528,0.645,34
rendering,0.265,50,56,1,1,0.531,0.434,0.667,106
firstborn,0.265,16,18,1,1,0.786,0.49,0.695,34
cantaloupe,0.265,16,18,1,1,0.592,0.212,0.276,34
subway,0.265,381,426,1,1,0.418,0.3,0.464,807
recommend,0.265,2155,2409,1,1,0.812,0.439,0.672,4564
stack,0.265,330,369,1,1,0.47,0.282,0.427,699
hundred,0.265,1102,1232,1,1,0.604,0.37,0.406,2334
ranting,0.265,567,634,1,1,0.181,0.755,0.5,1201
rank,0.265,304,340,1,1,0.531,0.38,0.686,644
butt,0.265,1394,1559,1,1,0.347,0.725,0.336,2953
fascinated,0.265,185,207,1,1,0.812,0.714,0.788,392
barb,0.264,75,84,1,1,0.448,0.365,0.417,159
tug,0.264,151,169,1,1,0.32,0.604,0.558,320
delete,0.264,1913,2140,1,1,0.292,0.298,0.409,4053
series,0.264,3590,4016,1,1,0.622,0.431,0.42,7606
explosions,0.264,58,65,1,1,0.123,0.86,0.594,123
imitate,0.264,58,65,1,1,0.469,0.561,0.336,123
gibberish,0.264,58,65,1,1,0.375,0.51,0.36,123
village,0.264,1108,1240,1,1,0.684,0.367,0.336,2348
beater,0.264,41,46,1,1,0.438,0.545,0.482,87
fiat,0.264,41,46,1,1,0.52,0.418,0.446,87
targeting,0.264,192,215,1,1,0.51,0.42,0.58,407
commute,0.264,326,365,1,1,0.622,0.582,0.565,691
whipped,0.264,284,318,1,1,0.198,0.804,0.361,602
wound,0.264,527,590,1,1,0.15,0.717,0.31,1117
habitual,0.264,66,74,1,1,0.527,0.208,0.49,140
bent,0.263,292,327,1,1,0.375,0.453,0.298,619
classical,0.263,158,177,1,1,0.643,0.198,0.536,335
agitated,0.263,116,130,1,1,0.444,0.882,0.491,246
physical,0.263,4412,4941,1,1,0.75,0.52,0.607,9353
magic,0.263,2566,2874,1,1,0.868,0.663,0.578,5440
tyrant,0.263,124,139,1,1,0.115,0.85,0.683,263
brainwash,0.263,49,55,1,1,0.198,0.647,0.481,104
cremation,0.263,24,27,1,1,0.084,0.62,0.42,51
goober,0.263,24,27,1,1,0.469,0.444,0.342,51
headstrong,0.263,24,27,1,1,0.31,0.714,0.5,51
catch,0.263,4870,5455,1,1,0.531,0.437,0.552,10325
regret,0.263,4268,4781,1,1,0.23,0.623,0.331,9049
panel,0.263,473,530,1,1,0.469,0.321,0.425,1003
human,0.263,18799,21060,1,1,0.767,0.314,0.605,39859
explosion,0.263,107,120,1,1,0.167,0.96,0.767,227
dynasty,0.263,107,120,1,1,0.725,0.588,0.936,227
psychic,0.262,256,287,1,1,0.49,0.559,0.726,543
erratic,0.262,57,64,1,1,0.271,0.503,0.217,121
school,0.262,25669,28770,1,1,0.765,0.423,0.633,54439
suppress,0.262,255,286,1,1,0.281,0.559,0.509,541
artwork,0.262,255,286,1,1,0.896,0.368,0.679,541
scoff,0.262,65,73,1,1,0.125,0.686,0.306,138
sufficiency,0.262,32,36,1,1,0.594,0.438,0.576,68
jive,0.262,32,36,1,1,0.561,0.551,0.373,68
sushi,0.262,378,424,1,1,0.698,0.343,0.394,802
shut,0.262,7211,8088,1,1,0.24,0.352,0.311,15299
distant,0.261,2150,2412,1,1,0.229,0.324,0.269,4562
burdened,0.261,196,220,1,1,0.429,0.519,0.565,416
annihilation,0.261,40,45,1,1,0.041,0.8,0.591,85
snide,0.261,40,45,1,1,0.186,0.723,0.455,85
galaxy,0.261,777,872,1,1,0.75,0.571,0.75,1649
fantasize,0.261,220,247,1,1,0.771,0.66,0.356,467
meat,0.261,1184,1329,1,1,0.612,0.421,0.413,2513
unspoken,0.261,195,219,1,1,0.177,0.26,0.208,414
keeping,0.261,6140,6892,1,1,0.592,0.28,0.723,13032
midway,0.261,56,63,1,1,0.459,0.316,0.304,119
rectify,0.261,56,63,1,1,0.625,0.48,0.634,119
jay,0.26,771,866,1,1,0.531,0.408,0.389,1637
delicious,0.26,584,656,1,1,0.927,0.65,0.589,1240
screen,0.26,2282,2563,1,1,0.67,0.3,0.417,4845
bound,0.26,998,1121,1,1,0.417,0.667,0.31,2119
babbling,0.26,80,90,1,1,0.396,0.418,0.241,170
adoring,0.26,80,90,1,1,0.885,0.62,0.717,170
lined,0.26,161,181,1,1,0.438,0.367,0.424,342
announce,0.26,500,562,1,1,0.694,0.618,0.611,1062
engine,0.26,209,235,1,1,0.615,0.644,0.676,444
cognitive,0.259,240,270,1,1,0.513,0.401,0.634,510
recipe,0.259,360,405,1,1,0.698,0.271,0.415,765
wasted,0.259,1611,1812,1,1,0.188,0.558,0.259,3423
productive,0.259,2018,2270,1,1,0.847,0.677,0.773,4288
clammy,0.259,15,17,1,1,0.354,0.44,0.236,32
voracious,0.259,15,17,1,1,0.385,0.892,0.694,32
gory,0.259,23,26,1,1,0.14,0.875,0.455,49
huddle,0.259,47,53,1,1,0.604,0.509,0.445,100
jiggle,0.259,15,17,1,1,0.592,0.673,0.518,32
missiles,0.259,31,35,1,1,0.07,0.922,0.83,66
snapper,0.259,15,17,1,1,0.417,0.429,0.245,32
mantis,0.259,31,35,1,1,0.48,0.355,0.421,66
maneuvering,0.259,15,17,1,1,0.635,0.64,0.745,32
amethyst,0.259,23,26,1,1,0.622,0.406,0.517,49
vibrate,0.259,79,89,1,1,0.5,0.698,0.604,168
procedural,0.259,15,17,1,1,0.5,0.45,0.611,32
misrepresentation,0.259,15,17,1,1,0.323,0.618,0.518,32
satin,0.259,55,62,1,1,0.519,0.396,0.481,117
fluidity,0.259,15,17,1,1,0.729,0.51,0.576,32
cubby,0.259,15,17,1,1,0.354,0.385,0.36,32
delegation,0.259,23,26,1,1,0.562,0.431,0.609,49
remit,0.259,15,17,1,1,0.51,0.509,0.473,32
plunder,0.259,15,17,1,1,0.125,0.894,0.574,32
archive,0.259,79,89,1,1,0.438,0.294,0.527,168
venerable,0.259,15,17,1,1,0.708,0.369,0.6,32
morass,0.259,15,17,1,1,0.387,0.348,0.375,32
unpopular,0.258,765,861,1,1,0.073,0.441,0.164,1626
sweet,0.258,9787,11015,1,1,0.668,0.418,0.382,20802
helpless,0.258,2595,2921,1,1,0.104,0.42,0.214,5516
middle,0.258,8230,9265,1,1,0.458,0.157,0.3,17495
steady,0.258,651,733,1,1,0.68,0.186,0.763,1384
whoop,0.258,158,178,1,1,0.559,0.481,0.443,336
lens,0.258,158,178,1,1,0.42,0.245,0.472,336
expand,0.258,293,330,1,1,0.792,0.559,0.686,623
recess,0.258,126,142,1,1,0.646,0.51,0.367,268
bing,0.258,110,124,1,1,0.573,0.453,0.415,234
sober,0.258,1822,2052,1,1,0.729,0.216,0.568,3874
dunk,0.257,94,106,1,1,0.406,0.333,0.475,200
butler,0.257,165,186,1,1,0.469,0.225,0.438,351
knob,0.257,78,88,1,1,0.34,0.36,0.272,166
camper,0.257,78,88,1,1,0.573,0.529,0.482,166
holy,0.257,4904,5525,1,1,0.812,0.112,0.69,10429
lasagna,0.257,133,150,1,1,0.719,0.441,0.396,283
volatile,0.257,62,70,1,1,0.323,0.786,0.565,132
view,0.257,4149,4676,1,1,0.896,0.292,0.555,8825
mark,0.257,2892,3260,1,1,0.491,0.231,0.6,6152
anarchist,0.257,54,61,1,1,0.204,0.7,0.759,115
aroma,0.257,54,61,1,1,0.823,0.235,0.442,115
corpus,0.257,54,61,1,1,0.543,0.34,0.49,115
shelter,0.256,1397,1575,1,1,0.704,0.229,0.569,2972
sly,0.256,101,114,1,1,0.573,0.69,0.75,215
humanities,0.256,46,52,1,1,0.729,0.325,0.677,98
chuck,0.256,555,626,1,1,0.542,0.509,0.413,1181
approval,0.256,500,564,1,1,0.854,0.46,0.889,1064
drill,0.256,171,193,1,1,0.25,0.602,0.573,364
reverence,0.256,38,43,1,1,0.643,0.347,0.516,81
robber,0.256,38,43,1,1,0.135,0.772,0.481,81
prerequisite,0.256,38,43,1,1,0.448,0.424,0.482,81
frisky,0.256,38,43,1,1,0.7,0.632,0.525,81
showbiz,0.256,38,43,1,1,0.661,0.713,0.598,81
irresistible,0.256,77,87,1,1,0.823,0.833,0.839,164
steaming,0.256,77,87,1,1,0.592,0.553,0.402,164
stubbornness,0.255,69,78,1,1,0.156,0.673,0.508,147
premise,0.255,170,192,1,1,0.531,0.519,0.517,362
aaaah,0.255,100,113,1,1,0.52,0.636,0.282,213
stew,0.255,162,183,1,1,0.667,0.373,0.25,345
guillotine,0.255,30,34,1,1,0.163,0.817,0.585,64
devastation,0.255,154,174,1,1,0.09,0.904,0.472,328
chipping,0.255,30,34,1,1,0.354,0.452,0.353,64
treacherous,0.255,92,104,1,1,0.112,0.815,0.402,196
disparaging,0.255,30,34,1,1,0.102,0.626,0.411,64
indefensible,0.255,30,34,1,1,0.173,0.647,0.484,64
unresolved,0.255,84,95,1,1,0.135,0.441,0.173,179
book,0.254,11587,13090,1,1,0.802,0.21,0.606,24677
teary,0.254,238,269,1,1,0.167,0.473,0.216,507
air,0.254,5072,5733,1,1,0.708,0.163,0.427,10805
type,0.254,10242,11577,1,1,0.5,0.284,0.364,21819
grail,0.254,45,51,1,1,0.573,0.384,0.566,96
noteworthy,0.254,22,25,1,1,0.704,0.481,0.759,47
strenuous,0.254,22,25,1,1,0.104,0.66,0.481,47
rainbows,0.254,252,285,1,1,0.875,0.517,0.402,537
tasteful,0.254,22,25,1,1,0.918,0.458,0.625,47
prince,0.254,2306,2607,1,1,0.888,0.464,0.87,4913
northern,0.253,435,492,1,1,0.57,0.34,0.472,927
hug,0.253,13752,15552,1,1,0.908,0.427,0.548,29304
instant,0.253,793,897,1,1,0.766,0.454,0.554,1690
rewrite,0.253,144,163,1,1,0.49,0.5,0.434,307
glory,0.253,1296,1466,1,1,0.948,0.735,0.817,2762
aggression,0.253,182,206,1,1,0.094,0.929,0.533,388
prevalent,0.253,197,223,1,1,0.694,0.43,0.669,420
ken,0.253,372,421,1,1,0.438,0.409,0.36,793
collaborate,0.253,136,154,1,1,0.816,0.449,0.559,290
broaden,0.253,37,42,1,1,0.678,0.602,0.61,79
outcast,0.253,788,892,1,1,0.153,0.449,0.353,1680
poke,0.253,219,248,1,1,0.365,0.713,0.475,467
uterus,0.252,90,102,1,1,0.551,0.42,0.51,192
aforementioned,0.252,52,59,1,1,0.49,0.316,0.408,111
hairdresser,0.252,52,59,1,1,0.708,0.509,0.407,111
reproduce,0.252,105,119,1,1,0.823,0.622,0.76,224
yen,0.252,120,136,1,1,0.51,0.435,0.508,256
acceptance,0.252,1284,1454,1,1,0.833,0.287,0.755,2738
fog,0.251,435,493,1,1,0.51,0.213,0.26,928
oomph,0.251,14,16,1,1,0.449,0.613,0.315,30
slanderous,0.251,14,16,1,1,0.057,0.8,0.337,30
modest,0.251,104,118,1,1,0.76,0.13,0.412,222
curator,0.251,14,16,1,1,0.688,0.389,0.688,30
mush,0.251,89,101,1,1,0.5,0.311,0.125,190
migrate,0.251,59,67,1,1,0.415,0.58,0.454,126
flounder,0.251,14,16,1,1,0.711,0.333,0.345,30
instructional,0.251,14,16,1,1,0.698,0.5,0.773,30
physiology,0.251,14,16,1,1,0.521,0.451,0.519,30
plummet,0.251,29,33,1,1,0.302,0.75,0.36,62
unbridled,0.251,29,33,1,1,0.396,0.759,0.448,62
castrate,0.251,14,16,1,1,0.177,0.485,0.519,30
aberrant,0.251,14,16,1,1,0.146,0.765,0.431,30
dust,0.251,1349,1529,1,1,0.344,0.246,0.241,2878
sturgeon,0.251,29,33,1,1,0.417,0.473,0.465,62
chromosome,0.251,14,16,1,1,0.5,0.296,0.548,30
bearing,0.251,239,271,1,1,0.571,0.367,0.474,510
takeoff,0.251,14,16,1,1,0.755,0.884,0.626,30
dastardly,0.251,14,16,1,1,0.208,0.688,0.27,30
incriminating,0.251,14,16,1,1,0.133,0.788,0.5,30
alternate,0.251,306,347,1,1,0.625,0.363,0.589,653
sweetest,0.251,942,1068,1,1,0.959,0.5,0.37,2010
imagine,0.251,15981,18118,1,1,0.759,0.48,0.587,34099
confined,0.251,253,287,1,1,0.286,0.472,0.444,540
micro,0.251,126,143,1,1,0.5,0.27,0.25,269
balm,0.251,96,109,1,1,0.625,0.275,0.414,205
chilled,0.251,178,202,1,1,0.521,0.34,0.482,380
consciousness,0.25,521,591,1,1,0.84,0.483,0.755,1112
afterthought,0.25,66,75,1,1,0.396,0.392,0.349,141
violent,0.25,862,978,1,1,0.112,0.918,0.616,1840
hyena,0.25,51,58,1,1,0.396,0.719,0.464,109
cigar,0.25,88,100,1,1,0.306,0.463,0.346,188
array,0.25,73,83,1,1,0.521,0.396,0.568,156
sustenance,0.25,36,41,1,1,0.82,0.519,0.679,77
broker,0.25,36,41,1,1,0.582,0.462,0.6,77
cynic,0.25,36,41,1,1,0.135,0.632,0.473,77
rationality,0.25,36,41,1,1,0.633,0.51,0.767,77
ewe,0.25,36,41,1,1,0.429,0.216,0.277,77
wake,0.249,10339,11741,1,1,0.7,0.47,0.512,22080
ship,0.249,2613,2968,1,1,0.646,0.5,0.439,5581
welcoming,0.249,573,651,1,1,0.905,0.527,0.636,1224
flows,0.249,234,266,1,1,0.571,0.48,0.434,500
cowardly,0.249,256,291,1,1,0.102,0.385,0.127,547
inclusive,0.249,300,341,1,1,0.604,0.42,0.564,641
opposite,0.249,3197,3633,1,1,0.235,0.545,0.408,6830
risotto,0.248,21,24,1,1,0.802,0.454,0.234,45
disclaimer,0.248,131,149,1,1,0.367,0.571,0.542,280
monochrome,0.248,43,49,1,1,0.312,0.292,0.339,92
ply,0.248,21,24,1,1,0.458,0.32,0.324,45
avalanche,0.248,65,74,1,1,0.265,0.915,0.683,139
dunce,0.248,21,24,1,1,0.188,0.327,0.146,45
degrading,0.248,131,149,1,1,0.031,0.583,0.232,280
kidnapper,0.248,21,24,1,1,0.115,0.906,0.618,45
thx,0.248,1472,1673,1,1,0.562,0.425,0.461,3145
teasing,0.248,314,357,1,1,0.235,0.725,0.352,671
chosen,0.248,1346,1530,1,1,0.865,0.449,0.833,2876
usage,0.248,160,182,1,1,0.646,0.36,0.426,342
entity,0.248,233,265,1,1,0.542,0.402,0.67,498
engaged,0.248,1504,1710,1,1,0.837,0.596,0.849,3214
measured,0.248,145,165,1,1,0.542,0.265,0.578,310
vein,0.248,145,165,1,1,0.347,0.373,0.318,310
lighting,0.248,437,497,1,1,0.765,0.44,0.75,934
adolescence,0.248,174,198,1,1,0.487,0.694,0.444,372
devil,0.248,2128,2420,1,1,0.161,0.9,0.611,4548
lying,0.248,4875,5544,1,1,0.208,0.704,0.317,10419
sapphire,0.248,50,57,1,1,0.77,0.472,0.651,107
checklist,0.248,50,57,1,1,0.561,0.521,0.552,107
hyper,0.248,370,421,1,1,0.542,0.616,0.64,791
fist,0.247,399,454,1,1,0.333,0.686,0.481,853
sage,0.247,188,214,1,1,0.781,0.327,0.693,402
tension,0.247,406,462,1,1,0.304,0.81,0.529,868
temporary,0.247,3122,3552,1,1,0.458,0.415,0.324,6674
analyst,0.247,57,65,1,1,0.604,0.415,0.755,122
oftentimes,0.247,144,164,1,1,0.571,0.5,0.482,308
stint,0.247,57,65,1,1,0.49,0.326,0.342,122
acquisition,0.247,28,32,1,1,0.698,0.509,0.736,60
inventory,0.247,57,65,1,1,0.594,0.463,0.49,122
overrated,0.247,890,1013,1,1,0.312,0.63,0.482,1903
dedicate,0.247,419,477,1,1,0.823,0.431,0.588,896
idol,0.247,1206,1373,1,1,0.684,0.805,0.853,2579
itching,0.247,100,114,1,1,0.208,0.69,0.3,214
doorstep,0.246,136,155,1,1,0.531,0.274,0.391,291
gunshot,0.246,35,40,1,1,0.042,0.953,0.673,75
gloat,0.246,35,40,1,1,0.5,0.637,0.603,75
cinder,0.246,35,40,1,1,0.35,0.26,0.157,75
left,0.246,48040,54716,1,1,0.354,0.37,0.361,102756
flashback,0.246,222,253,1,1,0.265,0.4,0.485,475
oversized,0.246,114,130,1,1,0.552,0.54,0.679,244
company,0.246,33403,38059,1,1,0.906,0.425,0.798,71462
bearer,0.246,42,48,1,1,0.571,0.547,0.676,90
octopus,0.246,85,97,1,1,0.713,0.378,0.411,182
pertinent,0.246,42,48,1,1,0.58,0.333,0.723,90
joking,0.246,1074,1224,1,1,0.776,0.839,0.407,2298
busted,0.246,264,301,1,1,0.204,0.676,0.345,565
innocence,0.246,357,407,1,1,0.802,0.26,0.307,764
mama,0.246,3491,3979,1,1,0.86,0.413,0.728,7470
spent,0.245,8486,9674,1,1,0.296,0.296,0.263,18160
diplomacy,0.245,56,64,1,1,0.74,0.396,0.774,120
dream,0.245,12066,13761,1,1,0.844,0.157,0.328,25827
remark,0.245,120,137,1,1,0.561,0.325,0.716,257
softly,0.245,1790,2042,1,1,0.517,0.206,0.304,3832
gone,0.244,28176,32151,1,1,0.292,0.23,0.19,60327
recap,0.244,91,104,1,1,0.602,0.578,0.667,195
score,0.244,767,876,1,1,0.67,0.388,0.589,1643
neglect,0.244,619,707,1,1,0.045,0.55,0.163,1326
intelligence,0.244,781,892,1,1,0.833,0.587,0.885,1673
elaborate,0.244,161,184,1,1,0.561,0.367,0.68,345
thigh,0.244,168,192,1,1,0.469,0.433,0.588,360
morning,0.243,18991,21691,1,1,0.688,0.235,0.444,40682
nursing,0.243,912,1042,1,1,0.552,0.549,0.653,1954
mention,0.243,3014,3444,1,1,0.562,0.365,0.562,6458
tired,0.243,47675,54478,1,1,0.125,0.317,0.191,102153
scholar,0.243,97,111,1,1,0.694,0.421,0.731,208
paste,0.243,153,175,1,1,0.5,0.556,0.5,328
primrose,0.243,13,15,1,1,0.827,0.23,0.648,28
extravagant,0.243,55,63,1,1,0.72,0.763,0.812,118
eyebrow,0.243,167,191,1,1,0.51,0.198,0.222,358
demeaned,0.243,20,23,1,1,0.271,0.52,0.212,43
configuration,0.243,13,15,1,1,0.54,0.443,0.591,28
recruiter,0.243,27,31,1,1,0.662,0.63,0.69,58
overpass,0.243,27,31,1,1,0.562,0.561,0.565,58
skillet,0.243,41,47,1,1,0.51,0.296,0.345,88
uncomplicated,0.243,13,15,1,1,0.74,0.26,0.453,28
kiosk,0.243,20,23,1,1,0.5,0.286,0.321,43
wrestler,0.243,55,63,1,1,0.52,0.863,0.911,118
pudding,0.243,132,151,1,1,0.75,0.255,0.202,283
obituary,0.243,34,39,1,1,0.188,0.33,0.423,73
bookcase,0.243,13,15,1,1,0.553,0.221,0.49,28
materialize,0.243,20,23,1,1,0.688,0.596,0.728,43
canopy,0.243,34,39,1,1,0.615,0.264,0.398,73
fabricate,0.243,20,23,1,1,0.636,0.491,0.779,43
aggressiveness,0.243,20,23,1,1,0.077,0.913,0.648,43
tombstone,0.243,62,71,1,1,0.204,0.441,0.311,133
grubby,0.243,20,23,1,1,0.156,0.583,0.176,43
rollers,0.243,13,15,1,1,0.49,0.365,0.336,28
disparage,0.243,27,31,1,1,0.092,0.663,0.336,58
unloaded,0.243,13,15,1,1,0.469,0.38,0.331,28
admiring,0.243,167,191,1,1,0.867,0.578,0.629,358
temptress,0.243,13,15,1,1,0.427,0.787,0.667,28
hardheaded,0.243,13,15,1,1,0.156,0.699,0.571,28
recycled,0.243,69,79,1,1,0.561,0.316,0.409,148
prominence,0.243,13,15,1,1,0.706,0.59,0.796,28
hotel,0.243,3788,4330,1,1,0.74,0.37,0.407,8118
sacrifices,0.242,452,517,1,1,0.281,0.717,0.538,969
desire,0.242,3719,4253,1,1,0.896,0.692,0.647,7972
android,0.242,396,453,1,1,0.663,0.436,0.5,849
jersey,0.242,493,564,1,1,0.594,0.317,0.411,1057
dynamic,0.242,326,373,1,1,0.724,0.75,0.836,699
suffice,0.242,152,174,1,1,0.643,0.326,0.504,326
rotation,0.242,152,174,1,1,0.67,0.52,0.55,326
imagined,0.242,854,977,1,1,0.656,0.412,0.418,1831
script,0.242,402,460,1,1,0.61,0.45,0.527,862
dodging,0.242,110,126,1,1,0.396,0.654,0.382,236
clip,0.242,810,927,1,1,0.438,0.31,0.381,1737
spiral,0.242,588,673,1,1,0.49,0.624,0.361,1261
disappointment,0.241,1534,1756,1,1,0.115,0.49,0.336,3290
slightly,0.241,2218,2539,1,1,0.47,0.274,0.255,4757
abrupt,0.241,54,62,1,1,0.271,0.819,0.545,116
fondness,0.241,54,62,1,1,0.885,0.391,0.503,116
spaceship,0.241,109,125,1,1,0.643,0.781,0.664,234
uninformed,0.241,109,125,1,1,0.156,0.37,0.182,234
model,0.24,1346,1542,1,1,0.607,0.388,0.723,2888
two,0.24,36168,41440,1,1,0.52,0.2,0.404,77608
digest,0.24,177,203,1,1,0.72,0.413,0.483,380
rave,0.24,307,352,1,1,0.49,0.637,0.42,659
seemingly,0.24,621,712,1,1,0.49,0.41,0.356,1333
famously,0.24,40,46,1,1,0.856,0.765,0.787,86
holidays,0.24,7114,8156,1,1,0.939,0.521,0.512,15270
hat,0.24,1091,1251,1,1,0.604,0.183,0.353,2342
thoughtful,0.24,572,656,1,1,0.667,0.29,0.527,1228
fellowship,0.239,374,429,1,1,0.9,0.429,0.778,803
young,0.239,15056,17266,1,1,0.812,0.52,0.537,32322
whilst,0.239,1995,2288,1,1,0.51,0.302,0.388,4283
escaped,0.239,380,436,1,1,0.365,0.755,0.518,816
completed,0.239,414,475,1,1,0.823,0.357,0.777,889
peck,0.239,67,77,1,1,0.202,0.53,0.321,144
pandemic,0.239,33,38,1,1,0.16,0.79,0.544,71
reviewer,0.239,33,38,1,1,0.562,0.344,0.5,71
fights,0.239,1039,1192,1,1,0.07,0.92,0.712,2231
funding,0.239,556,638,1,1,0.729,0.48,0.827,1194
depression,0.239,31289,35896,1,1,0.031,0.52,0.232,67185
mood,0.239,10861,12461,1,1,0.72,0.5,0.5,23322
look,0.239,50417,57848,1,1,0.719,0.429,0.615,108265
discounted,0.239,60,69,1,1,0.677,0.471,0.43,129
shake,0.238,2161,2481,1,1,0.439,0.689,0.539,4642
stomped,0.238,53,61,1,1,0.229,0.684,0.406,114
parcels,0.238,26,30,1,1,0.551,0.445,0.418,56
extinguish,0.238,26,30,1,1,0.24,0.576,0.482,56
veneer,0.238,26,30,1,1,0.49,0.265,0.289,56
profitable,0.238,80,92,1,1,0.87,0.392,0.736,172
conservation,0.238,53,61,1,1,0.832,0.401,0.606,114
menacing,0.238,26,30,1,1,0.042,0.88,0.643,56
duress,0.238,26,30,1,1,0.302,0.569,0.612,56
dues,0.238,53,61,1,1,0.367,0.461,0.288,114
pounce,0.237,46,53,1,1,0.49,0.657,0.518,99
cathedral,0.237,93,107,1,1,0.598,0.33,0.643,200
cheesy,0.237,630,724,1,1,0.47,0.471,0.179,1354
sharpen,0.237,66,76,1,1,0.582,0.694,0.611,142
watcher,0.237,86,99,1,1,0.562,0.401,0.702,185
sincerity,0.237,233,268,1,1,0.908,0.351,0.686,501
died,0.237,7853,9028,1,1,0.021,0.65,0.327,16881
joined,0.237,2061,2370,1,1,0.667,0.394,0.6,4431
squeeze,0.237,426,490,1,1,0.458,0.676,0.532,916
incubator,0.237,19,22,1,1,0.51,0.435,0.405,41
studded,0.237,19,22,1,1,0.396,0.412,0.425,41
dumbasses,0.237,139,160,1,1,0.316,0.59,0.363,299
nifty,0.237,19,22,1,1,0.74,0.745,0.815,41
install,0.237,159,183,1,1,0.63,0.583,0.736,342
whopper,0.237,19,22,1,1,0.448,0.598,0.432,41
woodlands,0.237,19,22,1,1,0.656,0.34,0.473,41
teapot,0.237,19,22,1,1,0.479,0.11,0.309,41
converge,0.237,19,22,1,1,0.635,0.471,0.539,41
festival,0.236,717,825,1,1,0.87,0.706,0.714,1542
sloppy,0.236,112,129,1,1,0.303,0.441,0.183,241
dimensional,0.236,72,83,1,1,0.561,0.484,0.596,155
bubble,0.236,1220,1404,1,1,0.774,0.213,0.364,2624
saint,0.236,616,709,1,1,0.812,0.24,0.693,1325
tide,0.236,410,472,1,1,0.541,0.556,0.42,882
instrument,0.236,158,182,1,1,0.562,0.537,0.655,340
hiding,0.236,2997,3450,1,1,0.25,0.567,0.364,6447
precipice,0.235,32,37,1,1,0.198,0.784,0.396,69
paddock,0.235,32,37,1,1,0.48,0.429,0.481,69
inane,0.235,65,75,1,1,0.271,0.35,0.268,140
deprive,0.235,65,75,1,1,0.271,0.591,0.34,140
preserved,0.235,32,37,1,1,0.677,0.337,0.667,69
bestow,0.235,32,37,1,1,0.656,0.56,0.642,69
knot,0.235,144,166,1,1,0.541,0.221,0.408,310
wand,0.235,111,128,1,1,0.542,0.322,0.315,239
easily,0.235,4866,5605,1,1,0.885,0.279,0.453,10471
ignore,0.235,5442,6269,1,1,0.146,0.23,0.295,11711
platinum,0.235,124,143,1,1,0.75,0.518,0.702,267
mick,0.235,137,158,1,1,0.449,0.451,0.382,295
corridor,0.235,137,158,1,1,0.604,0.589,0.592,295
ten,0.235,2100,2420,1,1,0.562,0.26,0.406,4520
foe,0.234,163,188,1,1,0.071,0.827,0.459,351
reference,0.234,786,906,1,1,0.633,0.312,0.595,1692
boulder,0.234,58,67,1,1,0.461,0.309,0.531,125
guise,0.234,97,112,1,1,0.531,0.547,0.324,209
range,0.234,717,827,1,1,0.49,0.472,0.615,1544
coin,0.234,325,375,1,1,0.677,0.574,0.445,700
vulnerable,0.233,3817,4404,1,1,0.198,0.49,0.245,8221
heel,0.233,116,134,1,1,0.48,0.35,0.385,250
deflate,0.233,12,14,1,1,0.148,0.404,0.237,26
contend,0.233,51,59,1,1,0.51,0.657,0.731,110
firestorm,0.233,12,14,1,1,0.18,0.929,0.766,26
swish,0.233,12,14,1,1,0.562,0.51,0.474,26
sportsman,0.233,12,14,1,1,0.755,0.735,0.713,26
fornicate,0.233,12,14,1,1,0.396,0.933,0.565,26
assign,0.233,51,59,1,1,0.622,0.417,0.709,110
lifeguard,0.233,25,29,1,1,0.87,0.606,0.786,54
dependency,0.233,168,194,1,1,0.429,0.365,0.356,362
agressive,0.233,38,44,1,1,0.083,0.918,0.751,82
troupe,0.233,25,29,1,1,0.625,0.406,0.557,54
goop,0.233,12,14,1,1,0.469,0.394,0.333,26
gutsy,0.233,12,14,1,1,0.635,0.573,0.536,26
granddaddy,0.233,12,14,1,1,0.708,0.291,0.48,26
inbound,0.233,12,14,1,1,0.531,0.388,0.538,26
species,0.233,869,1003,1,1,0.561,0.33,0.645,1872
come,0.233,80333,92731,1,1,0.529,0.269,0.558,173064
back,0.233,96448,111347,1,1,0.438,0.353,0.336,207795
attraction,0.233,510,589,1,1,0.906,0.774,0.712,1099
gloves,0.233,193,223,1,1,0.542,0.225,0.491,416
translate,0.232,322,372,1,1,0.604,0.423,0.462,694
iris,0.232,199,230,1,1,0.708,0.275,0.38,429
mockery,0.232,128,148,1,1,0.094,0.806,0.181,276
sit,0.232,13713,15841,1,1,0.561,0.23,0.368,29554
masculine,0.232,192,222,1,1,0.653,0.54,0.773,414
attached,0.232,2070,2392,1,1,0.562,0.35,0.439,4462
crowd,0.232,6063,7006,1,1,0.35,0.827,0.731,13069
formidable,0.232,44,51,1,1,0.708,0.709,0.857,95
fawn,0.232,44,51,1,1,0.626,0.36,0.284,95
schooling,0.232,89,103,1,1,0.582,0.462,0.64,192
hotdog,0.232,44,51,1,1,0.72,0.438,0.373,95
venture,0.232,301,348,1,1,0.893,0.81,0.644,649
clerk,0.232,76,88,1,1,0.5,0.579,0.509,164
conspiracy,0.232,692,800,1,1,0.125,0.787,0.652,1492
laser,0.232,76,88,1,1,0.469,0.531,0.769,164
victoria,0.231,339,392,1,1,0.896,0.811,0.837,731
quotes,0.231,781,903,1,1,0.625,0.578,0.52,1684
natal,0.231,63,73,1,1,0.755,0.462,0.481,136
sunburn,0.231,31,36,1,1,0.061,0.755,0.447,67
jumbo,0.231,31,36,1,1,0.68,0.552,0.447,67
comb,0.231,63,73,1,1,0.49,0.123,0.268,136
ring,0.231,3171,3667,1,1,0.677,0.427,0.464,6838
enter,0.231,1604,1855,1,1,0.708,0.47,0.5,3459
direction,0.231,2547,2946,1,1,0.719,0.33,0.684,5493
lucid,0.231,101,117,1,1,0.771,0.49,0.705,218
plantation,0.231,50,58,1,1,0.573,0.585,0.575,108
puts,0.231,2243,2595,1,1,0.428,0.407,0.369,4838
rugby,0.23,120,139,1,1,0.677,0.82,0.708,259
distress,0.23,660,764,1,1,0.073,0.84,0.396,1424
padding,0.23,18,21,1,1,0.561,0.398,0.423,39
machinery,0.23,37,43,1,1,0.458,0.615,0.629,80
obliged,0.23,94,109,1,1,0.327,0.68,0.411,203
integral,0.23,75,87,1,1,0.59,0.337,0.615,162
crucifixion,0.23,18,21,1,1,0.135,0.857,0.541,39
marquis,0.23,18,21,1,1,0.521,0.444,0.562,39
cookie,0.23,543,629,1,1,0.792,0.306,0.25,1172
kidney,0.23,252,292,1,1,0.448,0.363,0.38,544
cafeteria,0.229,195,226,1,1,0.757,0.4,0.382,421
iced,0.229,220,255,1,1,0.564,0.482,0.339,475
hamburger,0.229,62,72,1,1,0.809,0.551,0.387,134
matrix,0.229,188,218,1,1,0.551,0.378,0.673,406
dissociative,0.229,43,50,1,1,0.281,0.615,0.397,93
essence,0.229,376,436,1,1,0.663,0.369,0.575,812
ramble,0.229,156,181,1,1,0.615,0.464,0.44,337
comp,0.229,156,181,1,1,0.573,0.45,0.371,337
node,0.228,68,79,1,1,0.396,0.343,0.361,147
infinitely,0.228,256,297,1,1,0.688,0.643,0.829,553
grand,0.228,1121,1300,1,1,0.898,0.74,0.888,2421
tap,0.228,562,652,1,1,0.461,0.37,0.349,1214
unanimously,0.228,24,28,1,1,0.686,0.333,0.738,52
gaff,0.228,49,57,1,1,0.333,0.418,0.429,106
urine,0.228,74,86,1,1,0.375,0.361,0.169,160
landslide,0.228,74,86,1,1,0.25,0.864,0.53,160
flowery,0.228,49,57,1,1,0.792,0.332,0.446,106
slush,0.228,24,28,1,1,0.427,0.283,0.296,52
epilogue,0.228,49,57,1,1,0.582,0.353,0.466,106
life,0.228,194591,225733,1,1,0.918,0.615,0.824,420324
lines,0.228,1998,2318,1,1,0.542,0.317,0.33,4316
height,0.228,560,650,1,1,0.677,0.608,0.648,1210
stupid,0.228,13456,15615,1,1,0.133,0.51,0.2,29071
excellent,0.227,1412,1639,1,1,0.97,0.587,0.87,3051
flattering,0.227,55,64,1,1,0.755,0.686,0.5,119
bubbling,0.227,55,64,1,1,0.5,0.438,0.384,119
self,0.227,25650,29778,1,1,0.704,0.37,0.5,55428
hamper,0.227,30,35,1,1,0.204,0.711,0.473,65
cab,0.227,315,366,1,1,0.438,0.49,0.421,681
kick,0.227,3242,3766,1,1,0.271,0.791,0.526,7008
sore,0.226,506,588,1,1,0.094,0.65,0.224,1094
contented,0.226,271,315,1,1,0.857,0.612,0.746,586
dig,0.226,1018,1183,1,1,0.367,0.585,0.637,2201
acknowledge,0.226,1555,1807,1,1,0.786,0.37,0.661,3362
humane,0.226,141,164,1,1,0.8,0.37,0.58,305
jaws,0.226,73,85,1,1,0.385,0.528,0.455,158
camouflage,0.226,36,42,1,1,0.438,0.585,0.45,78
lords,0.226,147,171,1,1,0.571,0.356,0.781,318
primal,0.226,116,135,1,1,0.55,0.407,0.482,251
swap,0.226,196,228,1,1,0.552,0.5,0.509,424
unlike,0.226,1347,1566,1,1,0.439,0.439,0.418,2913
daydream,0.226,202,235,1,1,0.75,0.337,0.456,437
canon,0.226,325,378,1,1,0.385,0.519,0.541,703
dictionary,0.226,165,192,1,1,0.62,0.25,0.598,357
dreaming,0.226,2021,2350,1,1,0.854,0.32,0.336,4371
haste,0.226,42,49,1,1,0.378,0.745,0.5,91
inserted,0.226,42,49,1,1,0.479,0.402,0.476,91
suitcase,0.225,140,163,1,1,0.562,0.212,0.318,303
speed,0.225,1139,1325,1,1,0.719,0.849,0.658,2464
core,0.225,1218,1417,1,1,0.721,0.378,0.54,2635
convict,0.225,48,56,1,1,0.177,0.84,0.477,104
fare,0.225,146,170,1,1,0.49,0.425,0.645,316
heheh,0.225,146,170,1,1,0.625,0.51,0.278,316
catalyst,0.225,97,113,1,1,0.604,0.509,0.585,210
invest,0.225,732,852,1,1,0.65,0.663,0.682,1584
starry,0.225,426,496,1,1,0.438,0.643,0.434,922
predictive,0.225,60,70,1,1,0.479,0.454,0.736,130
placement,0.224,188,219,1,1,0.643,0.46,0.528,407
championship,0.224,194,226,1,1,0.833,0.8,0.88,420
pinch,0.224,139,162,1,1,0.34,0.632,0.339,301
subscribe,0.224,279,325,1,1,0.66,0.344,0.591,604
lost,0.224,36515,42518,1,1,0.199,0.663,0.148,79033
sector,0.224,230,268,1,1,0.594,0.19,0.569,498
cheesecake,0.224,169,197,1,1,0.86,0.276,0.238,366
ropes,0.224,84,98,1,1,0.458,0.304,0.402,182
gift,0.224,3836,4468,1,1,0.88,0.539,0.483,8304
joining,0.224,1425,1660,1,1,0.755,0.469,0.685,3085
retiring,0.224,90,105,1,1,0.408,0.376,0.214,195
apparent,0.224,466,543,1,1,0.473,0.383,0.398,1009
papa,0.224,769,896,1,1,0.656,0.34,0.527,1665
suite,0.223,217,253,1,1,0.79,0.42,0.4,470
ride,0.223,4696,5473,1,1,0.806,0.465,0.472,10169
maze,0.223,240,280,1,1,0.438,0.608,0.444,520
pizza,0.223,2670,3114,1,1,0.847,0.39,0.295,5784
occasionally,0.222,1020,1190,1,1,0.538,0.24,0.264,2210
child,0.222,14737,17193,1,1,0.912,0.46,0.413,31930
fundraising,0.222,83,97,1,1,0.76,0.62,0.544,180
matinee,0.222,29,34,1,1,0.694,0.578,0.447,63
enthralled,0.222,23,27,1,1,0.745,0.602,0.615,50
spat,0.222,83,97,1,1,0.427,0.413,0.309,180
dupe,0.222,17,20,1,1,0.184,0.76,0.327,37
suburb,0.222,53,62,1,1,0.354,0.566,0.441,115
godly,0.222,155,181,1,1,0.747,0.298,0.589,336
twirl,0.222,29,34,1,1,0.552,0.647,0.409,63
docile,0.222,23,27,1,1,0.604,0.259,0.264,50
promotion,0.222,287,335,1,1,0.906,0.755,0.769,622
sinful,0.222,131,153,1,1,0.143,0.788,0.417,284
geometry,0.222,23,27,1,1,0.49,0.27,0.537,50
mambo,0.222,23,27,1,1,0.808,0.622,0.445,50
fornication,0.222,23,27,1,1,0.365,0.951,0.457,50
watered,0.222,65,76,1,1,0.615,0.29,0.377,141
prolific,0.222,35,41,1,1,0.625,0.55,0.604,76
saucy,0.222,29,34,1,1,0.25,0.653,0.391,63
crank,0.222,101,118,1,1,0.448,0.275,0.417,219
federation,0.222,47,55,1,1,0.633,0.354,0.763,102
rumored,0.222,23,27,1,1,0.427,0.604,0.318,50
swig,0.222,35,41,1,1,0.604,0.481,0.406,76
speculate,0.222,53,62,1,1,0.398,0.602,0.553,115
inch,0.221,399,466,1,1,0.481,0.327,0.3,865
providing,0.221,667,779,1,1,0.816,0.55,0.896,1446
boards,0.221,166,194,1,1,0.469,0.27,0.524,360
partner,0.221,8250,9637,1,1,0.673,0.302,0.586,17887
creeper,0.221,100,117,1,1,0.429,0.558,0.366,217
gratifying,0.221,88,103,1,1,0.857,0.606,0.776,191
cliff,0.221,426,498,1,1,0.361,0.62,0.509,924
distinction,0.22,165,193,1,1,0.584,0.571,0.75,358
comforter,0.22,230,269,1,1,0.618,0.275,0.302,499
mutant,0.22,76,89,1,1,0.337,0.676,0.573,165
distribution,0.22,70,82,1,1,0.635,0.548,0.788,152
upset,0.22,6850,8010,1,1,0.071,0.68,0.33,14860
alien,0.22,1243,1454,1,1,0.41,0.615,0.491,2697
retribution,0.219,52,61,1,1,0.625,0.49,0.708,113
emphasis,0.219,211,247,1,1,0.653,0.745,0.816,458
grades,0.219,558,653,1,1,0.521,0.349,0.566,1211
generic,0.219,199,233,1,1,0.52,0.357,0.422,432
quill,0.219,46,54,1,1,0.521,0.216,0.263,100
correctness,0.219,46,54,1,1,0.796,0.45,0.649,100
brood,0.219,46,54,1,1,0.633,0.519,0.434,100
reactionary,0.219,46,54,1,1,0.406,0.573,0.69,100
build,0.219,4499,5265,1,1,0.771,0.546,0.806,9764
seem,0.219,14412,16866,1,1,0.471,0.302,0.298,31278
jab,0.219,87,102,1,1,0.385,0.519,0.482,189
acquire,0.219,128,150,1,1,0.833,0.468,0.7,278
regular,0.219,1998,2339,1,1,0.435,0.188,0.558,4337
trademark,0.219,40,47,1,1,0.667,0.344,0.75,87
anecdote,0.219,40,47,1,1,0.583,0.529,0.5,87
ferocious,0.219,40,47,1,1,0.167,0.915,0.776,87
obtuse,0.219,40,47,1,1,0.281,0.46,0.345,87
metal,0.219,690,808,1,1,0.551,0.429,0.547,1498
hermit,0.219,760,890,1,1,0.271,0.337,0.351,1650
favorite,0.218,10572,12381,1,1,0.885,0.59,0.691,22953
quarrel,0.218,34,40,1,1,0.112,0.929,0.496,74
untimely,0.218,34,40,1,1,0.245,0.676,0.233,74
bias,0.218,1209,1417,1,1,0.4,0.37,0.541,2626
university,0.217,1635,1917,1,1,0.735,0.574,0.741,3552
forgetfulness,0.217,28,33,1,1,0.271,0.385,0.302,61
jerky,0.217,28,33,1,1,0.233,0.538,0.358,61
squall,0.217,28,33,1,1,0.191,0.833,0.655,61
inexperienced,0.217,57,67,1,1,0.281,0.473,0.231,124
conspire,0.217,28,33,1,1,0.206,0.74,0.52,61
excuse,0.217,3715,4356,1,1,0.24,0.696,0.318,8071
porch,0.217,399,468,1,1,0.535,0.324,0.388,867
ham,0.217,283,332,1,1,0.673,0.245,0.404,615
put,0.217,31038,36398,1,1,0.52,0.398,0.51,67436
six,0.217,1985,2328,1,1,0.5,0.154,0.271,4313
polygamy,0.217,51,60,1,1,0.365,0.647,0.563,111
crutch,0.217,155,182,1,1,0.302,0.294,0.302,337
covering,0.217,623,731,1,1,0.615,0.382,0.583,1354
semi,0.217,334,392,1,1,0.296,0.345,0.304,726
holly,0.217,334,392,1,1,0.51,0.25,0.443,726
revive,0.217,126,148,1,1,0.676,0.78,0.778,274
fortress,0.217,126,148,1,1,0.816,0.5,0.933,274
tarot,0.216,149,175,1,1,0.479,0.422,0.43,324
leaving,0.216,11702,13732,1,1,0.163,0.542,0.371,25434
heading,0.216,1019,1196,1,1,0.551,0.292,0.642,2215
bagel,0.216,143,168,1,1,0.531,0.363,0.34,311
devoted,0.216,229,269,1,1,0.867,0.32,0.698,498
angelic,0.216,137,161,1,1,0.927,0.298,0.668,298
mote,0.216,22,26,1,1,0.375,0.388,0.26,48
producing,0.216,206,242,1,1,0.632,0.616,0.7,448
penitentiary,0.216,22,26,1,1,0.229,0.726,0.491,48
wacky,0.216,91,107,1,1,0.153,0.72,0.321,198
develop,0.216,1057,1241,1,1,0.771,0.67,0.821,2298
jugular,0.216,45,53,1,1,0.271,0.573,0.426,98
exceed,0.216,45,53,1,1,0.5,0.827,0.586,98
slippery,0.216,108,127,1,1,0.219,0.74,0.343,235
outstanding,0.216,257,302,1,1,0.898,0.76,0.896,559
warped,0.216,171,201,1,1,0.219,0.663,0.304,372
justify,0.216,681,800,1,1,0.612,0.473,0.615,1481
reality,0.215,8815,10354,1,1,0.786,0.365,0.787,19169
fun,0.215,25521,29980,1,1,0.918,0.843,0.667,55501
dual,0.215,102,120,1,1,0.573,0.33,0.384,222
misunderstanding,0.215,245,288,1,1,0.112,0.618,0.284,533
harmful,0.215,468,550,1,1,0.094,0.75,0.291,1018
manipulation,0.215,325,382,1,1,0.188,0.775,0.536,707
preparation,0.215,193,227,1,1,0.771,0.5,0.679,420
builder,0.215,56,66,1,1,0.66,0.642,0.701,122
craig,0.215,227,267,1,1,0.448,0.449,0.49,494
medium,0.215,358,421,1,1,0.559,0.356,0.358,779
whatnot,0.215,187,220,1,1,0.375,0.493,0.363,407
enterprise,0.215,130,153,1,1,0.76,0.392,0.754,283
bottle,0.214,2753,3237,1,1,0.469,0.236,0.336,5990
paralysis,0.214,255,300,1,1,0.156,0.5,0.305,555
loco,0.214,90,106,1,1,0.306,0.774,0.226,196
champion,0.214,397,467,1,1,0.89,0.88,0.945,864
deviation,0.214,16,19,1,1,0.105,0.513,0.336,35
bobcat,0.214,16,19,1,1,0.562,0.49,0.529,35
crackpot,0.214,16,19,1,1,0.26,0.602,0.245,35
revels,0.214,16,19,1,1,0.827,0.683,0.647,35
proclaim,0.214,67,79,1,1,0.719,0.673,0.876,146
wane,0.214,16,19,1,1,0.188,0.402,0.098,35
absolve,0.214,16,19,1,1,0.684,0.449,0.66,35
fuel,0.214,509,599,1,1,0.445,0.528,0.644,1108
bossy,0.214,67,79,1,1,0.24,0.824,0.75,146
cot,0.214,50,59,1,1,0.625,0.23,0.278,109
disagreeable,0.214,16,19,1,1,0.042,0.643,0.178,35
maestro,0.214,16,19,1,1,0.823,0.357,0.849,35
pudgy,0.214,16,19,1,1,0.31,0.428,0.3,35
labored,0.214,16,19,1,1,0.646,0.451,0.637,35
photographic,0.214,16,19,1,1,0.761,0.429,0.564,35
hearsay,0.214,16,19,1,1,0.288,0.623,0.333,35
ambush,0.214,33,39,1,1,0.281,0.83,0.5,72
prescription,0.214,180,212,1,1,0.302,0.337,0.568,392
assume,0.213,2597,3057,1,1,0.698,0.401,0.464,5654
nun,0.213,885,1042,1,1,0.5,0.15,0.406,1927
salt,0.213,602,709,1,1,0.323,0.312,0.306,1311
yea,0.213,4625,5446,1,1,0.751,0.412,0.472,10071
stop,0.213,40866,48121,1,1,0.28,0.51,0.49,88987
anticipate,0.213,106,125,1,1,0.622,0.469,0.667,231
impact,0.213,2341,2757,1,1,0.469,0.884,0.776,5098
creamy,0.213,44,52,1,1,0.823,0.337,0.345,96
double,0.213,2034,2396,1,1,0.677,0.378,0.569,4430
destruction,0.213,634,747,1,1,0.102,0.929,0.613,1381
scorpion,0.212,72,85,1,1,0.198,0.745,0.6,157
rumble,0.212,72,85,1,1,0.367,0.745,0.613,157
facial,0.212,291,343,1,1,0.594,0.429,0.433,634
duchess,0.212,72,85,1,1,0.656,0.548,0.711,157
chic,0.212,100,118,1,1,0.87,0.624,0.38,218
innuendo,0.212,27,32,1,1,0.467,0.67,0.463,59
bullet,0.212,503,593,1,1,0.408,0.794,0.634,1096
sinister,0.212,122,144,1,1,0.125,0.896,0.581,266
shorten,0.212,94,111,1,1,0.302,0.382,0.46,205
inherit,0.212,66,78,1,1,0.745,0.546,0.694,144
controversial,0.211,211,249,1,1,0.271,0.858,0.538,460
veil,0.211,183,216,1,1,0.5,0.235,0.415,399
tan,0.211,406,479,1,1,0.643,0.46,0.444,885
weary,0.211,729,860,1,1,0.194,0.281,0.202,1589
dice,0.211,467,551,1,1,0.458,0.441,0.264,1018
glamour,0.211,205,242,1,1,0.823,0.606,0.623,447
southern,0.211,455,537,1,1,0.552,0.269,0.37,992
flood,0.211,366,432,1,1,0.208,0.778,0.608,798
virtue,0.211,377,445,1,1,0.896,0.443,0.827,822
yew,0.211,49,58,1,1,0.312,0.207,0.311,107
genuine,0.211,2725,3216,1,1,0.875,0.45,0.685,5941
homophobic,0.211,543,641,1,1,0.13,0.736,0.464,1184
spend,0.211,16316,19257,1,1,0.672,0.745,0.429,35573
harness,0.211,60,71,1,1,0.57,0.549,0.508,131
patronising,0.211,60,71,1,1,0.439,0.455,0.582,131
replacement,0.21,326,385,1,1,0.385,0.519,0.5,711
improves,0.21,132,156,1,1,0.929,0.625,0.727,288
tank,0.21,608,718,1,1,0.431,0.454,0.634,1326
bruise,0.21,82,97,1,1,0.133,0.64,0.474,179
freezing,0.21,602,711,1,1,0.327,0.367,0.471,1313
wither,0.21,148,175,1,1,0.15,0.42,0.259,323
unmarried,0.21,280,331,1,1,0.438,0.48,0.545,611
resident,0.209,379,448,1,1,0.592,0.327,0.5,827
cutting,0.209,1622,1917,1,1,0.448,0.375,0.536,3539
physiological,0.209,32,38,1,1,0.51,0.418,0.62,70
inordinate,0.209,21,25,1,1,0.163,0.63,0.33,46
retrospect,0.209,76,90,1,1,0.406,0.5,0.538,166
raspberries,0.209,21,25,1,1,0.802,0.278,0.333,46
barbarian,0.209,32,38,1,1,0.323,0.896,0.713,70
misinformed,0.209,87,103,1,1,0.156,0.567,0.25,190
excursion,0.209,21,25,1,1,0.625,0.714,0.627,46
roadtrip,0.209,65,77,1,1,0.677,0.596,0.519,142
effortless,0.209,43,51,1,1,0.626,0.09,0.352,94
glaze,0.209,21,25,1,1,0.65,0.34,0.356,46
uneasiness,0.209,43,51,1,1,0.19,0.798,0.241,94
snub,0.209,21,25,1,1,0.229,0.412,0.228,46
tiara,0.209,21,25,1,1,0.719,0.3,0.472,46
imprison,0.209,32,38,1,1,0.112,0.829,0.545,70
truffle,0.209,21,25,1,1,0.677,0.323,0.418,46
motion,0.209,449,531,1,1,0.667,0.538,0.657,980
white,0.209,12017,14208,1,1,0.729,0.173,0.42,26225
thesis,0.209,295,349,1,1,0.583,0.582,0.552,644
pimple,0.208,92,109,1,1,0.245,0.37,0.274,201
plate,0.208,792,937,1,1,0.583,0.245,0.366,1729
unfold,0.208,152,180,1,1,0.612,0.51,0.52,332
bunker,0.208,141,167,1,1,0.375,0.673,0.773,308
haunt,0.208,654,774,1,1,0.288,0.676,0.576,1428
game,0.208,14888,17619,1,1,0.735,0.788,0.493,32507
folded,0.208,168,199,1,1,0.179,0.373,0.327,367
log,0.208,930,1101,1,1,0.591,0.371,0.395,2031
shading,0.208,48,57,1,1,0.42,0.324,0.318,105
yearbook,0.208,48,57,1,1,0.562,0.231,0.509,105
spending,0.207,6273,7427,1,1,0.333,0.556,0.33,13700
eternity,0.207,1157,1370,1,1,0.765,0.52,0.911,2527
frat,0.207,124,147,1,1,0.714,0.371,0.726,271
purgatory,0.207,124,147,1,1,0.255,0.705,0.413,271
publicity,0.207,189,224,1,1,0.59,0.622,0.679,413
ridicule,0.207,189,224,1,1,0.143,0.745,0.255,413
movie,0.207,11799,13974,1,1,0.792,0.56,0.471,25773
comma,0.207,64,76,1,1,0.344,0.269,0.242,140
normality,0.207,64,76,1,1,0.781,0.089,0.444,140
advantage,0.207,2045,2423,1,1,0.917,0.548,0.859,4468
medieval,0.207,91,108,1,1,0.56,0.408,0.455,199
confession,0.206,517,613,1,1,0.469,0.642,0.46,1130
iron,0.206,711,843,1,1,0.448,0.351,0.679,1554
obsession,0.206,824,977,1,1,0.229,0.847,0.571,1801
silhouette,0.206,123,146,1,1,0.582,0.41,0.288,269
betty,0.206,247,293,1,1,0.542,0.358,0.381,540
revert,0.206,139,165,1,1,0.38,0.451,0.519,304
lay,0.206,4761,5646,1,1,0.521,0.336,0.491,10407
briefing,0.206,42,50,1,1,0.612,0.333,0.702,92
stride,0.206,85,101,1,1,0.49,0.67,0.434,186
ailment,0.206,42,50,1,1,0.146,0.734,0.277,92
quitter,0.206,42,50,1,1,0.26,0.46,0.321,92
stuck,0.206,8378,9937,1,1,0.153,0.644,0.285,18315
lazy,0.206,2651,3145,1,1,0.392,0.264,0.096,5796
sunflower,0.205,262,311,1,1,0.878,0.231,0.27,573
glass,0.205,2134,2532,1,1,0.49,0.404,0.322,4666
woodwork,0.205,74,88,1,1,0.49,0.481,0.545,162
spec,0.205,90,107,1,1,0.583,0.426,0.691,197
sewer,0.205,90,107,1,1,0.286,0.367,0.282,197
vary,0.205,122,145,1,1,0.521,0.373,0.413,267
tall,0.205,1416,1681,1,1,0.725,0.591,0.538,3097
freedom,0.205,4923,5844,1,1,0.969,0.544,0.905,10767
partly,0.205,394,468,1,1,0.415,0.41,0.396,862
sight,0.205,2011,2388,1,1,0.684,0.25,0.528,4399
hutch,0.204,15,18,1,1,0.385,0.453,0.52,33
disbelieve,0.204,15,18,1,1,0.188,0.441,0.352,33
tickled,0.204,47,56,1,1,0.755,0.707,0.364,103
jeep,0.204,111,132,1,1,0.602,0.51,0.612,243
gymnast,0.204,15,18,1,1,0.67,0.76,0.558,33
modicum,0.204,31,37,1,1,0.234,0.417,0.327,68
nostril,0.204,15,18,1,1,0.396,0.404,0.316,33
mozzarella,0.204,47,56,1,1,0.653,0.265,0.34,103
teaspoon,0.204,15,18,1,1,0.521,0.33,0.221,33
tights,0.204,47,56,1,1,0.583,0.343,0.269,103
devolve,0.204,15,18,1,1,0.367,0.427,0.596,33
unruly,0.204,31,37,1,1,0.24,0.745,0.547,68
undercurrent,0.204,15,18,1,1,0.357,0.582,0.52,33
exploitation,0.204,111,132,1,1,0.156,0.92,0.718,243
obedience,0.204,63,75,1,1,0.765,0.287,0.536,138
duel,0.204,47,56,1,1,0.271,0.696,0.589,103
palate,0.204,15,18,1,1,0.625,0.35,0.358,33
anonymous,0.204,676,803,1,1,0.396,0.291,0.431,1479
constant,0.204,4945,5874,1,1,0.74,0.296,0.686,10819
auntie,0.204,350,416,1,1,0.643,0.275,0.447,766
fierce,0.204,318,378,1,1,0.281,0.877,0.759,696
television,0.204,541,643,1,1,0.633,0.391,0.547,1184
elements,0.203,285,339,1,1,0.51,0.312,0.462,624
chest,0.203,3548,4219,1,1,0.52,0.429,0.481,7767
pull,0.203,4500,5351,1,1,0.45,0.685,0.473,9851
lark,0.203,36,43,1,1,0.57,0.292,0.352,79
morrow,0.203,36,43,1,1,0.708,0.314,0.49,79
gall,0.203,36,43,1,1,0.417,0.51,0.353,79
forearm,0.203,36,43,1,1,0.469,0.304,0.509,79
tack,0.203,36,43,1,1,0.365,0.431,0.431,79
shattering,0.203,131,156,1,1,0.135,0.76,0.475,287
slate,0.203,94,112,1,1,0.531,0.283,0.431,206
minion,0.203,57,68,1,1,0.49,0.43,0.167,125
folder,0.203,136,162,1,1,0.49,0.279,0.375,298
neglecting,0.202,157,187,1,1,0.177,0.441,0.23,344
poisonous,0.202,141,168,1,1,0.102,0.87,0.533,309
newly,0.202,325,387,1,1,0.688,0.422,0.552,712
nerve,0.202,766,912,1,1,0.129,0.698,0.307,1678
quadruple,0.202,20,24,1,1,0.51,0.4,0.589,44
fussy,0.202,62,74,1,1,0.417,0.643,0.519,136
dwell,0.202,629,749,1,1,0.698,0.245,0.611,1378
blaster,0.202,20,24,1,1,0.459,0.538,0.554,44
explanatory,0.202,20,24,1,1,0.573,0.433,0.688,44
broccoli,0.202,83,99,1,1,0.469,0.2,0.283,182
pacifist,0.202,20,24,1,1,0.663,0.153,0.557,44
floral,0.202,41,49,1,1,0.833,0.235,0.264,90
piranha,0.202,20,24,1,1,0.219,0.799,0.575,44
fearsome,0.202,20,24,1,1,0.115,0.9,0.586,44
cause,0.202,65883,78448,1,1,0.469,0.373,0.486,144331
ounce,0.202,303,361,1,1,0.531,0.255,0.288,664
blow,0.202,1852,2206,1,1,0.316,0.75,0.57,4058
segregation,0.201,67,80,1,1,0.302,0.545,0.39,147
mythology,0.201,67,80,1,1,0.684,0.439,0.688,147
adult,0.201,5406,6440,1,1,0.815,0.491,0.787,11846
grit,0.201,93,111,1,1,0.449,0.296,0.345,204
pike,0.201,46,55,1,1,0.427,0.41,0.452,101
impeccable,0.201,46,55,1,1,0.833,0.37,0.824,101
buddy,0.201,4902,5841,1,1,0.884,0.585,0.655,10743
overcoming,0.201,385,459,1,1,0.842,0.765,0.855,844
quad,0.201,72,86,1,1,0.52,0.441,0.391,158
deny,0.201,1156,1378,1,1,0.316,0.667,0.321,2534
char,0.201,296,353,1,1,0.554,0.361,0.404,649
explore,0.201,1166,1390,1,1,0.776,0.66,0.727,2556
attic,0.201,202,241,1,1,0.521,0.259,0.377,443
circular,0.2,51,61,1,1,0.562,0.342,0.417,112
kryptonite,0.2,51,61,1,1,0.306,0.69,0.588,112
lac,0.2,25,30,1,1,0.408,0.418,0.331,55
temperamental,0.2,25,30,1,1,0.316,0.774,0.608,55
interchangeable,0.2,25,30,1,1,0.615,0.459,0.526,55
update,0.2,2701,3221,1,1,0.698,0.535,0.802,5922
fry,0.2,212,253,1,1,0.52,0.61,0.324,465
quit,0.2,3180,3793,1,1,0.469,0.559,0.488,6973
opinionated,0.2,82,98,1,1,0.156,0.8,0.491,180
ramp,0.2,56,67,1,1,0.49,0.517,0.357,123
late,0.2,13031,15548,1,1,0.245,0.358,0.315,28579
likable,0.2,87,104,1,1,0.865,0.48,0.663,191
overflowing,0.2,180,215,1,1,0.439,0.796,0.635,395
dead,0.2,12801,15277,1,1,0.052,0.454,0.194,28078
hellfire,0.199,30,36,1,1,0.143,0.89,0.618,66
mustang,0.199,30,36,1,1,0.635,0.642,0.708,66
whimper,0.199,61,73,1,1,0.271,0.545,0.308,134
third,0.199,2632,3142,1,1,0.551,0.187,0.304,5774
cake,0.199,1800,2149,1,1,0.81,0.375,0.287,3949
dough,0.199,164,196,1,1,0.588,0.229,0.391,360
prophet,0.199,267,319,1,1,0.673,0.462,0.774,586
salmon,0.199,102,122,1,1,0.76,0.25,0.444,224
checkout,0.199,102,122,1,1,0.597,0.51,0.67,224
index,0.199,107,128,1,1,0.448,0.268,0.342,235
transitional,0.199,35,42,1,1,0.573,0.472,0.491,77
tote,0.199,35,42,1,1,0.51,0.398,0.625,77
ancestral,0.199,35,42,1,1,0.64,0.481,0.75,77
produce,0.198,605,723,1,1,0.908,0.737,0.836,1328
shuffling,0.198,76,91,1,1,0.521,0.408,0.293,167
gale,0.198,40,48,1,1,0.271,0.691,0.611,88
felon,0.198,40,48,1,1,0.111,0.898,0.455,88
sneak,0.198,552,660,1,1,0.281,0.745,0.449,1212
forehead,0.198,638,763,1,1,0.47,0.308,0.556,1401
holistic,0.198,45,54,1,1,0.67,0.348,0.547,99
distinguished,0.198,45,54,1,1,0.823,0.593,0.759,99
backside,0.198,45,54,1,1,0.182,0.417,0.342,99
uncalled,0.198,45,54,1,1,0.344,0.294,0.222,99
conscience,0.197,581,695,1,1,0.663,0.375,0.721,1276
pack,0.197,1958,2342,1,1,0.51,0.347,0.475,4300
debris,0.197,50,60,1,1,0.135,0.396,0.327,110
limitless,0.197,101,121,1,1,0.688,0.574,0.655,222
caveman,0.197,50,60,1,1,0.235,0.644,0.482,110
sway,0.197,157,188,1,1,0.69,0.596,0.721,345
documentary,0.197,666,797,1,1,0.622,0.213,0.596,1463
warrior,0.197,1251,1497,1,1,0.458,0.863,0.915,2748
wen,0.197,1001,1198,1,1,0.438,0.431,0.38,2199
pool,0.197,1270,1520,1,1,0.625,0.356,0.598,2790
obsolete,0.197,60,72,1,1,0.337,0.321,0.25,132
subtle,0.197,436,522,1,1,0.708,0.167,0.228,958
glasses,0.197,883,1057,1,1,0.531,0.21,0.33,1940
insidious,0.196,141,169,1,1,0.146,0.622,0.48,310
plastic,0.196,757,907,1,1,0.49,0.269,0.32,1664
hunk,0.196,100,120,1,1,0.438,0.375,0.361,220
lesser,0.196,317,380,1,1,0.396,0.167,0.211,697
ray,0.195,1028,1232,1,1,0.55,0.67,0.538,2260
listing,0.195,160,192,1,1,0.438,0.273,0.432,352
discipline,0.195,351,421,1,1,0.615,0.471,0.806,772
gum,0.195,200,240,1,1,0.573,0.227,0.213,440
key,0.195,4379,5251,1,1,0.615,0.275,0.519,9630
wooden,0.195,225,270,1,1,0.5,0.196,0.318,495
elf,0.195,506,607,1,1,0.46,0.457,0.315,1113
desk,0.194,1111,1333,1,1,0.51,0.135,0.422,2444
pure,0.194,3309,3970,1,1,0.811,0.306,0.652,7279
review,0.194,845,1014,1,1,0.667,0.408,0.636,1859
goodwill,0.194,99,119,1,1,0.938,0.327,0.667,218
prognosis,0.194,14,17,1,1,0.5,0.506,0.629,31
cobbler,0.194,14,17,1,1,0.51,0.415,0.318,31
hasten,0.194,14,17,1,1,0.571,0.75,0.618,31
misdirection,0.194,14,17,1,1,0.131,0.71,0.281,31
appetizer,0.194,19,23,1,1,0.755,0.56,0.406,42
stomp,0.194,89,107,1,1,0.365,0.565,0.438,196
raving,0.194,89,107,1,1,0.312,0.764,0.358,196
measuring,0.194,74,89,1,1,0.448,0.337,0.529,163
varied,0.194,79,95,1,1,0.604,0.701,0.472,174
killjoy,0.194,14,17,1,1,0.178,0.55,0.324,31
rebuttal,0.194,34,41,1,1,0.312,0.69,0.54,75
monolith,0.194,14,17,1,1,0.429,0.327,0.5,31
initiated,0.194,69,83,1,1,0.76,0.49,0.65,152
famed,0.194,14,17,1,1,0.878,0.75,0.819,31
contender,0.194,49,59,1,1,0.48,0.79,0.681,108
backdoor,0.194,24,29,1,1,0.344,0.41,0.333,53
prophesy,0.194,14,17,1,1,0.673,0.538,0.682,31
hawking,0.194,24,29,1,1,0.521,0.509,0.491,53
aby,0.194,14,17,1,1,0.385,0.452,0.368,31
procreation,0.194,29,35,1,1,0.792,0.714,0.787,64
impervious,0.194,14,17,1,1,0.582,0.408,0.536,31
zest,0.194,19,23,1,1,0.917,0.769,0.845,42
beehive,0.194,14,17,1,1,0.541,0.7,0.422,31
hierarchy,0.194,84,101,1,1,0.583,0.722,0.902,185
frightful,0.194,34,41,1,1,0.125,0.755,0.455,75
parapet,0.194,14,17,1,1,0.45,0.356,0.279,31
aggregate,0.194,14,17,1,1,0.73,0.378,0.556,31
rarity,0.194,79,95,1,1,0.646,0.548,0.364,174
magnificence,0.194,14,17,1,1,0.802,0.81,0.92,31
bus,0.194,3038,3646,1,1,0.407,0.411,0.4,6684
salvation,0.194,433,520,1,1,0.857,0.48,0.8,953
deactivate,0.194,343,412,1,1,0.235,0.447,0.392,755
nowadays,0.193,2126,2553,1,1,0.68,0.346,0.4,4679
devotion,0.193,223,268,1,1,0.802,0.561,0.673,491
fever,0.193,740,889,1,1,0.194,0.674,0.364,1629
restaurant,0.193,1504,1807,1,1,0.847,0.406,0.5,3311
bat,0.193,654,786,1,1,0.324,0.409,0.48,1440
enlighten,0.193,128,154,1,1,0.729,0.549,0.667,282
stage,0.193,3930,4723,1,1,0.592,0.306,0.473,8653
less,0.193,54234,65177,1,1,0.265,0.24,0.115,119411
degrade,0.192,93,112,1,1,0.083,0.5,0.184,205
vegetable,0.192,88,106,1,1,0.551,0.12,0.289,194
harden,0.192,88,106,1,1,0.276,0.598,0.677,194
seething,0.192,88,106,1,1,0.312,0.821,0.642,194
athletic,0.192,83,100,1,1,0.857,0.798,0.708,183
ineffective,0.192,73,88,1,1,0.093,0.422,0.094,161
emblem,0.191,63,76,1,1,0.64,0.33,0.754,139
stamina,0.191,58,70,1,1,0.664,0.694,0.877,128
necessarily,0.191,1703,2050,1,1,0.667,0.423,0.598,3753
silliness,0.191,53,64,1,1,0.327,0.368,0.192,117
spit,0.191,431,519,1,1,0.149,0.545,0.436,950
coo,0.191,480,578,1,1,0.49,0.439,0.5,1058
monologue,0.191,210,253,1,1,0.5,0.284,0.534,463
doorway,0.191,102,123,1,1,0.573,0.304,0.496,225
classify,0.191,48,58,1,1,0.646,0.411,0.72,106
praises,0.19,136,164,1,1,0.878,0.491,0.75,300
asshole,0.19,2493,3003,1,1,0.133,0.582,0.263,5496
bronze,0.19,43,52,1,1,0.622,0.333,0.526,95
lin,0.19,131,158,1,1,0.416,0.362,0.343,289
amends,0.19,87,105,1,1,0.64,0.366,0.517,192
heat,0.19,1431,1724,1,1,0.534,0.612,0.433,3155
noon,0.19,370,446,1,1,0.531,0.343,0.518,816
esteem,0.19,1212,1461,1,1,0.745,0.38,0.679,2673
early,0.19,7454,8985,1,1,0.633,0.373,0.426,16439
wholly,0.189,145,175,1,1,0.69,0.353,0.696,320
payback,0.189,72,87,1,1,0.459,0.5,0.567,159
makeshift,0.189,33,40,1,1,0.479,0.611,0.389,73
slum,0.189,33,40,1,1,0.292,0.528,0.302,73
supplementary,0.189,33,40,1,1,0.625,0.352,0.541,73
chip,0.189,402,485,1,1,0.479,0.382,0.452,887
cheat,0.189,1406,1696,1,1,0.125,0.776,0.4,3102
conference,0.188,947,1143,1,1,0.688,0.615,0.606,2090
group,0.188,15694,18940,1,1,0.573,0.423,0.48,34634
fjord,0.188,28,34,1,1,0.51,0.404,0.463,62
projector,0.188,28,34,1,1,0.573,0.491,0.711,62
specie,0.188,28,34,1,1,0.583,0.471,0.65,62
saltwater,0.188,28,34,1,1,0.327,0.33,0.364,62
dancing,0.188,3462,4179,1,1,0.885,0.868,0.444,7641
possessive,0.188,139,168,1,1,0.279,0.648,0.696,307
fox,0.188,1679,2027,1,1,0.323,0.555,0.491,3706
crew,0.188,1162,1403,1,1,0.604,0.598,0.735,2565
procreate,0.188,81,98,1,1,0.646,0.76,0.802,179
chill,0.188,5109,6169,1,1,0.837,0.206,0.482,11278
pow,0.188,52,63,1,1,0.375,0.44,0.426,115
coffee,0.188,5254,6345,1,1,0.823,0.418,0.309,11599
league,0.188,1294,1563,1,1,0.656,0.34,0.462,2857
elitist,0.187,100,121,1,1,0.5,0.606,0.656,221
mouth,0.187,3147,3802,1,1,0.734,0.294,0.336,6949
modify,0.187,23,28,1,1,0.458,0.584,0.625,51
cramped,0.187,71,86,1,1,0.24,0.567,0.36,157
comparative,0.187,23,28,1,1,0.47,0.273,0.562,51
improving,0.187,397,480,1,1,0.911,0.51,0.682,877
dumps,0.187,162,196,1,1,0.302,0.583,0.365,358
welcomed,0.187,574,694,1,1,0.927,0.585,0.7,1268
dissonance,0.187,90,109,1,1,0.173,0.471,0.336,199
edge,0.187,1636,1978,1,1,0.439,0.47,0.468,3614
proposal,0.187,243,294,1,1,0.888,0.667,0.596,537
squeezing,0.186,152,184,1,1,0.26,0.598,0.557,336
bam,0.186,348,421,1,1,0.427,0.472,0.39,769
sling,0.186,42,51,1,1,0.417,0.423,0.404,93
blindfold,0.186,42,51,1,1,0.448,0.684,0.337,93
waning,0.186,42,51,1,1,0.375,0.333,0.3,93
tor,0.186,42,51,1,1,0.337,0.43,0.418,93
sewing,0.186,104,126,1,1,0.625,0.337,0.356,230
mid,0.186,877,1061,1,1,0.5,0.315,0.356,1938
flow,0.186,1077,1303,1,1,0.696,0.316,0.464,2380
externally,0.186,61,74,1,1,0.643,0.521,0.568,135
boss,0.186,2607,3154,1,1,0.31,0.627,0.954,5761
ethical,0.186,161,195,1,1,0.854,0.324,0.634,356
retired,0.186,613,742,1,1,0.27,0.259,0.301,1355
unable,0.186,2301,2785,1,1,0.132,0.459,0.193,5086
thirty,0.185,289,350,1,1,0.562,0.349,0.316,639
unworthy,0.185,579,701,1,1,0.194,0.433,0.226,1280
reward,0.185,574,695,1,1,0.948,0.694,0.783,1269
reunion,0.185,284,344,1,1,0.837,0.5,0.672,628
volcanic,0.185,18,22,1,1,0.344,0.91,0.781,40
vantage,0.185,18,22,1,1,0.74,0.632,0.788,40
diluted,0.185,18,22,1,1,0.469,0.31,0.229,40
pesto,0.185,18,22,1,1,0.531,0.323,0.336,40
cryptic,0.185,75,91,1,1,0.296,0.516,0.474,166
immerse,0.185,75,91,1,1,0.51,0.577,0.509,166
consolidation,0.185,18,22,1,1,0.604,0.445,0.776,40
undertow,0.185,18,22,1,1,0.327,0.639,0.231,40
flannel,0.185,37,45,1,1,0.49,0.25,0.327,82
prominently,0.185,18,22,1,1,0.771,0.633,0.831,40
embed,0.185,18,22,1,1,0.417,0.554,0.67,40
poker,0.185,132,160,1,1,0.48,0.689,0.398,292
satisfied,0.185,1096,1327,1,1,0.959,0.51,0.685,2423
found,0.185,23692,28685,1,1,0.833,0.446,0.49,52377
expanded,0.185,70,85,1,1,0.76,0.406,0.689,155
dessert,0.185,212,257,1,1,0.755,0.491,0.404,469
nosy,0.184,103,125,1,1,0.292,0.558,0.433,228
rush,0.184,2272,2753,1,1,0.406,0.809,0.546,5025
symbolic,0.184,84,102,1,1,0.67,0.385,0.574,186
waiting,0.184,16839,20406,1,1,0.239,0.339,0.333,37245
navigation,0.184,32,39,1,1,0.841,0.47,0.72,71
favorable,0.184,32,39,1,1,0.952,0.38,0.788,71
pawn,0.184,98,119,1,1,0.39,0.321,0.187,217
regrettable,0.184,32,39,1,1,0.104,0.374,0.245,71
painkiller,0.184,32,39,1,1,0.487,0.312,0.481,71
pompous,0.184,65,79,1,1,0.5,0.571,0.409,144
habitually,0.184,32,39,1,1,0.6,0.324,0.583,71
hopes,0.184,2311,2802,1,1,0.917,0.5,0.702,5113
celebration,0.184,634,769,1,1,0.939,0.824,0.88,1403
palsy,0.183,46,56,1,1,0.083,0.446,0.221,102
timely,0.183,140,170,1,1,0.865,0.387,0.591,310
burnt,0.183,530,643,1,1,0.082,0.713,0.356,1173
belly,0.183,511,620,1,1,0.51,0.388,0.387,1131
optimism,0.183,229,278,1,1,0.949,0.565,0.814,507
antsy,0.183,60,73,1,1,0.449,0.558,0.417,133
cap,0.183,1087,1319,1,1,0.612,0.24,0.375,2406
leisure,0.183,135,164,1,1,0.631,0.429,0.421,299
beginnings,0.183,163,198,1,1,0.837,0.527,0.6,361
row,0.183,1703,2067,1,1,0.427,0.275,0.406,3770
vacuum,0.183,350,425,1,1,0.327,0.196,0.134,775
cracked,0.183,392,476,1,1,0.224,0.52,0.228,868
unintentional,0.182,41,50,1,1,0.333,0.538,0.306,91
leer,0.182,13,16,1,1,0.612,0.348,0.509,29
exclamation,0.182,41,50,1,1,0.612,0.745,0.598,91
cusp,0.182,41,50,1,1,0.667,0.71,0.7,91
residue,0.182,13,16,1,1,0.354,0.33,0.183,29
dissect,0.182,41,50,1,1,0.367,0.75,0.595,91
expulsion,0.182,13,16,1,1,0.19,0.79,0.529,29
semantics,0.182,27,33,1,1,0.698,0.394,0.569,60
outward,0.182,111,135,1,1,0.449,0.439,0.365,246
honorable,0.182,265,322,1,1,0.963,0.412,0.83,587
prefect,0.182,27,33,1,1,0.698,0.451,0.809,60
mole,0.182,83,101,1,1,0.436,0.377,0.352,184
cyanide,0.182,13,16,1,1,0.229,0.667,0.545,29
ablaze,0.182,27,33,1,1,0.24,0.847,0.525,60
gastric,0.182,13,16,1,1,0.327,0.559,0.43,29
veritable,0.182,13,16,1,1,0.794,0.33,0.759,29
pogo,0.182,27,33,1,1,0.48,0.426,0.368,60
tobacco,0.182,69,84,1,1,0.327,0.546,0.387,153
eyewitness,0.182,13,16,1,1,0.541,0.686,0.698,29
culmination,0.182,27,33,1,1,0.656,0.586,0.695,60
sell,0.182,1877,2280,1,1,0.618,0.608,0.605,4157
idiot,0.182,3097,3762,1,1,0.086,0.567,0.113,6859
exhausted,0.182,2576,3130,1,1,0.123,0.423,0.202,5706
drama,0.182,3491,4242,1,1,0.43,0.755,0.481,7733
declining,0.181,143,174,1,1,0.328,0.4,0.264,317
obnoxious,0.181,338,411,1,1,0.088,0.602,0.256,749
millionth,0.181,64,78,1,1,0.635,0.528,0.611,142
afterlife,0.181,245,298,1,1,0.571,0.567,0.568,543
booth,0.181,523,636,1,1,0.531,0.4,0.31,1159
accessible,0.181,254,309,1,1,0.796,0.41,0.645,563
ebb,0.181,50,61,1,1,0.354,0.451,0.404,111
sleepover,0.181,430,523,1,1,0.815,0.519,0.34,953
bargain,0.181,87,106,1,1,0.653,0.533,0.67,193
menu,0.181,235,286,1,1,0.633,0.333,0.385,521
sword,0.181,545,663,1,1,0.438,0.653,0.713,1208
set,0.181,8748,10639,1,1,0.521,0.482,0.63,19387
randomly,0.181,1479,1799,1,1,0.41,0.594,0.302,3278
depressive,0.18,854,1039,1,1,0.143,0.434,0.202,1893
manifest,0.18,290,353,1,1,0.667,0.647,0.704,643
nutrition,0.18,96,117,1,1,0.885,0.42,0.579,213
ruthless,0.18,179,218,1,1,0.208,0.85,0.67,397
repentance,0.18,59,72,1,1,0.417,0.604,0.324,131
err,0.18,128,156,1,1,0.146,0.66,0.236,284
crushed,0.18,680,828,1,1,0.167,0.647,0.3,1508
abstinence,0.18,45,55,1,1,0.26,0.392,0.429,100
thinker,0.18,160,195,1,1,0.706,0.386,0.764,355
boar,0.18,22,27,1,1,0.406,0.5,0.351,49
rustle,0.18,22,27,1,1,0.333,0.538,0.394,49
buttercup,0.18,68,83,1,1,0.562,0.482,0.422,151
plasma,0.18,22,27,1,1,0.474,0.398,0.36,49
befall,0.18,22,27,1,1,0.52,0.663,0.585,49
jewelry,0.179,123,150,1,1,0.823,0.569,0.597,273
reduction,0.179,100,122,1,1,0.365,0.382,0.24,222
tiring,0.179,1344,1637,1,1,0.153,0.51,0.176,2981
rooms,0.179,1596,1944,1,1,0.677,0.241,0.386,3540
raspberry,0.179,54,66,1,1,0.735,0.336,0.291,120
pessimist,0.179,54,66,1,1,0.125,0.47,0.218,120
caused,0.179,2015,2455,1,1,0.344,0.52,0.382,4470
senseless,0.179,173,211,1,1,0.125,0.388,0.136,384
knock,0.179,2004,2442,1,1,0.312,0.531,0.527,4446
snack,0.179,420,512,1,1,0.646,0.407,0.345,932
prank,0.179,182,222,1,1,0.571,0.69,0.389,404
graft,0.179,31,38,1,1,0.41,0.528,0.42,69
uninvited,0.179,95,116,1,1,0.09,0.385,0.307,211
communicator,0.179,31,38,1,1,0.573,0.509,0.796,69
autocorrect,0.179,127,155,1,1,0.551,0.439,0.616,282
cross,0.178,2114,2577,1,1,0.448,0.321,0.569,4691
swell,0.178,136,166,1,1,0.36,0.679,0.348,302
broadcasting,0.178,113,138,1,1,0.542,0.7,0.706,251
low,0.178,9461,11538,1,1,0.292,0.22,0.102,20999
hideout,0.178,40,49,1,1,0.337,0.443,0.302,89
calamity,0.178,40,49,1,1,0.122,0.795,0.343,89
hunting,0.178,614,749,1,1,0.448,0.713,0.714,1363
amused,0.178,172,210,1,1,0.942,0.847,0.596,382
proper,0.178,1801,2197,1,1,0.796,0.312,0.757,3998
hesitating,0.177,49,60,1,1,0.265,0.528,0.24,109
boasting,0.177,49,60,1,1,0.417,0.62,0.602,109
compass,0.177,249,304,1,1,0.541,0.307,0.529,553
county,0.177,889,1085,1,1,0.479,0.368,0.545,1974
wing,0.177,866,1057,1,1,0.562,0.255,0.389,1923
coping,0.177,1633,1993,1,1,0.562,0.63,0.613,3626
swallow,0.177,743,907,1,1,0.466,0.608,0.436,1650
yard,0.177,602,735,1,1,0.468,0.176,0.349,1337
vanish,0.177,212,259,1,1,0.236,0.48,0.347,471
dope,0.177,1226,1497,1,1,0.295,0.855,0.425,2723
careless,0.176,279,341,1,1,0.255,0.431,0.125,620
sense,0.176,17538,21426,1,1,0.781,0.417,0.474,38964
long,0.176,55111,67353,1,1,0.541,0.353,0.543,122464
semester,0.176,1399,1710,1,1,0.521,0.327,0.482,3109
paragon,0.176,17,21,1,1,0.49,0.431,0.473,38
vermin,0.176,44,54,1,1,0.167,0.712,0.385,98
aberration,0.176,17,21,1,1,0.125,0.816,0.417,38
tidbit,0.176,17,21,1,1,0.552,0.382,0.385,38
pus,0.176,26,32,1,1,0.135,0.431,0.226,58
rump,0.176,44,54,1,1,0.449,0.425,0.396,98
mixer,0.176,80,98,1,1,0.562,0.5,0.556,178
overlapping,0.176,26,32,1,1,0.595,0.578,0.684,58
calculating,0.176,44,54,1,1,0.458,0.43,0.625,98
martyrdom,0.176,26,32,1,1,0.323,0.745,0.442,58
plop,0.176,26,32,1,1,0.385,0.475,0.349,58
indulgent,0.176,44,54,1,1,0.56,0.481,0.529,98
fortnight,0.176,71,87,1,1,0.77,0.65,0.397,158
pitchfork,0.176,17,21,1,1,0.312,0.58,0.529,38
temptation,0.175,399,488,1,1,0.365,0.817,0.56,887
hum,0.175,354,433,1,1,0.49,0.296,0.276,787
predict,0.175,264,323,1,1,0.615,0.486,0.654,587
fest,0.175,241,295,1,1,0.704,0.574,0.402,536
severely,0.175,478,585,1,1,0.219,0.673,0.7,1063
sociopath,0.175,254,311,1,1,0.104,0.863,0.439,565
khan,0.174,303,371,1,1,0.463,0.476,0.529,674
locate,0.174,75,92,1,1,0.583,0.52,0.786,167
capitol,0.174,75,92,1,1,0.535,0.375,0.705,167
cling,0.174,674,825,1,1,0.417,0.62,0.588,1499
barber,0.174,200,245,1,1,0.543,0.459,0.356,445
aqua,0.174,191,234,1,1,0.656,0.292,0.359,425
liberated,0.174,115,141,1,1,0.78,0.63,0.683,256
scrape,0.174,57,70,1,1,0.365,0.615,0.384,127
strand,0.174,115,141,1,1,0.396,0.406,0.538,256
oyster,0.174,57,70,1,1,0.5,0.311,0.327,127
dude,0.174,12132,14856,1,1,0.809,0.356,0.615,26988
traffic,0.174,849,1040,1,1,0.323,0.559,0.518,1889
grrr,0.174,88,108,1,1,0.271,0.755,0.327,196
thereof,0.173,79,97,1,1,0.542,0.265,0.281,176
lengthy,0.173,79,97,1,1,0.57,0.342,0.528,176
verily,0.173,39,48,1,1,0.713,0.351,0.585,87
lucrative,0.173,39,48,1,1,0.729,0.519,0.798,87
countdown,0.173,190,233,1,1,0.438,0.692,0.49,423
tech,0.173,1025,1256,1,1,0.684,0.491,0.732,2281
style,0.173,1673,2050,1,1,0.745,0.472,0.586,3723
semblance,0.173,110,135,1,1,0.5,0.471,0.442,245
hysteria,0.173,110,135,1,1,0.224,0.906,0.482,245
fried,0.173,394,483,1,1,0.479,0.482,0.336,877
equal,0.173,1330,1630,1,1,0.781,0.178,0.407,2960
nonsensical,0.173,101,124,1,1,0.173,0.268,0.193,225
ignorant,0.173,1604,1966,1,1,0.102,0.461,0.223,3570
result,0.173,2249,2757,1,1,0.812,0.49,0.652,5006
span,0.173,309,379,1,1,0.521,0.33,0.528,688
editor,0.173,247,303,1,1,0.772,0.431,0.673,550
leak,0.173,154,189,1,1,0.378,0.833,0.52,343
penance,0.173,30,37,1,1,0.219,0.667,0.463,67
goddamned,0.173,61,75,1,1,0.042,0.758,0.42,136
brigade,0.173,92,113,1,1,0.604,0.71,0.828,205
philosophy,0.173,362,444,1,1,0.684,0.255,0.64,806
travel,0.173,4548,5576,1,1,0.931,0.689,0.535,10124
arcade,0.173,176,216,1,1,0.676,0.521,0.502,392
karma,0.173,1176,1442,1,1,0.5,0.51,0.537,2618
chase,0.172,1904,2335,1,1,0.396,0.878,0.623,4239
infect,0.172,52,64,1,1,0.102,0.777,0.424,116
fearful,0.172,542,665,1,1,0.083,0.482,0.278,1207
element,0.172,312,383,1,1,0.531,0.259,0.481,695
reflecting,0.172,510,626,1,1,0.59,0.408,0.471,1136
programming,0.172,228,280,1,1,0.6,0.435,0.732,508
tuesday,0.172,1544,1895,1,1,0.469,0.184,0.33,3439
rosemary,0.172,43,53,1,1,0.688,0.381,0.425,96
chow,0.172,43,53,1,1,0.573,0.49,0.39,96
visage,0.172,65,80,1,1,0.7,0.361,0.482,145
hooded,0.172,21,26,1,1,0.306,0.745,0.439,47
incidentally,0.172,43,53,1,1,0.479,0.5,0.5,96
cosmos,0.172,175,215,1,1,0.86,0.478,0.664,390
stink,0.171,210,258,1,1,0.042,0.481,0.18,468
exclude,0.171,166,204,1,1,0.292,0.5,0.53,370
barrier,0.171,289,355,1,1,0.333,0.48,0.562,644
respectable,0.171,100,123,1,1,0.85,0.35,0.889,223
suggest,0.171,1547,1900,1,1,0.573,0.471,0.517,3447
vile,0.171,832,1022,1,1,0.083,0.537,0.553,1854
passion,0.171,1987,2441,1,1,0.854,0.865,0.728,4428
triumph,0.171,161,198,1,1,0.969,0.798,0.926,359
estimate,0.17,104,128,1,1,0.719,0.469,0.517,232
grate,0.17,34,42,1,1,0.333,0.25,0.419,76
remake,0.17,244,300,1,1,0.583,0.488,0.642,544
tong,0.17,69,85,1,1,0.475,0.48,0.37,154
curry,0.17,257,316,1,1,0.633,0.345,0.302,573
corn,0.17,340,418,1,1,0.594,0.196,0.292,758
sermon,0.17,130,160,1,1,0.417,0.507,0.615,290
instruction,0.17,108,133,1,1,0.656,0.434,0.736,241
arguments,0.17,544,669,1,1,0.541,0.602,0.657,1213
abandoned,0.17,3385,4162,1,1,0.046,0.481,0.13,7547
apricot,0.17,60,74,1,1,0.708,0.32,0.278,134
grotesque,0.17,73,90,1,1,0.135,0.788,0.5,163
puzzle,0.169,321,395,1,1,0.537,0.471,0.525,716
awe,0.169,825,1015,1,1,0.469,0.74,0.3,1840
whip,0.169,316,389,1,1,0.208,0.899,0.509,705
grief,0.169,3599,4429,1,1,0.07,0.64,0.474,8028
darkroom,0.169,12,15,1,1,0.188,0.627,0.423,27
prissy,0.169,12,15,1,1,0.354,0.559,0.364,27
limo,0.169,38,47,1,1,0.76,0.367,0.667,85
sturdy,0.169,38,47,1,1,0.58,0.642,0.824,85
connective,0.169,12,15,1,1,0.719,0.491,0.764,27
sidewalk,0.169,246,303,1,1,0.479,0.192,0.348,549
bonny,0.169,12,15,1,1,0.561,0.404,0.444,27
fob,0.169,77,95,1,1,0.327,0.402,0.396,172
lifer,0.169,12,15,1,1,0.427,0.519,0.398,27
devise,0.169,12,15,1,1,0.551,0.557,0.67,27
dicey,0.169,12,15,1,1,0.29,0.833,0.727,27
ordinance,0.169,12,15,1,1,0.615,0.452,0.776,27
dissenting,0.169,25,31,1,1,0.208,0.552,0.366,56
woefully,0.169,38,47,1,1,0.204,0.58,0.269,85
heightened,0.169,103,127,1,1,0.592,0.529,0.788,230
ointment,0.169,12,15,1,1,0.438,0.271,0.398,27
exaggerated,0.169,103,127,1,1,0.224,0.885,0.732,230
matted,0.169,12,15,1,1,0.281,0.519,0.393,27
thick,0.168,951,1171,1,1,0.449,0.433,0.596,2122
astrology,0.168,198,244,1,1,0.635,0.34,0.5,442
respective,0.168,120,148,1,1,0.625,0.413,0.721,268
regretting,0.168,336,414,1,1,0.255,0.567,0.273,750
solution,0.168,2380,2932,1,1,0.79,0.339,0.664,5312
tie,0.168,564,695,1,1,0.663,0.464,0.431,1259
expired,0.168,137,169,1,1,0.198,0.394,0.2,306
form,0.168,4326,5330,1,1,0.51,0.302,0.436,9656
streaming,0.168,1743,2148,1,1,0.592,0.481,0.582,3891
one,0.167,282993,348729,1,1,0.542,0.292,0.37,631722
leash,0.167,128,158,1,1,0.32,0.347,0.427,286
gunner,0.167,42,52,1,1,0.25,0.853,0.817,94
dialysis,0.167,42,52,1,1,0.194,0.567,0.407,94
alignment,0.167,72,89,1,1,0.643,0.412,0.683,161
relentless,0.167,218,269,1,1,0.333,0.713,0.904,487
ash,0.167,922,1137,1,1,0.26,0.21,0.207,2059
dye,0.167,175,216,1,1,0.479,0.314,0.371,391
spotlight,0.167,398,491,1,1,0.688,0.353,0.519,889
withdrawal,0.167,222,274,1,1,0.275,0.541,0.226,496
polo,0.167,59,73,1,1,0.582,0.36,0.415,132
drool,0.167,59,73,1,1,0.385,0.398,0.204,132
unmarked,0.167,29,36,1,1,0.416,0.294,0.433,65
woeful,0.167,29,36,1,1,0.135,0.555,0.255,65
create,0.167,5004,6172,1,1,0.786,0.588,0.789,11176
rivalry,0.166,46,57,1,1,0.192,0.765,0.538,103
flying,0.166,1975,2438,1,1,0.877,0.606,0.696,4413
spade,0.166,63,78,1,1,0.469,0.667,0.529,141
earnest,0.166,80,99,1,1,0.653,0.38,0.67,179
bleach,0.166,161,199,1,1,0.336,0.282,0.337,360
punch,0.165,804,993,1,1,0.229,0.787,0.608,1797
par,0.165,352,435,1,1,0.615,0.372,0.429,787
reddish,0.165,16,20,1,1,0.521,0.337,0.328,36
persuasive,0.165,33,41,1,1,0.74,0.7,0.657,74
moonwalk,0.165,16,20,1,1,0.615,0.586,0.525,36
repose,0.165,33,41,1,1,0.469,0.1,0.33,74
nutritional,0.165,16,20,1,1,0.812,0.406,0.676,36
wrongful,0.165,16,20,1,1,0.102,0.68,0.347,36
cushy,0.165,16,20,1,1,0.823,0.283,0.395,36
doldrums,0.165,16,20,1,1,0.229,0.425,0.266,36
idiotic,0.165,288,356,1,1,0.104,0.62,0.17,644
tumbler,0.165,16,20,1,1,0.52,0.26,0.352,36
completeness,0.165,33,41,1,1,0.823,0.433,0.769,74
addition,0.165,496,613,1,1,0.562,0.373,0.471,1109
base,0.165,1405,1736,1,1,0.635,0.298,0.553,3141
unheard,0.165,309,382,1,1,0.344,0.539,0.5,691
signal,0.165,517,639,1,1,0.615,0.417,0.464,1156
blackout,0.165,207,256,1,1,0.126,0.53,0.349,463
euphoria,0.165,347,429,1,1,0.769,0.955,0.648,776
acknowledged,0.165,330,408,1,1,0.714,0.443,0.765,738
discount,0.165,245,303,1,1,0.724,0.53,0.302,548
accuracy,0.165,105,130,1,1,0.604,0.481,0.802,235
bidding,0.164,71,88,1,1,0.586,0.644,0.509,159
person,0.164,69903,86415,1,1,0.646,0.363,0.596,156318
population,0.164,1167,1443,1,1,0.615,0.423,0.667,2610
toxic,0.164,8978,11100,1,1,0.008,0.885,0.492,20078
day,0.164,141645,175134,1,1,0.719,0.269,0.389,316779
professor,0.164,663,820,1,1,0.656,0.398,0.721,1483
purely,0.164,447,553,1,1,0.684,0.441,0.536,1000
pointy,0.164,37,46,1,1,0.469,0.651,0.438,83
blip,0.164,37,46,1,1,0.529,0.461,0.418,83
flask,0.164,37,46,1,1,0.418,0.412,0.454,83
messiah,0.164,96,119,1,1,0.781,0.634,0.8,215
optimist,0.163,58,72,1,1,0.875,0.539,0.787,130
fashion,0.163,652,807,1,1,0.827,0.616,0.589,1459
bond,0.163,1494,1849,1,1,0.667,0.519,0.63,3343
cope,0.163,3713,4595,1,1,0.592,0.647,0.709,8308
pseudo,0.163,79,98,1,1,0.367,0.389,0.282,177
obligatory,0.163,79,98,1,1,0.337,0.571,0.78,177
bacteria,0.163,121,150,1,1,0.177,0.553,0.57,271
partial,0.163,142,176,1,1,0.429,0.324,0.348,318
calendar,0.163,306,379,1,1,0.48,0.212,0.473,685
effective,0.163,638,790,1,1,0.844,0.632,0.891,1428
search,0.163,2920,3615,1,1,0.635,0.58,0.462,6535
soapy,0.163,20,25,1,1,0.552,0.373,0.355,45
fanatical,0.163,20,25,1,1,0.555,0.83,0.714,45
scalding,0.163,20,25,1,1,0.271,0.54,0.381,45
myriad,0.163,83,103,1,1,0.48,0.429,0.55,186
icky,0.163,83,103,1,1,0.357,0.51,0.342,186
ratio,0.163,230,285,1,1,0.56,0.461,0.741,515
unpleasant,0.162,280,347,1,1,0.122,0.612,0.185,627
rite,0.162,238,295,1,1,0.378,0.57,0.606,533
big,0.162,29454,36487,1,1,0.802,0.588,0.812,65941
wardrobe,0.162,133,165,1,1,0.612,0.51,0.336,298
fudge,0.162,112,139,1,1,0.853,0.418,0.407,251
tip,0.162,1212,1502,1,1,0.708,0.221,0.518,2714
investor,0.162,45,56,1,1,0.794,0.655,0.791,101
award,0.162,718,890,1,1,0.865,0.745,0.66,1608
holding,0.162,8193,10154,1,1,0.6,0.385,0.67,18347
automatic,0.162,212,263,1,1,0.562,0.433,0.664,475
imagining,0.161,683,847,1,1,0.765,0.458,0.545,1530
ranch,0.161,220,273,1,1,0.357,0.42,0.409,493
wasting,0.161,1817,2253,1,1,0.051,0.417,0.207,4070
worker,0.161,791,981,1,1,0.719,0.598,0.684,1772
relinquish,0.161,24,30,1,1,0.265,0.606,0.286,54
implant,0.161,24,30,1,1,0.429,0.51,0.588,54
evaporate,0.161,24,30,1,1,0.357,0.469,0.402,54
totem,0.161,24,30,1,1,0.639,0.35,0.571,54
exponential,0.161,24,30,1,1,0.704,0.588,0.763,54
charger,0.161,199,247,1,1,0.531,0.418,0.545,446
opiate,0.161,24,30,1,1,0.281,0.594,0.598,54
collateral,0.161,49,61,1,1,0.531,0.422,0.717,110
turnover,0.161,49,61,1,1,0.49,0.392,0.512,110
jour,0.161,24,30,1,1,0.479,0.394,0.415,54
toasty,0.161,24,30,1,1,0.698,0.461,0.396,54
constipation,0.161,24,30,1,1,0.079,0.612,0.231,54
mine,0.161,15409,19113,1,1,0.688,0.418,0.578,34522
dissent,0.161,53,66,1,1,0.3,0.655,0.407,119
lynch,0.161,107,133,1,1,0.167,0.885,0.482,240
damaged,0.161,921,1143,1,1,0.104,0.635,0.182,2064
exist,0.16,5438,6749,1,1,0.857,0.421,0.788,12187
tuna,0.16,111,138,1,1,0.531,0.386,0.304,249
blissful,0.16,227,282,1,1,0.885,0.639,0.676,509
estrogen,0.16,28,35,1,1,0.58,0.5,0.425,63
wickedness,0.16,57,71,1,1,0.031,0.727,0.443,128
recognizable,0.16,28,35,1,1,0.625,0.4,0.609,63
pouch,0.16,28,35,1,1,0.438,0.23,0.271,63
awards,0.16,442,549,1,1,0.958,0.736,0.652,991
collected,0.16,210,261,1,1,0.57,0.402,0.588,471
fabric,0.16,181,225,1,1,0.635,0.19,0.345,406
evade,0.16,61,76,1,1,0.304,0.49,0.342,137
mute,0.16,747,928,1,1,0.271,0.2,0.25,1675
buying,0.16,2383,2960,1,1,0.665,0.784,0.589,5343
mining,0.16,94,117,1,1,0.633,0.598,0.554,211
source,0.159,1725,2143,1,1,0.74,0.318,0.684,3868
shrug,0.159,325,404,1,1,0.208,0.296,0.278,729
newcomer,0.159,32,40,1,1,0.622,0.38,0.396,72
unwritten,0.159,32,40,1,1,0.367,0.384,0.272,72
forte,0.159,65,81,1,1,0.829,0.737,0.8,146
ample,0.159,65,81,1,1,0.744,0.349,0.719,146
jinx,0.159,65,81,1,1,0.337,0.582,0.373,146
transferred,0.159,168,209,1,1,0.48,0.45,0.409,377
board,0.159,1441,1791,1,1,0.592,0.255,0.385,3232
muddy,0.159,69,86,1,1,0.292,0.4,0.283,155
unwell,0.159,287,357,1,1,0.143,0.64,0.221,644
emotional,0.159,8453,10509,1,1,0.779,0.714,0.526,18962
disillusionment,0.159,36,45,1,1,0.051,0.519,0.19,81
engrossed,0.159,36,45,1,1,0.541,0.471,0.304,81
dawned,0.158,118,147,1,1,0.694,0.471,0.473,265
joke,0.158,5824,7244,1,1,0.704,0.61,0.316,13068
stocking,0.158,81,101,1,1,0.594,0.324,0.688,182
planetary,0.158,40,50,1,1,0.604,0.5,0.62,90
apprentice,0.158,81,101,1,1,0.615,0.413,0.452,182
sith,0.158,40,50,1,1,0.439,0.564,0.373,90
detach,0.158,167,208,1,1,0.357,0.625,0.45,375
conventional,0.158,85,106,1,1,0.594,0.292,0.634,191
dame,0.158,179,223,1,1,0.694,0.48,0.5,402
pad,0.158,269,335,1,1,0.684,0.279,0.33,604
likeness,0.158,44,55,1,1,0.688,0.41,0.561,99
cheers,0.157,1548,1927,1,1,0.948,0.77,0.702,3475
duration,0.157,93,116,1,1,0.656,0.37,0.536,209
handicap,0.157,48,60,1,1,0.133,0.394,0.264,108
sans,0.157,199,248,1,1,0.459,0.294,0.246,447
gravitate,0.157,101,126,1,1,0.479,0.472,0.476,227
nail,0.157,517,644,1,1,0.469,0.397,0.282,1161
relationship,0.157,30273,37698,1,1,0.867,0.566,0.589,67971
kill,0.157,10616,13220,1,1,0.052,0.941,0.736,23836
wishing,0.157,4356,5426,1,1,0.755,0.6,0.491,9782
treat,0.157,6302,7850,1,1,0.573,0.571,0.436,14152
invincible,0.157,174,217,1,1,0.867,0.853,0.914,391
tropical,0.157,117,146,1,1,0.74,0.461,0.509,263
socialize,0.157,1325,1651,1,1,0.907,0.683,0.726,2976
inheritance,0.156,60,75,1,1,0.9,0.565,0.798,135
ore,0.156,60,75,1,1,0.5,0.333,0.356,135
thrice,0.156,60,75,1,1,0.469,0.442,0.462,135
gag,0.156,190,237,1,1,0.323,0.66,0.398,427
ending,0.155,4154,5181,1,1,0.344,0.365,0.492,9335
attentive,0.155,88,110,1,1,0.812,0.52,0.724,198
failure,0.155,3692,4605,1,1,0.167,0.575,0.139,8297
stoned,0.155,557,695,1,1,0.177,0.796,0.375,1252
different,0.155,23880,29789,1,1,0.612,0.394,0.473,53669
whack,0.155,294,367,1,1,0.219,0.816,0.708,661
pavement,0.155,104,130,1,1,0.46,0.353,0.475,234
cast,0.155,1650,2059,1,1,0.558,0.62,0.517,3709
resume,0.155,221,276,1,1,0.573,0.411,0.586,497
needless,0.155,237,296,1,1,0.327,0.385,0.2,533
limited,0.155,1084,1353,1,1,0.229,0.273,0.38,2437
dysfunction,0.155,124,155,1,1,0.156,0.41,0.386,279
debilitating,0.155,426,532,1,1,0.125,0.49,0.308,958
celebrating,0.155,1513,1889,1,1,0.927,0.86,0.773,3402
attacking,0.154,776,969,1,1,0.276,0.837,0.642,1745
coward,0.154,933,1165,1,1,0.102,0.49,0.149,2098
comparable,0.154,168,210,1,1,0.562,0.443,0.458,378
appeal,0.154,510,637,1,1,0.663,0.598,0.558,1147
three,0.154,8023,10019,1,1,0.653,0.225,0.377,18042
downhill,0.154,228,285,1,1,0.292,0.573,0.279,513
thingy,0.154,244,305,1,1,0.458,0.312,0.158,549
grave,0.154,1432,1789,1,1,0.153,0.385,0.386,3221
uncertain,0.154,352,440,1,1,0.363,0.5,0.164,792
quiet,0.153,9865,12329,1,1,0.792,0.105,0.431,22194
mediocre,0.153,403,504,1,1,0.188,0.481,0.149,907
patch,0.153,595,744,1,1,0.439,0.288,0.283,1339
intercom,0.153,15,19,1,1,0.623,0.429,0.453,34
scarcely,0.153,23,29,1,1,0.082,0.412,0.16,52
sensational,0.153,55,69,1,1,0.938,0.827,0.858,124
waistline,0.153,11,14,1,1,0.56,0.417,0.32,25
molecule,0.153,15,19,1,1,0.531,0.259,0.375,34
underline,0.153,15,19,1,1,0.48,0.412,0.509,34
ducky,0.153,39,49,1,1,0.52,0.43,0.368,88
verification,0.153,51,64,1,1,0.75,0.276,0.642,115
eloquence,0.153,19,24,1,1,0.729,0.49,0.804,43
mademoiselle,0.153,11,14,1,1,0.752,0.459,0.461,25
praxis,0.153,11,14,1,1,0.438,0.439,0.593,25
aga,0.153,31,39,1,1,0.542,0.327,0.398,70
pitter,0.153,11,14,1,1,0.469,0.424,0.384,25
credited,0.153,35,44,1,1,0.781,0.39,0.691,79
distribute,0.153,43,54,1,1,0.643,0.596,0.709,97
snapshot,0.153,39,49,1,1,0.573,0.578,0.588,88
designation,0.153,11,14,1,1,0.612,0.571,0.675,25
filet,0.153,11,14,1,1,0.615,0.392,0.291,25
televised,0.153,43,54,1,1,0.625,0.519,0.518,97
appraisal,0.153,15,19,1,1,0.417,0.667,0.682,34
fixer,0.153,31,39,1,1,0.633,0.375,0.606,70
relish,0.153,127,159,1,1,0.854,0.61,0.632,286
maligned,0.153,23,29,1,1,0.102,0.684,0.218,52
sleazy,0.153,55,69,1,1,0.292,0.674,0.37,124
auditions,0.153,51,64,1,1,0.74,0.765,0.596,115
transitory,0.153,11,14,1,1,0.438,0.45,0.407,25
durable,0.153,15,19,1,1,0.74,0.294,0.688,34
nightgown,0.153,11,14,1,1,0.643,0.408,0.25,25
torso,0.153,51,64,1,1,0.408,0.394,0.473,115
emu,0.153,23,29,1,1,0.42,0.358,0.33,52
inter,0.153,59,74,1,1,0.51,0.375,0.466,133
liturgy,0.153,19,24,1,1,0.49,0.327,0.568,43
fidgety,0.153,15,19,1,1,0.229,0.786,0.351,34
pistachio,0.153,11,14,1,1,0.643,0.336,0.305,25
ricochet,0.153,11,14,1,1,0.287,0.618,0.43,25
twine,0.153,19,24,1,1,0.521,0.38,0.337,43
unchanged,0.153,27,34,1,1,0.49,0.204,0.237,61
blare,0.153,23,29,1,1,0.439,0.561,0.519,52
parachute,0.153,39,49,1,1,0.562,0.787,0.564,88
talisman,0.153,11,14,1,1,0.704,0.542,0.642,25
perversion,0.153,39,49,1,1,0.083,0.83,0.49,88
whopping,0.153,31,39,1,1,0.541,0.74,0.755,70
intermediate,0.153,15,19,1,1,0.48,0.368,0.4,34
wipe,0.153,699,874,1,1,0.663,0.427,0.551,1573
confine,0.153,43,54,1,1,0.327,0.551,0.538,97
fashionable,0.153,59,74,1,1,0.75,0.51,0.605,133
oaf,0.153,11,14,1,1,0.344,0.357,0.33,25
concentrate,0.153,510,638,1,1,0.75,0.439,0.743,1148
buildings,0.152,246,308,1,1,0.582,0.38,0.552,554
display,0.152,560,701,1,1,0.677,0.325,0.4,1261
imam,0.152,162,203,1,1,0.527,0.337,0.539,365
congratulate,0.152,138,173,1,1,0.927,0.724,0.784,311
ideology,0.152,408,511,1,1,0.573,0.344,0.692,919
wedding,0.152,2004,2509,1,1,0.875,0.802,0.642,4513
wish,0.152,46159,57789,1,1,0.771,0.583,0.647,103948
caretaker,0.152,126,158,1,1,0.714,0.531,0.759,284
fan,0.151,7297,9138,1,1,0.781,0.429,0.357,16435
comparison,0.151,435,545,1,1,0.583,0.456,0.492,980
international,0.151,1008,1263,1,1,0.8,0.519,0.702,2271
luxurious,0.151,90,113,1,1,0.947,0.644,0.754,203
shift,0.151,2123,2660,1,1,0.479,0.61,0.491,4783
hostile,0.151,335,420,1,1,0.188,0.877,0.474,755
unrelated,0.151,240,301,1,1,0.302,0.27,0.264,541
shockingly,0.15,70,88,1,1,0.51,0.924,0.721,158
torch,0.15,137,172,1,1,0.531,0.63,0.545,309
privileged,0.15,377,473,1,1,0.867,0.49,0.853,850
rounded,0.15,62,78,1,1,0.592,0.391,0.396,140
smile,0.15,16190,20309,1,1,0.906,0.598,0.618,36499
quick,0.15,3764,4722,1,1,0.704,0.755,0.75,8486
fiddle,0.15,54,68,1,1,0.571,0.449,0.391,122
partially,0.149,309,388,1,1,0.418,0.368,0.396,697
fodder,0.149,50,63,1,1,0.316,0.358,0.43,113
unparalleled,0.149,50,63,1,1,0.708,0.306,0.538,113
lovable,0.149,250,314,1,1,0.948,0.335,0.565,564
hammer,0.149,191,240,1,1,0.312,0.509,0.563,431
nada,0.149,191,240,1,1,0.25,0.231,0.136,431
paraphrase,0.149,46,58,1,1,0.5,0.375,0.444,104
selfish,0.149,4756,5971,1,1,0.061,0.637,0.495,10727
raid,0.149,183,230,1,1,0.35,0.726,0.56,413
location,0.149,868,1090,1,1,0.615,0.375,0.546,1958
materials,0.149,136,171,1,1,0.633,0.361,0.473,307
manipulate,0.149,394,495,1,1,0.255,0.7,0.772,889
bring,0.149,14535,18253,1,1,0.635,0.46,0.462,32788
trusty,0.149,42,53,1,1,0.863,0.398,0.696,95
shave,0.149,257,323,1,1,0.521,0.41,0.48,580
pursuing,0.148,339,426,1,1,0.483,0.906,0.69,765
reveal,0.148,694,872,1,1,0.493,0.637,0.526,1566
warehouse,0.148,120,151,1,1,0.721,0.365,0.446,271
biology,0.148,159,200,1,1,0.479,0.274,0.546,359
wield,0.148,38,48,1,1,0.347,0.66,0.625,86
luckiest,0.148,77,97,1,1,0.917,0.69,0.852,174
strep,0.148,38,48,1,1,0.365,0.594,0.353,86
casually,0.148,486,611,1,1,0.658,0.29,0.333,1097
deliverance,0.148,73,92,1,1,0.75,0.52,0.658,165
yahoo,0.148,73,92,1,1,0.643,0.583,0.522,165
loving,0.148,10499,13196,1,1,0.948,0.612,0.636,23695
vision,0.148,1217,1530,1,1,0.708,0.447,0.742,2747
horrors,0.147,205,258,1,1,0.061,0.852,0.409,463
mistake,0.147,3211,4038,1,1,0.208,0.585,0.102,7249
dodger,0.147,65,82,1,1,0.427,0.454,0.49,147
drown,0.147,1875,2359,1,1,0.071,0.86,0.27,4234
physique,0.147,30,38,1,1,0.643,0.5,0.543,68
framework,0.147,61,77,1,1,0.459,0.33,0.36,138
roasted,0.147,123,155,1,1,0.615,0.52,0.339,278
landlady,0.147,30,38,1,1,0.677,0.303,0.417,68
heist,0.147,30,38,1,1,0.184,0.85,0.645,68
installment,0.147,30,38,1,1,0.619,0.396,0.483,68
theological,0.147,30,38,1,1,0.48,0.363,0.683,68
recording,0.147,646,813,1,1,0.573,0.537,0.474,1459
acquaintance,0.147,181,228,1,1,0.656,0.29,0.67,409
shotgun,0.147,119,150,1,1,0.2,0.868,0.684,269
organ,0.146,115,145,1,1,0.51,0.469,0.538,260
midst,0.146,1050,1322,1,1,0.324,0.275,0.296,2372
surprising,0.146,505,636,1,1,0.888,0.79,0.692,1141
endeavor,0.146,273,344,1,1,0.677,0.755,0.765,617
excrement,0.146,26,33,1,1,0.041,0.558,0.221,59
aghhh,0.146,26,33,1,1,0.281,0.635,0.243,59
grrrrr,0.146,26,33,1,1,0.281,0.633,0.444,59
toxicity,0.146,593,747,1,1,0.104,0.865,0.491,1340
unexplainable,0.146,134,169,1,1,0.26,0.448,0.61,303
stroller,0.146,26,33,1,1,0.786,0.398,0.314,59
arghh,0.146,26,33,1,1,0.292,0.536,0.397,59
eating,0.145,9939,12520,1,1,0.847,0.491,0.615,22459
wrapping,0.145,326,411,1,1,0.46,0.368,0.462,737
frequent,0.145,322,406,1,1,0.594,0.481,0.525,728
springtime,0.145,72,91,1,1,0.837,0.439,0.722,163
shrinking,0.145,95,120,1,1,0.19,0.4,0.217,215
scattered,0.145,383,483,1,1,0.208,0.38,0.238,866
slip,0.145,886,1117,1,1,0.316,0.714,0.321,2003
show,0.145,32447,40899,1,1,0.673,0.771,0.719,73346
fund,0.145,544,686,1,1,0.521,0.36,0.426,1230
midday,0.145,91,115,1,1,0.658,0.25,0.403,206
barge,0.145,68,86,1,1,0.469,0.388,0.465,154
stepmother,0.145,22,28,1,1,0.427,0.53,0.484,50
syphilis,0.145,22,28,1,1,0.071,0.606,0.245,50
face,0.144,22016,27765,1,1,0.571,0.173,0.453,49781
versus,0.144,309,390,1,1,0.31,0.5,0.447,699
dandy,0.144,87,110,1,1,0.673,0.52,0.63,197
lounge,0.144,263,332,1,1,0.592,0.245,0.466,595
outweigh,0.144,106,134,1,1,0.486,0.6,0.682,240
consume,0.144,717,905,1,1,0.427,0.62,0.509,1622
contrived,0.144,41,52,1,1,0.408,0.53,0.458,93
reckon,0.144,350,442,1,1,0.643,0.42,0.472,792
substance,0.143,502,634,1,1,0.615,0.422,0.528,1136
toast,0.143,521,658,1,1,0.74,0.382,0.356,1179
phase,0.143,1782,2250,1,1,0.645,0.3,0.482,4032
harlot,0.143,18,23,1,1,0.198,0.798,0.33,41
mechanical,0.143,75,95,1,1,0.479,0.569,0.564,170
newyear,0.143,18,23,1,1,0.938,0.784,0.52,41
saber,0.143,75,95,1,1,0.551,0.62,0.553,170
unsympathetic,0.143,18,23,1,1,0.163,0.62,0.281,41
undignified,0.143,18,23,1,1,0.122,0.627,0.308,41
apprenticeship,0.143,18,23,1,1,0.812,0.482,0.643,41
avenge,0.143,37,47,1,1,0.073,0.867,0.559,84
arrogant,0.143,531,671,1,1,0.115,0.755,0.58,1202
manned,0.143,18,23,1,1,0.551,0.588,0.484,41
subset,0.143,18,23,1,1,0.429,0.358,0.404,41
wrestle,0.142,128,162,1,1,0.388,0.89,0.765,290
trunk,0.142,90,114,1,1,0.271,0.167,0.404,204
viewer,0.142,181,229,1,1,0.592,0.358,0.558,410
fitness,0.142,268,339,1,1,0.875,0.529,0.81,607
neighbor,0.142,1177,1488,1,1,0.657,0.448,0.434,2665
persistence,0.142,105,133,1,1,0.684,0.611,0.873,238
similarity,0.142,52,66,1,1,0.729,0.255,0.518,118
stingy,0.142,86,109,1,1,0.094,0.548,0.283,195
short,0.142,5762,7286,1,1,0.184,0.264,0.237,13048
jacket,0.142,547,692,1,1,0.656,0.302,0.382,1239
flight,0.142,1605,2030,1,1,0.646,0.63,0.587,3635
mint,0.141,169,214,1,1,0.688,0.221,0.345,383
paradigm,0.141,67,85,1,1,0.573,0.429,0.779,152
infertile,0.141,33,42,1,1,0.274,0.458,0.255,75
coincide,0.141,33,42,1,1,0.635,0.49,0.593,75
offing,0.141,33,42,1,1,0.49,0.412,0.447,75
boston,0.141,505,639,1,1,0.643,0.38,0.58,1144
distressed,0.141,218,276,1,1,0.143,0.771,0.324,494
leaned,0.141,301,381,1,1,0.57,0.373,0.49,682
ladder,0.141,233,295,1,1,0.56,0.438,0.358,528
accountant,0.141,48,61,1,1,0.625,0.45,0.639,109
intoxicating,0.141,78,99,1,1,0.224,0.76,0.464,177
tooth,0.141,251,318,1,1,0.439,0.25,0.367,569
behold,0.14,247,313,1,1,0.61,0.284,0.449,560
landmark,0.14,44,56,1,1,0.694,0.355,0.681,100
busybody,0.14,14,18,1,1,0.255,0.634,0.472,32
parsley,0.14,14,18,1,1,0.458,0.17,0.291,32
mediterranean,0.14,29,37,1,1,0.663,0.454,0.545,66
pendant,0.14,29,37,1,1,0.676,0.321,0.385,66
winnings,0.14,14,18,1,1,0.949,0.829,0.83,32
trimming,0.14,14,18,1,1,0.5,0.478,0.325,32
bliss,0.14,865,1096,1,1,0.816,0.5,0.782,1961
object,0.14,407,516,1,1,0.531,0.356,0.375,923
math,0.14,972,1232,1,1,0.417,0.375,0.6,2204
arms,0.139,5898,7476,1,1,0.464,0.395,0.483,13374
incentive,0.139,70,89,1,1,0.812,0.618,0.718,159
elated,0.139,70,89,1,1,0.792,0.96,0.725,159
hobo,0.139,167,212,1,1,0.323,0.443,0.282,379
schedule,0.139,1632,2070,1,1,0.51,0.38,0.48,3702
reflective,0.139,122,155,1,1,0.656,0.292,0.735,277
ire,0.139,40,51,1,1,0.198,0.74,0.575,91
prestigious,0.139,40,51,1,1,0.979,0.644,0.925,91
operative,0.139,40,51,1,1,0.541,0.635,0.718,91
routine,0.139,1202,1525,1,1,0.365,0.219,0.333,2727
personality,0.138,3279,4160,1,1,0.896,0.513,0.79,7439
pew,0.138,66,84,1,1,0.449,0.235,0.664,150
psalms,0.138,200,254,1,1,0.602,0.252,0.534,454
scorn,0.138,66,84,1,1,0.11,0.721,0.356,150
scout,0.138,159,202,1,1,0.656,0.611,0.763,361
phenomenal,0.138,237,301,1,1,0.915,0.75,0.918,538
stays,0.138,2073,2631,1,1,0.633,0.363,0.564,4704
luncheon,0.138,25,32,1,1,0.837,0.24,0.441,57
qualifications,0.138,77,98,1,1,0.776,0.576,0.75,175
ante,0.138,25,32,1,1,0.448,0.32,0.417,57
pointless,0.138,998,1267,1,1,0.055,0.353,0.111,2265
participate,0.138,530,673,1,1,0.755,0.58,0.684,1203
couch,0.138,2323,2949,1,1,0.594,0.082,0.198,5272
bracelet,0.138,140,178,1,1,0.776,0.34,0.322,318
pitcher,0.137,62,79,1,1,0.51,0.673,0.704,141
mankind,0.137,351,446,1,1,0.823,0.471,0.768,797
consumption,0.137,162,206,1,1,0.39,0.531,0.538,368
graduation,0.137,536,681,1,1,0.88,0.67,0.837,1217
adoration,0.137,136,173,1,1,0.885,0.699,0.708,309
beat,0.137,4556,5787,1,1,0.279,0.647,0.492,10343
carnal,0.137,36,46,1,1,0.417,0.679,0.421,82
resurrect,0.137,36,46,1,1,0.781,0.725,0.817,82
keen,0.137,317,403,1,1,0.823,0.719,0.806,720
filter,0.137,365,464,1,1,0.44,0.296,0.26,829
central,0.137,694,882,1,1,0.64,0.356,0.621,1576
pump,0.137,291,370,1,1,0.417,0.882,0.681,661
zen,0.137,169,215,1,1,0.492,0.21,0.432,384
cookies,0.137,823,1046,1,1,0.823,0.451,0.316,1869
expansion,0.137,95,121,1,1,0.776,0.618,0.787,216
kos,0.137,47,60,1,1,0.5,0.471,0.407,107
remain,0.137,3395,4315,1,1,0.709,0.365,0.731,7710
cease,0.137,261,332,1,1,0.388,0.25,0.42,593
peer,0.136,593,754,1,1,0.458,0.321,0.569,1347
apply,0.136,1035,1316,1,1,0.612,0.321,0.667,2351
record,0.136,2145,2728,1,1,0.552,0.421,0.5,4873
rip,0.136,2957,3761,1,1,0.146,0.676,0.365,6718
disappear,0.136,2666,3392,1,1,0.143,0.441,0.35,6058
coma,0.136,179,228,1,1,0.219,0.255,0.302,407
discovery,0.136,414,527,1,1,0.823,0.627,0.814,941
witness,0.135,1265,1610,1,1,0.562,0.569,0.593,2875
attempt,0.135,1807,2300,1,1,0.625,0.491,0.431,4107
beret,0.135,21,27,1,1,0.542,0.24,0.327,48
unwavering,0.135,65,83,1,1,0.74,0.63,0.858,148
cutoff,0.135,21,27,1,1,0.432,0.51,0.518,48
spoonful,0.135,21,27,1,1,0.582,0.208,0.308,48
syringe,0.135,21,27,1,1,0.25,0.68,0.33,48
juvenile,0.135,87,111,1,1,0.678,0.49,0.526,198
discard,0.135,65,83,1,1,0.24,0.343,0.337,148
vulgarity,0.135,21,27,1,1,0.104,0.87,0.346,48
butcher,0.135,65,83,1,1,0.5,0.575,0.608,148
quickie,0.135,21,27,1,1,0.6,0.7,0.431,48
shack,0.135,182,232,1,1,0.396,0.425,0.339,414
ion,0.135,4049,5156,1,1,0.429,0.33,0.408,9205
elite,0.135,405,516,1,1,0.688,0.704,0.737,921
refer,0.135,445,567,1,1,0.506,0.358,0.558,1012
extraordinary,0.134,368,469,1,1,0.969,0.728,0.86,837
half,0.134,10729,13668,1,1,0.5,0.274,0.276,24397
basketball,0.134,455,580,1,1,0.814,0.764,0.435,1035
cheer,0.134,4084,5204,1,1,0.938,0.784,0.845,9288
flee,0.134,185,236,1,1,0.292,0.796,0.232,421
reconcile,0.134,123,157,1,1,0.76,0.47,0.625,280
abroad,0.134,910,1160,1,1,0.677,0.596,0.561,2070
chef,0.134,294,375,1,1,0.854,0.411,0.57,669
forest,0.134,1594,2032,1,1,0.729,0.27,0.435,3626
hideous,0.134,232,296,1,1,0.091,0.75,0.328,528
slope,0.134,90,115,1,1,0.347,0.438,0.279,205
vicinity,0.134,90,115,1,1,0.7,0.353,0.466,205
spot,0.133,3032,3866,1,1,0.51,0.18,0.336,6898
rocks,0.133,787,1004,1,1,0.365,0.209,0.543,1791
gist,0.133,97,124,1,1,0.622,0.45,0.519,221
special,0.133,9849,12565,1,1,0.844,0.602,0.73,22414
eyeball,0.133,28,36,1,1,0.526,0.422,0.42,64
overthinker,0.133,28,36,1,1,0.43,0.606,0.552,64
loophole,0.133,28,36,1,1,0.406,0.755,0.491,64
maniac,0.133,162,207,1,1,0.12,0.849,0.431,369
scarf,0.133,133,170,1,1,0.75,0.224,0.224,303
rot,0.132,614,784,1,1,0.031,0.558,0.301,1398
vibration,0.132,93,119,1,1,0.583,0.657,0.528,212
doubling,0.132,46,59,1,1,0.459,0.452,0.464,105
critique,0.132,140,179,1,1,0.302,0.76,0.537,319
xanax,0.132,140,179,1,1,0.427,0.402,0.446,319
recall,0.132,693,885,1,1,0.583,0.351,0.525,1578
heavy,0.132,3494,4461,1,1,0.25,0.454,0.6,7955
reader,0.132,411,525,1,1,0.776,0.224,0.602,936
downward,0.132,176,225,1,1,0.188,0.347,0.255,401
undergo,0.132,64,82,1,1,0.398,0.554,0.339,146
purpose,0.132,4752,6069,1,1,0.8,0.534,0.782,10821
geography,0.132,82,105,1,1,0.719,0.15,0.553,187
troublesome,0.132,100,128,1,1,0.283,0.894,0.404,228
difference,0.131,8159,10425,1,1,0.474,0.56,0.483,18584
remembering,0.131,1569,2005,1,1,0.535,0.386,0.509,3574
mutation,0.131,17,22,1,1,0.365,0.625,0.611,39
hemisphere,0.131,35,45,1,1,0.531,0.367,0.598,80
countess,0.131,17,22,1,1,0.562,0.44,0.67,39
persuade,0.131,107,137,1,1,0.62,0.618,0.709,244
chandelier,0.131,17,22,1,1,0.615,0.542,0.366,39
disciplined,0.131,71,91,1,1,0.728,0.45,0.75,162
seatbelt,0.131,35,45,1,1,0.656,0.314,0.726,80
stimulus,0.131,35,45,1,1,0.771,0.779,0.75,80
amicable,0.131,17,22,1,1,0.875,0.33,0.507,39
bloodthirsty,0.131,17,22,1,1,0.052,0.804,0.644,39
slack,0.131,215,275,1,1,0.521,0.283,0.446,490
mountains,0.131,999,1277,1,1,0.766,0.433,0.569,2276
bacon,0.131,344,440,1,1,0.698,0.406,0.295,784
glorious,0.131,480,614,1,1,0.959,0.673,0.827,1094
atheist,0.131,322,412,1,1,0.225,0.447,0.377,734
flipping,0.13,225,288,1,1,0.553,0.551,0.345,513
manic,0.13,336,430,1,1,0.054,0.892,0.368,766
impossibility,0.13,42,54,1,1,0.17,0.625,0.306,96
subsequently,0.13,67,86,1,1,0.38,0.337,0.336,153
loveee,0.13,117,150,1,1,0.927,0.592,0.693,267
jenny,0.13,267,342,1,1,0.542,0.406,0.407,609
vulnerability,0.13,767,982,1,1,0.25,0.51,0.267,1749
sonic,0.129,349,447,1,1,0.594,0.5,0.481,796
randomness,0.129,24,31,1,1,0.418,0.449,0.433,55
spear,0.129,49,63,1,1,0.51,0.601,0.5,112
frazzled,0.129,24,31,1,1,0.344,0.415,0.339,55
waste,0.129,4056,5193,1,1,0.041,0.51,0.184,9249
eater,0.129,131,168,1,1,0.459,0.337,0.51,299
plethora,0.129,81,104,1,1,0.646,0.602,0.547,185
gala,0.129,113,145,1,1,0.755,0.443,0.679,258
unusual,0.129,487,624,1,1,0.429,0.433,0.361,1111
frantic,0.129,88,113,1,1,0.21,0.89,0.627,201
association,0.129,305,391,1,1,0.745,0.5,0.817,696
tumultuous,0.128,31,40,1,1,0.208,0.622,0.59,71
chicken,0.128,1736,2225,1,1,0.594,0.306,0.394,3961
watermelon,0.128,102,131,1,1,0.714,0.23,0.239,233
ungodly,0.128,102,131,1,1,0.296,0.423,0.388,233
forevermore,0.128,70,90,1,1,0.843,0.425,0.614,160
silly,0.128,2082,2669,1,1,0.384,0.349,0.161,4751
favor,0.128,1145,1468,1,1,0.812,0.308,0.519,2613
start,0.128,27590,35368,1,1,0.684,0.43,0.589,62958
chased,0.128,265,340,1,1,0.188,0.83,0.287,605
clench,0.128,38,49,1,1,0.438,0.618,0.58,87
bowl,0.128,963,1235,1,1,0.625,0.377,0.358,2198
sheet,0.128,261,335,1,1,0.439,0.174,0.302,596
surly,0.127,45,58,1,1,0.221,0.469,0.493,103
transmission,0.127,45,58,1,1,0.688,0.49,0.611,103
op,0.127,519,666,1,1,0.48,0.402,0.349,1185
unpack,0.127,98,126,1,1,0.531,0.528,0.445,224
bump,0.127,539,692,1,1,0.286,0.458,0.368,1231
communion,0.127,119,153,1,1,0.765,0.357,0.607,272
sick,0.127,20189,25910,1,1,0.104,0.431,0.136,46099
inclined,0.127,186,239,1,1,0.469,0.347,0.402,425
target,0.127,1254,1610,1,1,0.633,0.573,0.798,2864
revision,0.126,80,103,1,1,0.417,0.459,0.71,183
stretch,0.126,702,902,1,1,0.604,0.578,0.5,1604
creative,0.126,1766,2269,1,1,0.917,0.518,0.788,4035
switch,0.126,1952,2508,1,1,0.5,0.538,0.509,4460
impression,0.126,596,766,1,1,0.684,0.557,0.577,1362
ahead,0.126,3818,4906,1,1,0.708,0.52,0.673,8724
selection,0.126,227,292,1,1,0.594,0.34,0.595,519
fourth,0.125,458,589,1,1,0.559,0.28,0.398,1047
nick,0.125,1043,1341,1,1,0.554,0.388,0.387,2384
subservient,0.125,27,35,1,1,0.255,0.402,0.339,62
humongous,0.125,27,35,1,1,0.378,0.538,0.536,62
binoculars,0.125,13,17,1,1,0.49,0.309,0.411,30
pseudonym,0.125,13,17,1,1,0.5,0.398,0.423,30
stitching,0.125,20,26,1,1,0.51,0.382,0.345,46
homeward,0.125,13,17,1,1,0.833,0.275,0.435,30
snicker,0.125,20,26,1,1,0.708,0.693,0.409,46
snacks,0.125,769,989,1,1,0.781,0.48,0.306,1758
strapping,0.125,13,17,1,1,0.552,0.413,0.454,30
pragmatic,0.125,48,62,1,1,0.573,0.433,0.637,110
tertiary,0.125,13,17,1,1,0.5,0.35,0.431,30
entrance,0.125,223,287,1,1,0.698,0.393,0.526,510
ended,0.125,4370,5620,1,1,0.302,0.5,0.5,9990
machine,0.125,1387,1784,1,1,0.51,0.5,0.707,3171
spill,0.125,408,525,1,1,0.408,0.633,0.456,933
possess,0.125,226,291,1,1,0.67,0.59,0.727,517
mold,0.125,219,282,1,1,0.33,0.274,0.402,501
persons,0.124,1018,1310,1,1,0.869,0.302,0.588,2328
turned,0.124,6199,7980,1,1,0.63,0.538,0.583,14179
bane,0.124,86,111,1,1,0.265,0.694,0.366,197
muscular,0.123,72,93,1,1,0.531,0.434,0.577,165
apocalyptic,0.123,72,93,1,1,0.173,0.88,0.75,165
inhale,0.123,138,178,1,1,0.427,0.34,0.492,316
peice,0.123,58,75,1,1,0.479,0.422,0.398,133
designated,0.123,110,142,1,1,0.5,0.412,0.616,252
stirring,0.123,162,209,1,1,0.582,0.702,0.558,371
petition,0.123,318,410,1,1,0.498,0.575,0.415,728
waiter,0.123,207,267,1,1,0.459,0.3,0.295,474
sentence,0.122,1036,1336,1,1,0.625,0.265,0.548,2372
fiancee,0.122,75,97,1,1,0.959,0.626,0.556,172
serve,0.122,1501,1936,1,1,0.622,0.4,0.384,3437
nature,0.122,4087,5271,1,1,0.857,0.184,0.643,9358
remembered,0.122,2142,2763,1,1,0.916,0.333,0.588,4905
writing,0.122,7916,10212,1,1,0.694,0.475,0.645,18128
anxious,0.121,6653,8585,1,1,0.281,0.875,0.434,15238
pollution,0.121,116,150,1,1,0.062,0.694,0.445,266
paw,0.121,171,221,1,1,0.417,0.36,0.286,392
science,0.121,1213,1566,1,1,0.588,0.429,0.741,2779
female,0.121,5343,6900,1,1,0.857,0.52,0.625,12243
septum,0.12,23,30,1,1,0.276,0.423,0.41,53
conquest,0.12,47,61,1,1,0.71,0.702,0.833,108
groggy,0.12,23,30,1,1,0.235,0.265,0.194,53
insulated,0.12,23,30,1,1,0.208,0.265,0.304,53
shriek,0.12,23,30,1,1,0.459,0.827,0.491,53
memorial,0.12,239,309,1,1,0.602,0.304,0.6,548
prudence,0.12,23,30,1,1,0.781,0.284,0.679,53
sunglasses,0.12,119,154,1,1,0.844,0.443,0.364,273
mobster,0.12,23,30,1,1,0.188,0.87,0.638,53
zilch,0.12,23,30,1,1,0.409,0.451,0.361,53
disconnects,0.12,23,30,1,1,0.256,0.357,0.241,53
shining,0.12,1370,1770,1,1,0.885,0.673,0.812,3140
pursue,0.12,657,849,1,1,0.417,0.783,0.536,1506
handshake,0.12,88,114,1,1,0.816,0.654,0.492,202
happily,0.12,1895,2449,1,1,1,0.69,0.674,4344
indicative,0.12,64,83,1,1,0.51,0.51,0.591,147
enslaved,0.12,64,83,1,1,0.104,0.72,0.321,147
leg,0.12,915,1183,1,1,0.51,0.373,0.313,2098
buggy,0.12,40,52,1,1,0.5,0.509,0.327,92
silky,0.12,40,52,1,1,0.802,0.397,0.271,92
cooler,0.12,262,339,1,1,0.664,0.375,0.46,601
backwards,0.119,552,714,1,1,0.302,0.372,0.33,1266
liquid,0.119,156,202,1,1,0.562,0.235,0.307,358
accidental,0.119,115,149,1,1,0.319,0.784,0.307,264
unforgettable,0.119,166,215,1,1,0.833,0.561,0.66,381
ignite,0.119,91,118,1,1,0.458,0.785,0.675,209
unlimited,0.119,217,281,1,1,0.75,0.623,0.679,498
jerks,0.119,217,281,1,1,0.214,0.788,0.395,498
football,0.119,1576,2039,1,1,0.755,0.76,0.582,3615
demonic,0.119,176,228,1,1,0.146,0.875,0.6,404
dean,0.119,812,1051,1,1,0.612,0.469,0.723,1863
polite,0.119,431,558,1,1,0.927,0.378,0.562,989
businesswoman,0.119,16,21,1,1,0.719,0.5,0.764,37
primate,0.119,16,21,1,1,0.561,0.363,0.402,37
craze,0.119,50,65,1,1,0.255,0.657,0.435,115
moldy,0.119,33,43,1,1,0.235,0.387,0.25,76
cheep,0.119,16,21,1,1,0.367,0.38,0.373,37
blitz,0.119,33,43,1,1,0.417,0.722,0.789,76
rectory,0.119,16,21,1,1,0.49,0.373,0.704,37
fervor,0.119,16,21,1,1,0.573,0.769,0.651,37
tinkering,0.119,16,21,1,1,0.531,0.49,0.448,37
turn,0.118,14354,18580,1,1,0.531,0.398,0.482,32934
misplaced,0.118,128,166,1,1,0.247,0.45,0.324,294
involvement,0.118,111,144,1,1,0.76,0.62,0.696,255
cesspool,0.118,77,100,1,1,0.167,0.46,0.409,177
witchcraft,0.118,77,100,1,1,0.183,0.779,0.555,177
sparkling,0.118,138,179,1,1,0.7,0.418,0.598,317
belong,0.118,4689,6074,1,1,0.643,0.405,0.569,10763
straight,0.118,6777,8779,1,1,0.667,0.298,0.669,15556
peppermint,0.117,43,56,1,1,0.72,0.264,0.271,99
squeak,0.117,43,56,1,1,0.271,0.679,0.3,99
deaf,0.117,493,639,1,1,0.186,0.324,0.161,1132
oblivious,0.117,239,310,1,1,0.229,0.388,0.355,549
madness,0.117,1246,1615,1,1,0.104,0.804,0.44,2861
walk,0.117,19640,25452,1,1,0.643,0.412,0.45,45092
intelligent,0.117,1181,1531,1,1,0.917,0.541,0.868,2712
punching,0.117,232,301,1,1,0.332,0.915,0.623,533
closure,0.117,286,371,1,1,0.229,0.22,0.412,657
converted,0.117,107,139,1,1,0.663,0.418,0.686,246
stimulate,0.117,53,69,1,1,0.792,0.798,0.754,122
linguistic,0.117,26,34,1,1,0.646,0.351,0.618,60
historical,0.117,235,305,1,1,0.653,0.357,0.833,540
establish,0.117,208,270,1,1,0.708,0.5,0.688,478
hunt,0.116,703,912,1,1,0.327,0.806,0.588,1615
dominate,0.116,127,165,1,1,0.439,0.814,0.953,292
pretzel,0.116,36,47,1,1,0.519,0.323,0.358,83
unjust,0.116,73,95,1,1,0.115,0.625,0.278,168
preserving,0.116,36,47,1,1,0.765,0.462,0.63,83
homestead,0.116,36,47,1,1,0.865,0.221,0.536,83
enjoyable,0.116,614,797,1,1,1,0.481,0.605,1411
unsettled,0.116,83,108,1,1,0.208,0.647,0.17,191
frowning,0.116,83,108,1,1,0.194,0.582,0.5,191
anticipation,0.116,130,169,1,1,0.698,0.539,0.711,299
upbringing,0.116,177,230,1,1,0.677,0.49,0.6,407
polish,0.116,224,291,1,1,0.604,0.412,0.533,515
snakes,0.116,647,840,1,1,0.176,0.662,0.606,1487
youth,0.116,2318,3009,1,1,0.938,0.608,0.736,5327
utterly,0.115,1143,1484,1,1,0.633,0.44,0.673,2627
list,0.115,4824,6263,1,1,0.528,0.26,0.402,11087
retrieve,0.115,56,73,1,1,0.74,0.576,0.705,129
table,0.115,3593,4666,1,1,0.551,0.17,0.284,8259
furiously,0.115,86,112,1,1,0.062,0.925,0.657,198
fifteen,0.115,193,251,1,1,0.49,0.29,0.443,444
sports,0.115,1183,1537,1,1,0.833,0.683,0.587,2720
rewind,0.114,176,229,1,1,0.46,0.551,0.431,405
barney,0.114,69,90,1,1,0.451,0.378,0.44,159
leaky,0.114,39,51,1,1,0.17,0.686,0.288,90
usefulness,0.114,19,25,1,1,0.806,0.519,0.741,44
storytelling,0.114,139,181,1,1,0.643,0.375,0.472,320
tightrope,0.114,29,38,1,1,0.354,0.653,0.279,67
morph,0.114,39,51,1,1,0.448,0.469,0.451,90
monstrosity,0.114,29,38,1,1,0.094,0.933,0.611,67
annihilated,0.114,19,25,1,1,0.08,0.76,0.324,44
extensive,0.114,109,142,1,1,0.635,0.52,0.76,251
limbo,0.114,209,272,1,1,0.385,0.284,0.309,481
wolverine,0.114,39,51,1,1,0.47,0.673,0.627,90
confusing,0.113,1319,1716,1,1,0.229,0.69,0.222,3035
pledge,0.113,235,306,1,1,0.719,0.49,0.764,541
meeting,0.113,4230,5504,1,1,0.75,0.569,0.613,9734
motherly,0.113,72,94,1,1,0.927,0.324,0.71,166
spicy,0.113,261,340,1,1,0.44,0.733,0.61,601
transformation,0.113,188,245,1,1,0.796,0.618,0.77,433
lance,0.113,420,547,1,1,0.406,0.62,0.587,967
sponsor,0.113,168,219,1,1,0.729,0.537,0.8,387
strain,0.113,168,219,1,1,0.19,0.75,0.38,387
ulterior,0.113,52,68,1,1,0.375,0.509,0.49,120
punishing,0.113,105,137,1,1,0.094,0.898,0.471,242
conservatism,0.113,52,68,1,1,0.406,0.369,0.633,120
cardiac,0.113,52,68,1,1,0.344,0.765,0.615,120
gentleman,0.112,519,676,1,1,0.823,0.439,0.712,1195
five,0.112,3118,4060,1,1,0.51,0.221,0.298,7178
fond,0.112,393,512,1,1,0.885,0.602,0.518,905
bones,0.112,1769,2304,1,1,0.281,0.343,0.358,4073
rapids,0.112,42,55,1,1,0.573,0.817,0.788,97
grunt,0.112,42,55,1,1,0.286,0.798,0.392,97
titanic,0.112,118,154,1,1,0.427,0.786,0.795,272
crying,0.112,20996,27354,1,1,0.153,0.704,0.208,48350
ideal,0.112,976,1272,1,1,0.802,0.437,0.736,2248
feign,0.112,32,42,1,1,0.34,0.394,0.356,74
contact,0.111,5331,6948,1,1,0.719,0.424,0.526,12279
commentary,0.111,332,433,1,1,0.602,0.402,0.446,765
undiscovered,0.111,55,72,1,1,0.438,0.347,0.261,127
compulsive,0.111,111,145,1,1,0.347,0.871,0.573,256
compassion,0.111,1636,2133,1,1,0.735,0.258,0.509,3769
camera,0.111,1359,1772,1,1,0.64,0.288,0.379,3131
razor,0.111,134,175,1,1,0.26,0.61,0.481,309
admit,0.111,5230,6820,1,1,0.538,0.423,0.667,12050
sparkle,0.111,124,162,1,1,0.819,0.765,0.51,286
grip,0.111,683,891,1,1,0.52,0.549,0.602,1574
inspector,0.111,45,59,1,1,0.418,0.58,0.852,104
deadbeat,0.111,68,89,1,1,0.229,0.453,0.368,157
bazaar,0.111,22,29,1,1,0.604,0.34,0.5,51
thin,0.111,1014,1323,1,1,0.469,0.337,0.356,2337
rambling,0.111,265,346,1,1,0.448,0.51,0.528,611
ethnic,0.11,117,153,1,1,0.583,0.373,0.555,270
vocal,0.11,756,987,1,1,0.583,0.352,0.34,1743
size,0.11,1348,1760,1,1,0.531,0.336,0.569,3108
continuous,0.11,215,281,1,1,0.625,0.509,0.58,496
feminine,0.11,215,281,1,1,0.802,0.52,0.394,496
cabbage,0.11,71,93,1,1,0.398,0.225,0.264,164
intrinsically,0.11,35,46,1,1,0.459,0.382,0.538,81
settled,0.11,732,956,1,1,0.521,0.51,0.473,1688
reserved,0.11,313,409,1,1,0.594,0.316,0.583,722
daylight,0.109,339,443,1,1,0.865,0.42,0.545,782
quarters,0.109,133,174,1,1,0.51,0.412,0.48,307
regress,0.109,48,63,1,1,0.255,0.442,0.3,111
graph,0.109,48,63,1,1,0.51,0.286,0.621,111
stressful,0.109,1972,2577,1,1,0.153,0.873,0.389,4549
beverage,0.109,87,114,1,1,0.635,0.49,0.389,201
tilt,0.109,87,114,1,1,0.365,0.549,0.463,201
sorority,0.109,100,131,1,1,0.635,0.637,0.627,231
crate,0.109,126,165,1,1,0.427,0.173,0.274,291
analysis,0.108,396,518,1,1,0.729,0.448,0.705,914
debate,0.108,1011,1322,1,1,0.408,0.691,0.683,2333
permanent,0.108,949,1241,1,1,0.745,0.345,0.736,2190
notice,0.108,4596,6010,1,1,0.646,0.408,0.491,10606
refinement,0.108,12,16,1,1,0.719,0.387,0.709,28
apostate,0.108,12,16,1,1,0.342,0.5,0.528,28
antelope,0.108,12,16,1,1,0.542,0.51,0.5,28
scoundrel,0.108,12,16,1,1,0.094,0.74,0.412,28
rectum,0.108,12,16,1,1,0.438,0.443,0.491,28
viscous,0.108,25,33,1,1,0.398,0.396,0.409,58
pressing,0.108,402,526,1,1,0.24,0.755,0.636,928
buckled,0.108,12,16,1,1,0.427,0.358,0.439,28
gross,0.108,1481,1937,1,1,0.115,0.575,0.181,3418
concierge,0.108,12,16,1,1,0.48,0.343,0.343,28
mull,0.108,25,33,1,1,0.663,0.34,0.594,58
fascinate,0.108,12,16,1,1,0.854,0.683,0.802,28
multinational,0.108,12,16,1,1,0.656,0.51,0.842,28
acknowledgement,0.108,142,186,1,1,0.819,0.539,0.83,328
purification,0.108,12,16,1,1,0.847,0.452,0.774,28
commonplace,0.108,38,50,1,1,0.52,0.337,0.442,88
prima,0.108,38,50,1,1,0.633,0.406,0.427,88
bevy,0.108,12,16,1,1,0.429,0.46,0.541,28
hose,0.108,51,67,1,1,0.469,0.288,0.263,118
droopy,0.108,12,16,1,1,0.438,0.35,0.297,28
commemoration,0.108,12,16,1,1,0.719,0.615,0.754,28
willpower,0.108,103,135,1,1,0.823,0.776,0.897,238
urinate,0.108,12,16,1,1,0.36,0.5,0.353,28
repulsive,0.108,171,224,1,1,0.146,0.775,0.425,395
handy,0.108,239,313,1,1,0.741,0.378,0.639,552
pitch,0.108,560,733,1,1,0.521,0.431,0.465,1293
delta,0.108,106,139,1,1,0.551,0.343,0.509,245
pork,0.107,135,177,1,1,0.37,0.45,0.333,312
remarry,0.107,54,71,1,1,0.653,0.791,0.54,125
gate,0.107,426,558,1,1,0.51,0.235,0.426,984
flap,0.107,41,54,1,1,0.275,0.385,0.344,95
piss,0.106,1116,1462,1,1,0.354,0.462,0.268,2578
bread,0.106,1442,1889,1,1,0.66,0.314,0.342,3331
proceed,0.106,254,333,1,1,0.729,0.63,0.565,587
atheism,0.106,70,92,1,1,0.276,0.46,0.481,162
newt,0.106,99,130,1,1,0.458,0.38,0.541,229
bender,0.106,57,75,1,1,0.49,0.51,0.466,132
relic,0.106,28,37,1,1,0.646,0.452,0.591,65
induction,0.106,28,37,1,1,0.392,0.593,0.627,65
seasoning,0.106,28,37,1,1,0.633,0.388,0.479,65
dictator,0.106,202,265,1,1,0.073,0.76,0.862,467
problematic,0.106,569,746,1,1,0.073,0.72,0.361,1315
bush,0.106,501,657,1,1,0.413,0.22,0.315,1158
unleash,0.106,73,96,1,1,0.479,0.775,0.559,169
rarely,0.106,2128,2790,1,1,0.408,0.367,0.366,4918
servant,0.105,269,353,1,1,0.34,0.408,0.331,622
intrinsic,0.105,44,58,1,1,0.406,0.471,0.526,102
tenth,0.105,60,79,1,1,0.51,0.349,0.382,139
generator,0.105,60,79,1,1,0.704,0.568,0.864,139
saw,0.105,14507,19026,1,1,0.316,0.541,0.518,33533
awaken,0.105,169,222,1,1,0.729,0.412,0.611,391
nonchalant,0.105,124,163,1,1,0.312,0.314,0.366,287
sweat,0.105,672,882,1,1,0.388,0.579,0.297,1554
hang,0.105,15855,20804,1,1,0.323,0.529,0.446,36659
achieved,0.105,534,701,1,1,0.896,0.519,0.775,1235
grandpa,0.105,771,1012,1,1,0.806,0.296,0.466,1783
chief,0.105,1008,1323,1,1,0.52,0.544,0.869,2331
daytime,0.104,191,251,1,1,0.75,0.324,0.454,442
regeneration,0.104,15,20,1,1,0.76,0.64,0.845,35
hombre,0.104,15,20,1,1,0.656,0.472,0.696,35
preclude,0.104,15,20,1,1,0.333,0.552,0.417,35
belligerent,0.104,31,41,1,1,0.344,0.68,0.594,72
buttocks,0.104,15,20,1,1,0.458,0.677,0.365,35
counterpart,0.104,63,83,1,1,0.448,0.608,0.577,146
cortex,0.104,15,20,1,1,0.594,0.439,0.529,35
undisputed,0.104,15,20,1,1,0.646,0.588,0.673,35
chipper,0.104,31,41,1,1,0.418,0.588,0.5,72
stereotyped,0.104,15,20,1,1,0.375,0.51,0.436,35
favoritism,0.104,15,20,1,1,0.582,0.559,0.658,35
absolution,0.104,31,41,1,1,0.715,0.5,0.664,72
progeny,0.104,15,20,1,1,0.571,0.351,0.58,35
student,0.104,2765,3632,1,1,0.634,0.318,0.537,6397
rage,0.103,1526,2005,1,1,0.082,0.888,0.658,3531
rushing,0.103,499,656,1,1,0.398,0.821,0.529,1155
puff,0.103,206,271,1,1,0.531,0.367,0.26,477
unwelcome,0.103,120,158,1,1,0.115,0.48,0.269,278
fundamentalist,0.103,34,45,1,1,0.49,0.43,0.759,79
blasphemy,0.103,34,45,1,1,0.146,0.794,0.406,79
rabid,0.103,104,137,1,1,0.089,0.827,0.454,241
pay,0.103,9197,12089,1,1,0.514,0.588,0.592,21286
encounter,0.103,628,826,1,1,0.865,0.702,0.689,1454
knack,0.103,53,70,1,1,0.562,0.518,0.82,123
convenient,0.103,504,663,1,1,0.846,0.491,0.574,1167
breaker,0.103,126,166,1,1,0.323,0.527,0.52,292
ultimately,0.102,1218,1602,1,1,0.385,0.48,0.558,2820
python,0.102,72,95,1,1,0.219,0.618,0.618,167
connected,0.102,3249,4273,1,1,0.816,0.55,0.612,7522
maternal,0.102,110,145,1,1,0.847,0.417,0.634,255
slight,0.102,573,754,1,1,0.521,0.24,0.155,1327
written,0.102,2731,3593,1,1,0.6,0.231,0.52,6324
exaggerate,0.102,56,74,1,1,0.193,0.76,0.529,130
duds,0.102,18,24,1,1,0.347,0.311,0.339,42
merchandise,0.102,56,74,1,1,0.594,0.46,0.621,130
psychics,0.102,18,24,1,1,0.49,0.529,0.692,42
concession,0.102,18,24,1,1,0.588,0.423,0.615,42
tantamount,0.102,18,24,1,1,0.633,0.288,0.67,42
hail,0.102,189,249,1,1,0.459,0.627,0.411,438
shank,0.102,18,24,1,1,0.53,0.393,0.286,42
lessening,0.102,18,24,1,1,0.375,0.3,0.277,42
erupt,0.102,18,24,1,1,0.188,0.82,0.818,42
twig,0.102,37,49,1,1,0.378,0.288,0.236,86
competitor,0.102,37,49,1,1,0.612,0.959,0.861,86
disfigured,0.102,18,24,1,1,0.153,0.613,0.336,42
decayed,0.102,18,24,1,1,0.017,0.375,0.169,42
trip,0.102,4641,6107,1,1,0.875,0.643,0.538,10748
noisy,0.102,458,603,1,1,0.271,0.812,0.561,1061
flexible,0.102,116,153,1,1,0.719,0.46,0.465,269
tolerable,0.101,119,157,1,1,0.75,0.35,0.374,276
pretense,0.101,40,53,1,1,0.323,0.6,0.54,93
carbon,0.101,163,215,1,1,0.604,0.36,0.35,378
press,0.101,1408,1855,1,1,0.552,0.52,0.491,3263
hypocritical,0.1,191,252,1,1,0.048,0.74,0.415,443
scope,0.1,128,169,1,1,0.656,0.386,0.718,297
paging,0.1,21,28,1,1,0.542,0.398,0.423,49
sparring,0.1,21,28,1,1,0.292,0.87,0.704,49
dependable,0.1,65,86,1,1,0.88,0.357,0.741,151
battalion,0.1,21,28,1,1,0.333,0.818,0.795,49
barrow,0.1,21,28,1,1,0.479,0.363,0.362,49
customized,0.1,21,28,1,1,0.625,0.504,0.59,49
upheaval,0.1,21,28,1,1,0.29,0.83,0.57,49
softening,0.1,21,28,1,1,0.7,0.255,0.361,49
pal,0.1,1372,1809,1,1,0.812,0.426,0.596,3181
heath,0.1,200,264,1,1,0.802,0.387,0.546,464
restricted,0.1,134,177,1,1,0.276,0.5,0.407,311
query,0.1,90,119,1,1,0.521,0.42,0.467,209
overflow,0.1,90,119,1,1,0.398,0.792,0.5,209
heartbeat,0.1,1069,1410,1,1,0.75,0.698,0.585,2479
suspension,0.1,68,90,1,1,0.288,0.53,0.426,158
abundant,0.099,115,152,1,1,0.958,0.59,0.76,267
avocado,0.099,115,152,1,1,0.677,0.255,0.287,267
stroke,0.099,566,747,1,1,0.562,0.44,0.57,1313
slaughter,0.099,118,156,1,1,0.052,0.953,0.602,274
mar,0.099,218,288,1,1,0.622,0.544,0.545,506
compound,0.099,121,160,1,1,0.635,0.385,0.735,281
year,0.099,48822,64430,1,1,0.542,0.284,0.415,113252
cosmetics,0.099,24,32,1,1,0.765,0.464,0.472,56
muck,0.099,49,65,1,1,0.347,0.423,0.272,114
inexpensive,0.099,24,32,1,1,0.694,0.414,0.26,56
walnut,0.099,24,32,1,1,0.688,0.302,0.255,56
endurance,0.099,74,98,1,1,0.592,0.745,0.76,172
discussion,0.099,1049,1385,1,1,0.333,0.842,0.536,2434
raider,0.098,52,69,1,1,0.302,0.86,0.525,121
domain,0.098,105,139,1,1,0.573,0.549,0.828,244
expire,0.098,52,69,1,1,0.573,0.745,0.702,121
contribution,0.098,211,279,1,1,0.854,0.452,0.76,490
contradiction,0.098,133,176,1,1,0.25,0.66,0.377,309
naturally,0.098,1021,1349,1,1,0.854,0.276,0.549,2370
hair,0.098,5448,7197,1,1,0.582,0.186,0.286,12645
awkward,0.098,4140,5470,1,1,0.296,0.65,0.358,9610
smug,0.098,192,254,1,1,0.198,0.552,0.587,446
eve,0.098,3606,4765,1,1,0.612,0.378,0.44,8371
commit,0.098,1474,1948,1,1,0.365,0.529,0.491,3422
article,0.098,2457,3247,1,1,0.594,0.28,0.481,5704
weak,0.098,6234,8238,1,1,0.18,0.241,0.045,14472
cubicle,0.098,111,147,1,1,0.479,0.343,0.417,258
horizontal,0.098,27,36,1,1,0.573,0.304,0.387,63
anathema,0.098,27,36,1,1,0.286,0.49,0.519,63
restrained,0.098,27,36,1,1,0.354,0.59,0.509,63
deflect,0.098,83,110,1,1,0.133,0.491,0.482,193
various,0.097,969,1281,1,1,0.5,0.296,0.342,2250
impressive,0.097,316,418,1,1,0.781,0.83,0.873,734
scolding,0.097,58,77,1,1,0.071,0.833,0.417,135
leeches,0.097,58,77,1,1,0.115,0.698,0.295,135
shred,0.097,120,159,1,1,0.224,0.75,0.627,279
squirm,0.097,30,40,1,1,0.235,0.824,0.373,70
aspire,0.097,185,245,1,1,0.812,0.469,0.722,430
pinkie,0.097,30,40,1,1,0.663,0.265,0.269,70
complex,0.097,1304,1725,1,1,0.388,0.608,0.55,3029
supper,0.096,163,216,1,1,0.708,0.429,0.552,379
sweets,0.096,296,392,1,1,0.91,0.422,0.321,688
journal,0.096,574,760,1,1,0.688,0.24,0.352,1334
unprovoked,0.096,33,44,1,1,0.565,0.327,0.385,77
cram,0.096,33,44,1,1,0.354,0.73,0.598,77
nutcase,0.096,33,44,1,1,0.286,0.775,0.259,77
atomic,0.096,33,44,1,1,0.327,0.817,0.713,77
dinner,0.096,5122,6780,1,1,0.823,0.392,0.379,11902
daycare,0.096,141,187,1,1,0.776,0.481,0.36,328
flustered,0.096,107,142,1,1,0.316,0.903,0.283,249
pumped,0.096,181,240,1,1,0.615,0.7,0.528,421
replica,0.095,36,48,1,1,0.48,0.52,0.493,84
imprint,0.095,36,48,1,1,0.615,0.574,0.685,84
job,0.095,13902,18412,1,1,0.694,0.541,0.717,32314
shout,0.095,2339,3099,1,1,0.229,0.925,0.444,5438
residence,0.095,156,207,1,1,0.615,0.382,0.585,363
past,0.095,18135,24027,1,1,0.49,0.422,0.311,42162
antichrist,0.095,39,52,1,1,0.082,0.837,0.544,91
repetition,0.095,79,105,1,1,0.375,0.519,0.396,184
unwilling,0.095,162,215,1,1,0.302,0.316,0.179,377
gathering,0.095,580,769,1,1,0.854,0.657,0.667,1349
wide,0.095,1748,2317,1,1,0.571,0.312,0.472,4065
plague,0.095,297,394,1,1,0.083,0.596,0.355,691
constitute,0.094,42,56,1,1,0.812,0.349,0.906,98
mass,0.094,1123,1489,1,1,0.458,0.245,0.277,2612
distracted,0.094,867,1150,1,1,0.194,0.392,0.213,2017
hiss,0.094,45,60,1,1,0.388,0.48,0.37,105
incite,0.094,45,60,1,1,0.449,0.736,0.642,105
tine,0.094,45,60,1,1,0.438,0.373,0.284,105
celebratory,0.094,45,60,1,1,0.857,0.653,0.845,105
mattress,0.094,235,312,1,1,0.612,0.255,0.397,547
surprise,0.094,1947,2583,1,1,0.875,0.875,0.562,4530
chunk,0.094,195,259,1,1,0.365,0.287,0.214,454
audience,0.093,1173,1557,1,1,0.698,0.61,0.613,2730
button,0.093,986,1309,1,1,0.52,0.22,0.343,2295
presentation,0.093,332,441,1,1,0.792,0.604,0.553,773
demonstrating,0.093,57,76,1,1,0.698,0.571,0.693,133
sofa,0.093,484,643,1,1,0.583,0.106,0.263,1127
tragedies,0.093,124,165,1,1,0.1,0.91,0.442,289
literal,0.093,813,1080,1,1,0.57,0.353,0.574,1893
touchy,0.093,127,169,1,1,0.323,0.51,0.343,296
spectacle,0.093,63,84,1,1,0.812,0.745,0.762,147
notable,0.092,66,88,1,1,0.76,0.45,0.696,154
completing,0.092,139,185,1,1,0.614,0.5,0.769,324
guarded,0.092,145,193,1,1,0.758,0.686,0.5,338
inadvertently,0.092,75,100,1,1,0.302,0.541,0.549,175
slogan,0.092,151,201,1,1,0.55,0.216,0.564,352
mumble,0.092,75,100,1,1,0.292,0.444,0.245,175
fetch,0.092,157,209,1,1,0.479,0.363,0.491,366
equation,0.092,157,209,1,1,0.479,0.384,0.608,366
aim,0.092,558,742,1,1,0.481,0.569,0.567,1300
sissy,0.092,251,334,1,1,0.333,0.562,0.232,585
alternative,0.091,711,946,1,1,0.628,0.373,0.631,1657
cry,0.091,31533,41942,1,1,0.133,0.627,0.255,73475
senses,0.091,480,639,1,1,0.74,0.461,0.693,1119
unanswered,0.091,120,160,1,1,0.276,0.361,0.219,280
pension,0.091,250,333,1,1,0.625,0.409,0.406,583
rehab,0.091,268,357,1,1,0.531,0.45,0.593,625
division,0.09,416,554,1,1,0.37,0.481,0.472,970
cracking,0.09,328,437,1,1,0.327,0.557,0.286,765
wrecked,0.09,207,276,1,1,0.078,0.618,0.28,483
pat,0.09,653,870,1,1,0.418,0.377,0.34,1523
specially,0.09,1029,1371,1,1,0.847,0.398,0.714,2400
established,0.089,294,392,1,1,0.796,0.394,0.694,686
language,0.089,2235,2978,1,1,0.677,0.337,0.704,5213
competition,0.089,681,908,1,1,0.58,0.79,0.798,1589
working,0.089,15734,20977,1,1,0.74,0.585,0.576,36711
coroner,0.089,17,23,1,1,0.323,0.558,0.526,40
alleyway,0.089,50,67,1,1,0.357,0.471,0.382,117
munchkin,0.089,29,39,1,1,0.49,0.466,0.374,68
nakedness,0.089,20,27,1,1,0.48,0.76,0.35,47
superhuman,0.089,47,63,1,1,0.81,0.745,0.895,110
holster,0.089,11,15,1,1,0.561,0.255,0.339,26
distraught,0.089,161,215,1,1,0.115,0.903,0.264,376
comprise,0.089,17,23,1,1,0.839,0.373,0.669,40
incense,0.089,41,55,1,1,0.698,0.275,0.328,96
consolidate,0.089,11,15,1,1,0.88,0.44,0.87,26
deck,0.089,299,399,1,1,0.42,0.333,0.394,698
asphyxiation,0.089,14,19,1,1,0.059,0.745,0.412,33
junky,0.089,11,15,1,1,0.385,0.595,0.343,26
snip,0.089,29,39,1,1,0.417,0.327,0.268,68
narrate,0.089,35,47,1,1,0.541,0.48,0.473,82
arseholes,0.089,53,71,1,1,0.188,0.545,0.351,124
lapsed,0.089,11,15,1,1,0.357,0.333,0.276,26
ambivalent,0.089,50,67,1,1,0.51,0.404,0.482,117
diverting,0.089,14,19,1,1,0.396,0.571,0.537,33
crummy,0.089,38,51,1,1,0.125,0.531,0.224,89
novice,0.089,20,27,1,1,0.429,0.346,0.18,47
proxy,0.089,62,83,1,1,0.521,0.408,0.52,145
drawback,0.089,26,35,1,1,0.302,0.422,0.148,61
incomprehensible,0.089,68,91,1,1,0.25,0.55,0.344,159
buzzing,0.089,185,247,1,1,0.43,0.588,0.37,432
correction,0.089,209,279,1,1,0.448,0.485,0.558,488
unaffected,0.089,26,35,1,1,0.542,0.265,0.571,61
empathic,0.089,59,79,1,1,0.76,0.57,0.558,138
database,0.089,41,55,1,1,0.604,0.286,0.644,96
liaison,0.089,14,19,1,1,0.698,0.337,0.472,33
bonehead,0.089,11,15,1,1,0.337,0.521,0.518,26
theology,0.089,80,107,1,1,0.448,0.33,0.711,187
unscrupulous,0.089,20,27,1,1,0.094,0.727,0.465,47
evacuation,0.089,20,27,1,1,0.16,0.755,0.582,47
briefcase,0.089,14,19,1,1,0.542,0.206,0.442,33
weaponry,0.089,14,19,1,1,0.219,0.84,0.87,33
beads,0.089,35,47,1,1,0.673,0.388,0.552,82
manna,0.089,11,15,1,1,0.698,0.294,0.544,26
sleaze,0.089,17,23,1,1,0.312,0.538,0.405,40
reigning,0.089,14,19,1,1,0.677,0.632,0.87,33
ovation,0.089,29,39,1,1,0.719,0.758,0.75,68
spacing,0.089,41,55,1,1,0.621,0.425,0.507,96
goggles,0.089,32,43,1,1,0.667,0.36,0.278,75
discernible,0.089,23,31,1,1,0.427,0.441,0.481,54
sociology,0.089,59,79,1,1,0.615,0.439,0.694,138
capitulation,0.089,11,15,1,1,0.375,0.546,0.615,26
unoccupied,0.089,23,31,1,1,0.258,0.245,0.412,54
iteration,0.089,26,35,1,1,0.531,0.449,0.486,61
costly,0.089,92,123,1,1,0.316,0.65,0.642,215
chatter,0.089,140,187,1,1,0.56,0.45,0.347,327
cull,0.089,17,23,1,1,0.365,0.702,0.464,40
acumen,0.089,11,15,1,1,0.564,0.66,0.679,26
mediation,0.089,29,39,1,1,0.661,0.35,0.657,68
mirror,0.088,3113,4152,1,1,0.677,0.31,0.438,7265
extent,0.088,762,1017,1,1,0.646,0.451,0.602,1779
partnership,0.088,349,466,1,1,0.786,0.387,0.545,815
occur,0.088,343,458,1,1,0.451,0.561,0.51,801
stripped,0.088,235,314,1,1,0.255,0.615,0.278,549
wrenching,0.087,199,266,1,1,0.204,0.833,0.483,465
identity,0.087,1433,1914,1,1,0.663,0.36,0.78,3347
bearable,0.087,362,484,1,1,0.542,0.375,0.605,846
fuzzy,0.086,222,297,1,1,0.306,0.472,0.158,519
inner,0.086,2500,3342,1,1,0.551,0.216,0.443,5842
bakery,0.086,94,126,1,1,0.802,0.5,0.38,220
formal,0.086,183,245,1,1,0.735,0.25,0.625,428
cut,0.086,6623,8855,1,1,0.49,0.49,0.393,15478
nanny,0.086,177,237,1,1,0.615,0.37,0.528,414
asylum,0.086,263,352,1,1,0.407,0.33,0.445,615
restart,0.086,174,233,1,1,0.531,0.519,0.554,407
outing,0.086,159,213,1,1,0.771,0.672,0.634,372
plaza,0.085,76,102,1,1,0.69,0.346,0.529,178
gown,0.085,76,102,1,1,0.625,0.283,0.421,178
edit,0.085,754,1009,1,1,0.51,0.41,0.544,1763
smirk,0.085,224,300,1,1,0.792,0.596,0.583,524
hyped,0.085,437,585,1,1,0.708,0.582,0.679,1022
state,0.085,9089,12162,1,1,0.562,0.32,0.604,21251
disloyal,0.085,67,90,1,1,0.062,0.582,0.245,157
pain,0.085,31679,42396,1,1,0.012,0.765,0.395,74075
plea,0.085,200,268,1,1,0.633,0.491,0.517,468
intensive,0.085,64,86,1,1,0.57,0.842,0.776,150
observant,0.085,64,86,1,1,0.74,0.422,0.708,150
incoherent,0.085,61,82,1,1,0.122,0.612,0.25,143
announcement,0.084,353,473,1,1,0.729,0.491,0.482,826
dining,0.084,406,544,1,1,0.724,0.35,0.459,950
briefly,0.084,285,382,1,1,0.686,0.314,0.33,667
newsroom,0.084,55,74,1,1,0.531,0.392,0.658,129
training,0.084,1500,2010,1,1,0.714,0.776,0.788,3510
world,0.084,82576,110640,1,1,0.622,0.394,0.75,193216
critic,0.084,152,204,1,1,0.264,0.604,0.686,356
captain,0.084,1008,1351,1,1,0.552,0.653,0.966,2359
onstage,0.084,49,66,1,1,0.719,0.673,0.583,115
undoing,0.084,49,66,1,1,0.219,0.452,0.298,115
runway,0.084,49,66,1,1,0.585,0.373,0.406,115
donation,0.084,199,267,1,1,0.792,0.398,0.602,466
psychiatric,0.084,146,196,1,1,0.21,0.616,0.525,342
flickering,0.084,96,129,1,1,0.49,0.444,0.289,225
distraction,0.083,966,1295,1,1,0.402,0.557,0.39,2261
lousy,0.083,143,192,1,1,0.125,0.482,0.234,335
geographic,0.083,46,62,1,1,0.698,0.33,0.664,108
network,0.083,1488,1995,1,1,0.531,0.337,0.466,3483
trait,0.083,645,865,1,1,0.469,0.365,0.453,1510
greater,0.083,1607,2155,1,1,0.755,0.519,0.796,3762
body,0.083,11819,15848,1,1,0.694,0.461,0.571,27667
gracias,0.083,87,117,1,1,0.833,0.356,0.6,204
ponytail,0.083,43,58,1,1,0.541,0.337,0.302,101
cough,0.083,559,750,1,1,0.255,0.627,0.241,1309
arranged,0.083,207,278,1,1,0.698,0.531,0.728,485
eye,0.083,4273,5732,1,1,0.531,0.265,0.425,10005
glimpse,0.083,412,553,1,1,0.646,0.48,0.455,965
diligent,0.083,40,54,1,1,0.76,0.426,0.759,94
heartburn,0.083,40,54,1,1,0.143,0.613,0.398,94
stab,0.082,391,525,1,1,0.167,0.882,0.595,916
maintain,0.082,894,1200,1,1,0.684,0.398,0.647,2094
mayonnaise,0.082,37,50,1,1,0.51,0.32,0.222,87
disinterested,0.082,75,101,1,1,0.398,0.284,0.392,176
tireless,0.082,37,50,1,1,0.657,0.75,0.645,87
chainsaw,0.082,37,50,1,1,0.367,0.804,0.636,87
entry,0.082,417,560,1,1,0.552,0.353,0.602,977
fled,0.082,113,152,1,1,0.224,0.639,0.322,265
maturity,0.082,291,391,1,1,0.827,0.4,0.806,682
male,0.082,4341,5829,1,1,0.612,0.532,0.695,10170
bis,0.082,34,46,1,1,0.44,0.42,0.345,80
gallows,0.082,34,46,1,1,0.167,0.712,0.422,80
harmonious,0.082,34,46,1,1,0.938,0.391,0.719,80
aspects,0.081,626,841,1,1,0.439,0.48,0.565,1467
stealing,0.081,585,786,1,1,0.086,0.913,0.455,1371
intimidating,0.081,343,461,1,1,0.229,0.79,0.708,804
forget,0.081,18351,24658,1,1,0.312,0.382,0.209,43009
seating,0.081,127,171,1,1,0.552,0.265,0.286,298
incompatible,0.081,63,85,1,1,0.196,0.5,0.31,148
task,0.081,831,1117,1,1,0.55,0.353,0.5,1948
rampant,0.081,188,253,1,1,0.49,0.788,0.526,441
vitamin,0.081,124,167,1,1,0.827,0.33,0.56,291
smiled,0.081,1501,2018,1,1,0.949,0.53,0.536,3519
avail,0.08,121,163,1,1,0.8,0.43,0.603,284
flux,0.08,28,38,1,1,0.473,0.472,0.451,66
disconnect,0.08,376,506,1,1,0.438,0.292,0.191,882
slob,0.08,86,116,1,1,0.275,0.365,0.3,202
chewy,0.08,28,38,1,1,0.625,0.418,0.39,66
fed,0.08,2056,2766,1,1,0.602,0.37,0.482,4822
claim,0.08,1974,2656,1,1,0.255,0.76,0.473,4630
possessed,0.08,193,260,1,1,0.327,0.884,0.611,453
yap,0.08,54,73,1,1,0.51,0.458,0.37,127
homosexuality,0.08,109,147,1,1,0.367,0.696,0.429,256
threshold,0.079,77,104,1,1,0.531,0.519,0.575,181
ace,0.079,701,944,1,1,0.643,0.481,0.546,1645
tirade,0.079,25,34,1,1,0.378,0.587,0.532,59
mosquito,0.079,77,104,1,1,0.229,0.4,0.198,181
larger,0.079,513,691,1,1,0.729,0.654,0.763,1204
disturbed,0.079,484,652,1,1,0.125,0.87,0.305,1136
crispy,0.078,48,65,1,1,0.656,0.55,0.509,113
xenophobia,0.078,48,65,1,1,0.156,0.771,0.5,113
happy,0.078,81743,110120,1,1,1,0.735,0.772,191863
lecturer,0.078,94,127,1,1,0.677,0.549,0.736,221
passionate,0.078,796,1073,1,1,0.99,0.827,0.731,1869
package,0.078,534,720,1,1,0.571,0.433,0.443,1254
assimilation,0.078,22,30,1,1,0.429,0.378,0.463,52
biologist,0.078,22,30,1,1,0.625,0.453,0.693,52
bell,0.078,847,1142,1,1,0.552,0.51,0.505,1989
justification,0.078,111,150,1,1,0.622,0.444,0.661,261
damages,0.077,88,119,1,1,0.082,0.76,0.31,207
repay,0.077,154,208,1,1,0.469,0.632,0.592,362
medicine,0.077,1158,1562,1,1,0.708,0.318,0.679,2720
interface,0.077,42,57,1,1,0.643,0.357,0.6,99
sponge,0.077,85,115,1,1,0.551,0.192,0.219,200
roam,0.077,406,548,1,1,0.51,0.55,0.444,954
spouse,0.077,973,1313,1,1,0.75,0.6,0.645,2286
stumble,0.077,314,424,1,1,0.153,0.716,0.259,738
dozen,0.077,417,563,1,1,0.583,0.343,0.425,980
optimistic,0.077,437,590,1,1,0.979,0.58,0.821,1027
discuss,0.077,1364,1841,1,1,0.396,0.769,0.509,3205
discourse,0.077,205,277,1,1,0.41,0.55,0.803,482
zombie,0.077,411,555,1,1,0.214,0.648,0.415,966
inflict,0.077,102,138,1,1,0.167,0.76,0.609,240
spelling,0.077,245,331,1,1,0.594,0.357,0.398,576
soviet,0.076,59,80,1,1,0.347,0.58,0.536,139
retainer,0.076,19,26,1,1,0.396,0.422,0.356,45
undergraduate,0.076,19,26,1,1,0.583,0.5,0.559,45
undertaker,0.076,19,26,1,1,0.363,0.696,0.611,45
tightness,0.076,19,26,1,1,0.344,0.606,0.759,45
signpost,0.076,19,26,1,1,0.51,0.4,0.446,45
speculative,0.076,19,26,1,1,0.276,0.591,0.464,45
frenzy,0.076,59,80,1,1,0.61,0.965,0.682,139
palliative,0.076,39,53,1,1,0.548,0.394,0.518,92
volition,0.076,19,26,1,1,0.48,0.587,0.578,45
aggressive,0.076,618,835,1,1,0.125,0.949,0.648,1453
pod,0.076,230,311,1,1,0.48,0.396,0.339,541
caller,0.076,113,153,1,1,0.646,0.615,0.472,266
tremble,0.075,93,126,1,1,0.177,0.878,0.388,219
woman,0.075,24506,33110,1,1,0.865,0.5,0.578,57616
wag,0.075,261,353,1,1,0.448,0.49,0.481,614
slimy,0.075,73,99,1,1,0.177,0.5,0.309,172
reinforce,0.075,110,149,1,1,0.604,0.583,0.76,259
advisory,0.075,36,49,1,1,0.656,0.429,0.633,85
mode,0.075,1348,1822,1,1,0.531,0.185,0.367,3170
fence,0.075,400,541,1,1,0.5,0.198,0.398,941
graphic,0.075,235,318,1,1,0.602,0.494,0.491,553
talk,0.074,92428,124998,1,1,0.833,0.346,0.594,217426
starve,0.074,538,728,1,1,0.073,0.729,0.402,1266
grandson,0.074,155,210,1,1,0.778,0.333,0.5,365
loyalty,0.074,872,1180,1,1,0.885,0.406,0.793,2052
redundancy,0.074,16,22,1,1,0.316,0.262,0.589,38
offside,0.074,16,22,1,1,0.323,0.519,0.443,38
convertible,0.074,16,22,1,1,0.542,0.529,0.717,38
innovate,0.074,16,22,1,1,0.898,0.872,0.75,38
eminent,0.074,16,22,1,1,0.74,0.62,0.83,38
opaque,0.074,16,22,1,1,0.344,0.265,0.342,38
deteriorating,0.074,101,137,1,1,0.104,0.459,0.112,238
predecessor,0.074,16,22,1,1,0.635,0.415,0.593,38
ascendant,0.074,16,22,1,1,0.656,0.673,0.821,38
valuables,0.074,16,22,1,1,0.79,0.625,0.759,38
idolizing,0.074,33,45,1,1,0.676,0.712,0.643,78
spite,0.074,568,769,1,1,0.08,0.6,0.317,1337
dairy,0.074,149,202,1,1,0.633,0.255,0.462,351
rising,0.073,852,1154,1,1,0.75,0.602,0.696,2006
item,0.073,287,389,1,1,0.594,0.27,0.465,676
originality,0.073,47,64,1,1,0.898,0.5,0.824,111
merge,0.073,78,106,1,1,0.76,0.48,0.733,184
splinter,0.073,30,41,1,1,0.136,0.422,0.325,71
uninhabited,0.073,30,41,1,1,0.301,0.23,0.221,71
murmur,0.073,30,41,1,1,0.458,0.52,0.2,71
moderate,0.073,216,293,1,1,0.582,0.19,0.453,509
stubborn,0.073,540,732,1,1,0.157,0.702,0.575,1272
rick,0.072,475,644,1,1,0.459,0.42,0.444,1119
burial,0.072,75,102,1,1,0.203,0.577,0.333,177
fascist,0.072,272,369,1,1,0.2,0.755,0.527,641
water,0.072,5923,8028,1,1,0.812,0.123,0.429,13951
strange,0.072,4710,6385,1,1,0.314,0.663,0.395,11095
ware,0.072,44,60,1,1,0.604,0.443,0.455,104
hometown,0.072,575,780,1,1,0.858,0.333,0.605,1355
abysmal,0.072,58,79,1,1,0.25,0.71,0.598,137
appreciation,0.072,853,1157,1,1,0.917,0.529,0.588,2010
overdue,0.072,131,178,1,1,0.125,0.427,0.259,309
turning,0.072,2869,3891,1,1,0.51,0.684,0.42,6760
negative,0.072,4893,6636,1,1,0.102,0.527,0.176,11529
lump,0.072,218,296,1,1,0.438,0.337,0.463,514
today,0.072,61065,82818,1,1,0.806,0.306,0.362,143883
direct,0.072,956,1297,1,1,0.793,0.403,0.65,2253
winning,0.071,1312,1780,1,1,0.955,0.712,0.972,3092
gouge,0.071,13,18,1,1,0.396,0.441,0.4,31
criticize,0.071,223,303,1,1,0.143,0.708,0.473,526
clause,0.071,55,75,1,1,0.48,0.409,0.528,130
soprano,0.071,27,37,1,1,0.552,0.55,0.685,64
argumentative,0.071,27,37,1,1,0.45,0.531,0.679,64
antiques,0.071,13,18,1,1,0.54,0.37,0.595,31
itinerary,0.071,27,37,1,1,0.551,0.55,0.454,64
presto,0.071,13,18,1,1,0.573,0.415,0.433,31
battleship,0.071,13,18,1,1,0.479,0.75,0.726,31
incapacity,0.071,13,18,1,1,0.052,0.5,0.217,31
facilitate,0.071,83,113,1,1,0.812,0.333,0.509,196
kink,0.071,276,375,1,1,0.337,0.634,0.321,651
liberal,0.071,1512,2053,1,1,0.565,0.565,0.755,3565
theory,0.071,1154,1567,1,1,0.583,0.314,0.529,2721
shipping,0.071,382,519,1,1,0.622,0.327,0.443,901
t-shirt,0.07,270,367,1,1,0.815,0.286,0.284,637
medicate,0.07,80,109,1,1,0.417,0.375,0.546,189
shovel,0.07,80,109,1,1,0.427,0.308,0.267,189
convention,0.07,281,382,1,1,0.622,0.622,0.704,663
broadcast,0.07,334,454,1,1,0.615,0.587,0.355,788
married,0.07,10227,13891,1,1,0.674,0.57,0.602,24118
tub,0.07,440,598,1,1,0.449,0.235,0.265,1038
heroin,0.07,186,253,1,1,0.276,0.843,0.655,439
suggestion,0.07,412,560,1,1,0.646,0.365,0.558,972
specific,0.07,1544,2098,1,1,0.656,0.388,0.691,3642
event,0.07,2829,3844,1,1,0.745,0.673,0.664,6673
occupying,0.07,91,124,1,1,0.573,0.462,0.519,215
essentially,0.07,590,802,1,1,0.75,0.373,0.802,1392
arrogance,0.069,269,366,1,1,0.143,0.75,0.62,635
nineteen,0.069,63,86,1,1,0.673,0.304,0.375,149
demeaning,0.069,74,101,1,1,0.104,0.645,0.308,175
hideaway,0.069,24,33,1,1,0.448,0.481,0.36,57
esteemed,0.069,24,33,1,1,0.694,0.418,0.531,57
continental,0.069,24,33,1,1,0.486,0.35,0.755,57
disposed,0.069,24,33,1,1,0.688,0.441,0.625,57
muzzle,0.069,24,33,1,1,0.388,0.43,0.232,57
recklessness,0.069,24,33,1,1,0.292,0.763,0.38,57
grab,0.069,1718,2337,1,1,0.448,0.706,0.538,4055
significance,0.069,135,184,1,1,0.82,0.46,0.644,319
generally,0.069,1492,2030,1,1,0.562,0.255,0.473,3522
unexpectedly,0.069,282,384,1,1,0.354,0.759,0.462,666
longtime,0.069,85,116,1,1,0.362,0.442,0.546,201
environmental,0.068,146,199,1,1,0.633,0.313,0.664,345
binding,0.068,60,82,1,1,0.438,0.425,0.64,142
surprises,0.068,243,331,1,1,0.875,0.769,0.632,574
cultivate,0.068,193,263,1,1,0.708,0.41,0.598,456
liability,0.068,132,180,1,1,0.646,0.5,0.802,312
decade,0.068,877,1194,1,1,0.531,0.402,0.665,2071
arbitrary,0.068,71,97,1,1,0.281,0.702,0.686,168
oncoming,0.068,35,48,1,1,0.594,0.625,0.773,83
humbug,0.068,35,48,1,1,0.219,0.622,0.456,83
devote,0.068,107,146,1,1,0.802,0.49,0.642,253
wonderfully,0.068,212,289,1,1,0.969,0.76,0.821,501
differ,0.068,176,240,1,1,0.23,0.398,0.396,416
tempting,0.068,223,304,1,1,0.615,0.74,0.519,527
keyword,0.068,46,63,1,1,0.602,0.52,0.747,109
uninterested,0.068,140,191,1,1,0.365,0.24,0.328,331
soak,0.067,209,285,1,1,0.48,0.37,0.24,494
substantial,0.067,104,142,1,1,0.59,0.49,0.69,246
uncanny,0.067,57,78,1,1,0.469,0.461,0.43,135
kook,0.067,159,217,1,1,0.417,0.471,0.398,376
outdoors,0.067,203,277,1,1,0.781,0.444,0.453,480
slander,0.067,225,307,1,1,0.184,0.604,0.454,532
rut,0.067,178,243,1,1,0.333,0.31,0.392,421
booking,0.066,197,269,1,1,0.708,0.503,0.583,466
grandchild,0.066,65,89,1,1,0.781,0.433,0.465,154
peanuts,0.066,76,104,1,1,0.542,0.294,0.324,180
morgue,0.066,32,44,1,1,0.022,0.539,0.241,76
sketching,0.066,54,74,1,1,0.729,0.327,0.4,128
kimono,0.066,21,29,1,1,0.643,0.28,0.363,50
transition,0.066,700,955,1,1,0.605,0.561,0.558,1655
verge,0.066,502,685,1,1,0.5,0.337,0.305,1187
conditions,0.066,895,1221,1,1,0.551,0.441,0.593,2116
consistency,0.066,194,265,1,1,0.714,0.5,0.887,459
annoying,0.066,6872,9375,1,1,0.082,0.853,0.348,16247
contents,0.066,128,175,1,1,0.656,0.375,0.55,303
pun,0.066,718,980,1,1,0.653,0.529,0.457,1698
area,0.065,3413,4658,1,1,0.49,0.306,0.464,8071
neighborhood,0.065,753,1028,1,1,0.385,0.469,0.373,1781
hide,0.065,5491,7495,1,1,0.438,0.51,0.218,12986
fallacy,0.065,62,85,1,1,0.112,0.561,0.43,147
barely,0.065,3987,5443,1,1,0.448,0.183,0.268,9430
birthday,0.065,11960,16327,1,1,0.969,0.844,0.575,28287
logical,0.065,426,582,1,1,0.805,0.4,0.648,1008
mini,0.065,754,1030,1,1,0.421,0.324,0.221,1784
lecture,0.065,368,503,1,1,0.594,0.462,0.737,871
coupon,0.065,40,55,1,1,0.704,0.3,0.421,95
princess,0.065,1874,2560,1,1,0.885,0.557,0.62,4434
seat,0.064,1875,2562,1,1,0.542,0.281,0.434,4437
stocks,0.064,100,137,1,1,0.573,0.598,0.586,237
uproar,0.064,29,40,1,1,0.271,0.902,0.462,69
trade,0.064,1335,1825,1,1,0.561,0.544,0.69,3160
due,0.064,6133,8384,1,1,0.562,0.34,0.467,14517
incarceration,0.063,48,66,1,1,0.1,0.8,0.397,114
turbulent,0.063,48,66,1,1,0.302,0.792,0.612,114
potatoes,0.063,282,386,1,1,0.69,0.271,0.309,668
booster,0.063,67,92,1,1,0.755,0.6,0.8,159
amber,0.063,377,516,1,1,0.635,0.308,0.369,893
progression,0.063,154,211,1,1,0.74,0.562,0.8,365
note,0.063,3238,4431,1,1,0.594,0.163,0.416,7669
freckle,0.063,18,25,1,1,0.542,0.396,0.254,43
bombard,0.063,37,51,1,1,0.156,0.961,0.777,88
quarterback,0.063,18,25,1,1,0.677,0.726,0.767,43
indignant,0.063,18,25,1,1,0.26,0.6,0.423,43
beholden,0.063,18,25,1,1,0.296,0.555,0.212,43
antenna,0.063,18,25,1,1,0.521,0.327,0.358,43
illustrious,0.063,18,25,1,1,0.673,0.55,0.741,43
trespass,0.063,18,25,1,1,0.229,0.67,0.613,43
intervening,0.063,18,25,1,1,0.398,0.627,0.442,43
whiff,0.063,37,51,1,1,0.459,0.4,0.331,88
notion,0.062,365,500,1,1,0.612,0.284,0.667,865
fright,0.062,102,140,1,1,0.177,0.816,0.191,242
give,0.062,49747,68111,1,1,0.75,0.346,0.5,117858
competitive,0.062,240,329,1,1,0.447,0.718,0.908,569
outfit,0.062,443,607,1,1,0.76,0.49,0.566,1050
gemini,0.062,578,792,1,1,0.531,0.32,0.327,1370
hay,0.062,394,540,1,1,0.469,0.212,0.343,934
informative,0.061,126,173,1,1,0.812,0.419,0.741,299
spectacular,0.061,180,247,1,1,0.947,0.74,0.887,427
guess,0.061,34579,47383,1,1,0.64,0.463,0.442,81962
shuttle,0.061,53,73,1,1,0.531,0.591,0.547,126
apparatus,0.061,26,36,1,1,0.375,0.353,0.377,62
promising,0.061,215,295,1,1,0.791,0.549,0.858,510
sanitary,0.061,26,36,1,1,0.458,0.32,0.425,62
prime,0.061,822,1127,1,1,0.708,0.275,0.446,1949
badass,0.061,482,661,1,1,0.255,0.775,0.745,1143
superpower,0.061,142,195,1,1,0.806,0.784,0.972,337
enlightened,0.061,142,195,1,1,0.956,0.566,0.7,337
sort,0.061,4450,6100,1,1,0.673,0.389,0.674,10550
deserved,0.061,1610,2208,1,1,0.781,0.582,0.689,3818
parole,0.06,34,47,1,1,0.388,0.62,0.526,81
deteriorated,0.06,34,47,1,1,0.053,0.549,0.237,81
interior,0.06,139,191,1,1,0.618,0.157,0.462,330
books,0.06,5386,7387,1,1,0.729,0.115,0.43,12773
sacrifice,0.06,1318,1808,1,1,0.208,0.833,0.534,3126
bummer,0.06,217,298,1,1,0.163,0.5,0.267,515
amount,0.06,4164,5712,1,1,0.562,0.422,0.649,9876
advance,0.06,628,862,1,1,0.673,0.472,0.858,1490
cone,0.06,171,235,1,1,0.417,0.208,0.343,406
regressive,0.06,42,58,1,1,0.302,0.434,0.363,100
odd,0.06,2179,2991,1,1,0.265,0.337,0.302,5170
internal,0.06,756,1038,1,1,0.439,0.349,0.423,1794
ego,0.06,1853,2544,1,1,0.328,0.576,0.593,4397
staggering,0.06,109,150,1,1,0.52,0.657,0.683,259
collect,0.059,624,857,1,1,0.635,0.481,0.491,1481
savvy,0.059,58,80,1,1,0.719,0.52,0.706,138
postal,0.059,58,80,1,1,0.765,0.245,0.411,138
foam,0.059,66,91,1,1,0.698,0.23,0.204,157
ahhh,0.059,1052,1445,1,1,0.562,0.517,0.241,2497
music,0.059,24413,33525,1,1,0.833,0.563,0.605,57938
suck,0.059,5884,8081,1,1,0.344,0.706,0.377,13965
receipt,0.059,74,102,1,1,0.542,0.23,0.415,176
crowded,0.059,3442,4729,1,1,0.694,0.286,0.585,8171
superhero,0.059,261,359,1,1,0.91,0.82,0.893,620
passing,0.058,1901,2613,1,1,0.458,0.298,0.509,4514
hand,0.058,14463,19879,1,1,0.542,0.314,0.434,34342
trigger,0.058,971,1335,1,1,0.271,0.804,0.66,2306
beg,0.058,1523,2094,1,1,0.292,0.608,0.328,3617
suit,0.058,885,1217,1,1,0.776,0.282,0.482,2102
younger,0.058,3013,4143,1,1,0.781,0.457,0.558,7156
realtor,0.058,15,21,1,1,0.429,0.471,0.582,36
battering,0.058,15,21,1,1,0.21,0.798,0.49,36
generalization,0.058,39,54,1,1,0.542,0.459,0.704,93
espouse,0.058,15,21,1,1,0.802,0.529,0.598,36
especial,0.058,31,43,1,1,0.827,0.419,0.794,74
omit,0.058,15,21,1,1,0.33,0.265,0.451,36
gauntlet,0.058,47,65,1,1,0.42,0.491,0.39,112
procrastination,0.058,119,164,1,1,0.323,0.43,0.491,283
superintendent,0.058,15,21,1,1,0.592,0.57,0.942,36
cite,0.058,63,87,1,1,0.625,0.454,0.532,150
orthodoxy,0.058,15,21,1,1,0.271,0.388,0.612,36
complexion,0.058,23,32,1,1,0.521,0.52,0.38,55
trajectory,0.058,55,76,1,1,0.653,0.558,0.779,131
adviser,0.058,47,65,1,1,0.745,0.362,0.705,112
belt,0.058,343,472,1,1,0.541,0.322,0.445,815
neurosis,0.058,23,32,1,1,0.122,0.766,0.418,55
hoard,0.058,71,98,1,1,0.506,0.412,0.518,169
cruel,0.058,2441,3357,1,1,0.122,0.866,0.391,5798
solid,0.058,1473,2026,1,1,0.667,0.304,0.763,3499
yoga,0.058,524,721,1,1,0.75,0.115,0.422,1245
prevent,0.058,993,1366,1,1,0.635,0.481,0.575,2359
vanilla,0.058,268,369,1,1,0.706,0.216,0.284,637
stuffing,0.057,132,182,1,1,0.417,0.324,0.304,314
separate,0.057,1690,2327,1,1,0.24,0.514,0.349,4017
caps,0.057,214,295,1,1,0.51,0.221,0.368,509
modeling,0.057,68,94,1,1,0.684,0.404,0.49,162
karate,0.057,68,94,1,1,0.562,0.833,0.598,162
steel,0.056,312,430,1,1,0.521,0.42,0.714,742
output,0.056,60,83,1,1,0.604,0.389,0.434,143
bumper,0.056,60,83,1,1,0.385,0.573,0.518,143
poorly,0.056,548,755,1,1,0.077,0.62,0.196,1303
unexplained,0.056,52,72,1,1,0.271,0.531,0.349,124
braid,0.056,52,72,1,1,0.427,0.222,0.216,124
community,0.056,10961,15100,1,1,0.75,0.35,0.659,26061
cater,0.056,134,185,1,1,0.802,0.5,0.509,319
pregnant,0.056,2193,3022,1,1,0.765,0.773,0.537,5215
excited,0.056,6400,8819,1,1,0.908,0.931,0.709,15219
grievance,0.055,36,50,1,1,0.092,0.635,0.364,86
development,0.055,797,1099,1,1,0.827,0.5,0.796,1896
welcome,0.055,7541,10396,1,1,0.898,0.555,0.664,17937
flake,0.055,205,283,1,1,0.385,0.388,0.289,488
prejudice,0.055,210,290,1,1,0.11,0.613,0.407,500
lobby,0.055,326,450,1,1,0.625,0.427,0.472,776
overdo,0.055,28,39,1,1,0.156,0.864,0.602,67
throttle,0.055,28,39,1,1,0.562,0.804,0.75,67
hone,0.055,86,119,1,1,0.688,0.392,0.473,205
earpiece,0.055,28,39,1,1,0.583,0.286,0.452,67
noticeable,0.055,115,159,1,1,0.89,0.562,0.75,274
intact,0.055,144,199,1,1,0.716,0.212,0.602,343
career,0.055,2883,3977,1,1,0.74,0.712,0.606,6860
basic,0.055,1422,1962,1,1,0.643,0.102,0.395,3384
dysfunctional,0.054,265,366,1,1,0.125,0.558,0.307,631
proactive,0.054,99,137,1,1,0.792,0.723,0.857,236
counter,0.054,612,845,1,1,0.439,0.478,0.75,1457
complete,0.054,4597,6345,1,1,0.75,0.414,0.809,10942
orbs,0.054,70,97,1,1,0.469,0.355,0.482,167
expert,0.054,517,714,1,1,0.776,0.646,0.911,1231
overlook,0.054,133,184,1,1,0.292,0.418,0.415,317
tongue,0.054,795,1098,1,1,0.542,0.432,0.482,1893
deliver,0.054,939,1297,1,1,0.583,0.37,0.582,2236
participant,0.054,62,86,1,1,0.712,0.598,0.613,148
smelt,0.054,20,28,1,1,0.333,0.441,0.345,48
forfeit,0.054,20,28,1,1,0.083,0.635,0.245,48
adulterer,0.054,20,28,1,1,0.229,0.814,0.407,48
banker,0.054,41,57,1,1,0.586,0.588,0.792,98
hob,0.054,20,28,1,1,0.633,0.363,0.415,48
altered,0.054,83,115,1,1,0.255,0.765,0.5,198
syntax,0.054,20,28,1,1,0.531,0.346,0.559,48
aerial,0.054,20,28,1,1,0.615,0.461,0.463,48
jail,0.053,2350,3246,1,1,0.094,0.898,0.48,5596
cousin,0.053,2141,2958,1,1,0.675,0.394,0.427,5099
restraint,0.053,75,104,1,1,0.167,0.618,0.52,179
defiance,0.053,54,75,1,1,0.333,0.78,0.76,129
flora,0.053,54,75,1,1,0.833,0.324,0.567,129
kale,0.053,54,75,1,1,0.469,0.226,0.411,129
fundamental,0.053,232,321,1,1,0.708,0.422,0.903,553
frugal,0.053,33,46,1,1,0.48,0.355,0.355,79
pedicure,0.053,33,46,1,1,0.695,0.269,0.296,79
germs,0.053,67,93,1,1,0.135,0.51,0.38,160
parasitic,0.053,33,46,1,1,0.037,0.6,0.364,79
provide,0.052,2203,3046,1,1,0.833,0.517,0.704,5249
miracle,0.052,830,1148,1,1,0.917,0.607,0.806,1978
tangible,0.052,161,223,1,1,0.646,0.35,0.679,384
pressure,0.052,2833,3918,1,1,0.36,0.65,0.623,6751
fit,0.051,4321,5980,1,1,0.604,0.45,0.632,10301
fooled,0.051,434,601,1,1,0.051,0.692,0.241,1035
marine,0.051,202,280,1,1,0.633,0.471,0.679,482
contribute,0.051,527,730,1,1,0.806,0.35,0.795,1257
posterity,0.051,12,17,1,1,0.565,0.46,0.683,29
umpire,0.051,12,17,1,1,0.52,0.592,0.755,29
apron,0.051,25,35,1,1,0.582,0.208,0.245,60
vascular,0.051,12,17,1,1,0.516,0.451,0.627,29
iguana,0.051,12,17,1,1,0.521,0.235,0.291,29
jiffy,0.051,12,17,1,1,0.41,0.444,0.38,29
pedigree,0.051,12,17,1,1,0.625,0.34,0.609,29
underwood,0.051,25,35,1,1,0.51,0.453,0.51,60
praising,0.051,155,215,1,1,0.906,0.557,0.623,370
punctual,0.051,12,17,1,1,0.745,0.337,0.636,29
precocious,0.051,12,17,1,1,0.398,0.61,0.324,29
snooty,0.051,12,17,1,1,0.39,0.455,0.446,29
decode,0.051,25,35,1,1,0.551,0.51,0.64,60
formless,0.051,12,17,1,1,0.398,0.201,0.163,29
perception,0.051,550,762,1,1,0.653,0.481,0.655,1312
dose,0.051,586,812,1,1,0.458,0.49,0.427,1398
purchase,0.05,396,549,1,1,0.625,0.5,0.616,945
bday,0.05,1452,2012,1,1,0.729,0.6,0.415,3464
ethic,0.05,95,132,1,1,0.786,0.26,0.791,227
gravy,0.05,126,175,1,1,0.608,0.45,0.339,301
vibe,0.05,2785,3860,1,1,0.71,0.48,0.517,6645
weaken,0.05,56,78,1,1,0.112,0.25,0.223,134
degraded,0.05,56,78,1,1,0.167,0.433,0.205,134
chunky,0.05,56,78,1,1,0.52,0.517,0.509,134
compete,0.05,328,455,1,1,0.573,0.745,0.786,783
bishop,0.05,188,261,1,1,0.594,0.184,0.725,449
password,0.05,175,243,1,1,0.39,0.356,0.559,418
beacon,0.049,224,311,1,1,0.58,0.407,0.537,535
reason,0.049,25292,35076,1,1,0.781,0.455,0.712,60368
deceive,0.049,136,189,1,1,0.094,0.775,0.414,325
livelihood,0.049,61,85,1,1,0.698,0.481,0.721,146
modesty,0.049,30,42,1,1,0.778,0.24,0.5,72
godfather,0.049,61,85,1,1,0.694,0.45,0.509,146
patronizing,0.049,30,42,1,1,0.542,0.365,0.529,72
appetite,0.049,311,432,1,1,0.704,0.637,0.581,743
flourish,0.048,205,285,1,1,0.939,0.573,0.601,490
term,0.048,2094,2908,1,1,0.45,0.255,0.598,5002
rating,0.048,228,317,1,1,0.663,0.679,0.637,545
valiant,0.048,35,49,1,1,0.88,0.745,0.904,84
graded,0.048,17,24,1,1,0.562,0.34,0.759,41
enormous,0.048,269,374,1,1,0.677,0.665,0.886,643
backroom,0.048,17,24,1,1,0.406,0.5,0.387,41
torrid,0.048,17,24,1,1,0.281,0.625,0.517,41
nobility,0.048,17,24,1,1,0.844,0.347,0.736,41
statistical,0.048,35,49,1,1,0.714,0.353,0.627,84
neutral,0.048,310,431,1,1,0.469,0.184,0.357,741
impatient,0.048,220,306,1,1,0.25,0.708,0.429,526
coat,0.047,433,602,1,1,0.677,0.256,0.464,1035
stress,0.047,6749,9378,1,1,0.173,0.843,0.317,16127
drove,0.047,946,1315,1,1,0.541,0.528,0.623,2261
pickle,0.047,135,188,1,1,0.593,0.449,0.288,323
unbreakable,0.047,117,163,1,1,0.653,0.573,0.759,280
nutty,0.047,58,81,1,1,0.444,0.317,0.271,139
endure,0.047,1289,1792,1,1,0.32,0.61,0.574,3081
constructive,0.047,181,252,1,1,0.86,0.57,0.812,433
pamper,0.047,122,170,1,1,0.792,0.321,0.348,292
argh,0.047,163,227,1,1,0.26,0.538,0.328,390
discharge,0.047,63,88,1,1,0.427,0.538,0.578,151
punctuation,0.047,63,88,1,1,0.561,0.385,0.592,151
authentic,0.046,416,579,1,1,0.885,0.51,0.782,995
mean,0.046,37673,52407,1,1,0.44,0.467,0.62,90080
resonance,0.046,45,63,1,1,0.541,0.426,0.629,108
radically,0.046,45,63,1,1,0.552,0.731,0.715,108
moisture,0.046,22,31,1,1,0.406,0.398,0.327,53
reciprocate,0.046,183,255,1,1,0.76,0.46,0.618,438
columnist,0.046,22,31,1,1,0.646,0.365,0.648,53
cripple,0.046,68,95,1,1,0.094,0.392,0.161,163
accommodation,0.046,137,191,1,1,0.817,0.415,0.587,328
doubtless,0.046,22,31,1,1,0.688,0.415,0.689,53
abominable,0.046,22,31,1,1,0.12,0.731,0.482,53
miraculous,0.046,68,95,1,1,0.875,0.706,0.812,163
unprecedented,0.046,68,95,1,1,0.5,0.491,0.658,163
scumbag,0.046,211,294,1,1,0.24,0.591,0.278,505
accidentally,0.046,1133,1577,1,1,0.333,0.741,0.333,2710
ditch,0.046,553,770,1,1,0.357,0.364,0.322,1323
silent,0.046,4042,5626,1,1,0.469,0.125,0.28,9668
gesture,0.045,389,542,1,1,0.667,0.481,0.427,931
pot,0.045,618,861,1,1,0.5,0.186,0.294,1479
savior,0.045,539,751,1,1,0.92,0.469,0.804,1290
cupboard,0.045,134,187,1,1,0.553,0.2,0.304,321
discredited,0.045,27,38,1,1,0.112,0.491,0.182,65
mammal,0.045,27,38,1,1,0.618,0.449,0.421,65
hare,0.045,55,77,1,1,0.62,0.41,0.345,132
hoping,0.045,5525,7697,1,1,0.684,0.469,0.454,13222
yesterday,0.045,7293,10160,1,1,0.5,0.286,0.253,17453
suffocate,0.045,144,201,1,1,0.219,0.764,0.44,345
hindsight,0.045,121,169,1,1,0.333,0.431,0.532,290
heating,0.045,215,300,1,1,0.647,0.491,0.537,515
walking,0.044,8473,11810,1,1,0.708,0.48,0.781,20283
override,0.044,32,45,1,1,0.316,0.491,0.529,77
reluctance,0.044,32,45,1,1,0.24,0.606,0.373,77
hype,0.044,1131,1577,1,1,0.51,0.5,0.586,2708
cried,0.044,5972,8326,1,1,0.167,0.612,0.254,14298
oil,0.044,648,904,1,1,0.521,0.278,0.306,1552
likelihood,0.044,108,151,1,1,0.76,0.469,0.542,259
vital,0.044,582,812,1,1,0.75,0.716,0.847,1394
dramatic,0.044,1547,2158,1,1,0.367,0.78,0.443,3705
qualified,0.044,303,423,1,1,0.76,0.52,0.815,726
distasteful,0.044,37,52,1,1,0.264,0.676,0.222,89
cordial,0.044,37,52,1,1,0.823,0.312,0.482,89
horde,0.043,80,112,1,1,0.286,0.713,0.684,192
summarize,0.043,42,59,1,1,0.59,0.323,0.471,101
contaminated,0.043,85,119,1,1,0.04,0.5,0.368,204
trust,0.043,24890,34740,1,1,0.888,0.547,0.741,59630
motivation,0.043,1735,2422,1,1,0.854,0.784,0.802,4157
seize,0.043,100,140,1,1,0.656,0.644,0.673,240
retire,0.043,312,436,1,1,0.398,0.392,0.186,748
mind,0.043,42333,59106,1,1,0.65,0.388,0.627,101439
overtime,0.043,211,295,1,1,0.447,0.504,0.529,506
badge,0.042,173,242,1,1,0.567,0.488,0.691,415
bathe,0.042,120,168,1,1,0.677,0.294,0.371,288
spirits,0.042,1030,1439,1,1,0.583,0.847,0.545,2469
awakening,0.042,331,463,1,1,0.745,0.5,0.618,794
intern,0.042,165,231,1,1,0.459,0.46,0.392,396
empathy,0.042,1533,2143,1,1,0.729,0.349,0.545,3676
fullness,0.041,92,129,1,1,0.868,0.402,0.811,221
ceremony,0.041,200,280,1,1,0.76,0.559,0.761,480
challenge,0.041,2265,3167,1,1,0.469,0.922,0.713,5432
fag,0.041,220,308,1,1,0.122,0.653,0.331,528
fresh,0.041,1756,2456,1,1,0.908,0.292,0.419,4212
recurring,0.041,132,185,1,1,0.37,0.56,0.445,317
wan,0.041,576,806,1,1,0.384,0.457,0.31,1382
thumb,0.041,305,427,1,1,0.673,0.271,0.361,732
pride,0.041,3264,4567,1,1,0.729,0.634,0.848,7831
perceive,0.04,242,339,1,1,0.653,0.49,0.655,581
giggle,0.04,257,360,1,1,0.719,0.618,0.36,617
laugh,0.04,8228,11515,1,1,0.98,0.639,0.587,19743
righteous,0.04,382,535,1,1,0.823,0.385,0.79,917
robust,0.04,44,62,1,1,0.667,0.604,0.719,106
precise,0.04,99,139,1,1,0.833,0.358,0.769,238
comparatively,0.04,19,27,1,1,0.604,0.391,0.538,46
cess,0.04,14,20,1,1,0.427,0.375,0.406,34
manicure,0.04,19,27,1,1,0.706,0.308,0.284,46
module,0.04,44,62,1,1,0.582,0.388,0.571,106
coop,0.04,79,111,1,1,0.612,0.445,0.65,190
tracker,0.04,39,55,1,1,0.398,0.744,0.731,94
coordinator,0.04,49,69,1,1,0.75,0.51,0.85,118
bemused,0.04,14,20,1,1,0.281,0.49,0.278,34
periphery,0.04,29,41,1,1,0.469,0.36,0.366,70
anemia,0.04,14,20,1,1,0.188,0.327,0.31,34
herring,0.04,24,34,1,1,0.531,0.387,0.422,58
pious,0.04,44,62,1,1,0.698,0.306,0.426,106
outlet,0.04,619,867,1,1,0.61,0.396,0.245,1486
premonition,0.04,19,27,1,1,0.365,0.765,0.544,46
glorify,0.04,104,146,1,1,0.94,0.591,0.661,250
tact,0.04,39,55,1,1,0.55,0.417,0.417,94
temperature,0.04,219,307,1,1,0.521,0.559,0.473,526
addendum,0.04,24,34,1,1,0.392,0.37,0.418,58
grapple,0.04,44,62,1,1,0.49,0.577,0.482,106
envelope,0.04,89,125,1,1,0.604,0.275,0.377,214
rainforest,0.04,19,27,1,1,0.612,0.375,0.398,46
yuletide,0.04,29,41,1,1,0.438,0.43,0.445,70
expiry,0.04,19,27,1,1,0.194,0.434,0.382,46
emigrate,0.04,14,20,1,1,0.356,0.812,0.508,34
sapiens,0.04,34,48,1,1,0.48,0.453,0.584,82
useful,0.039,945,1324,1,1,0.833,0.411,0.726,2269
widely,0.039,211,296,1,1,0.698,0.453,0.725,507
wife,0.039,11315,15853,1,1,0.886,0.63,0.583,27168
smiling,0.039,3075,4309,1,1,0.981,0.679,0.625,7384
consistent,0.039,647,907,1,1,0.786,0.431,0.726,1554
unit,0.039,642,900,1,1,0.562,0.235,0.578,1542
imbalance,0.039,111,156,1,1,0.115,0.538,0.264,267
lag,0.039,111,156,1,1,0.22,0.375,0.246,267
funeral,0.038,1121,1572,1,1,0.073,0.38,0.393,2693
rev,0.038,101,142,1,1,0.367,0.422,0.353,243
readily,0.038,96,135,1,1,0.74,0.29,0.547,231
nose,0.038,1150,1613,1,1,0.582,0.27,0.245,2763
leftover,0.038,163,229,1,1,0.49,0.46,0.222,392
imperial,0.038,71,100,1,1,0.669,0.646,0.922,171
itch,0.038,138,194,1,1,0.319,0.61,0.465,332
curtains,0.038,272,382,1,1,0.615,0.123,0.342,654
formula,0.038,133,187,1,1,0.521,0.45,0.585,320
overtake,0.038,66,93,1,1,0.573,0.62,0.718,159
tacky,0.038,61,86,1,1,0.245,0.49,0.373,147
ducking,0.037,180,253,1,1,0.344,0.573,0.294,433
try,0.037,36783,51639,1,1,0.604,0.551,0.556,88422
aback,0.037,46,65,1,1,0.385,0.407,0.288,111
ordained,0.037,46,65,1,1,0.735,0.409,0.731,111
silicon,0.037,46,65,1,1,0.439,0.448,0.445,111
narrative,0.037,825,1159,1,1,0.58,0.303,0.443,1984
engineering,0.037,177,249,1,1,0.735,0.471,0.836,426
lose,0.037,10585,14867,1,1,0.115,0.538,0.176,25452
camp,0.037,1079,1516,1,1,0.622,0.617,0.594,2595
outreach,0.036,83,117,1,1,0.54,0.462,0.672,200
southeast,0.036,41,58,1,1,0.51,0.283,0.413,99
gently,0.036,1061,1491,1,1,0.917,0.255,0.36,2552
scum,0.036,525,738,1,1,0.357,0.38,0.218,1263
assuming,0.036,806,1133,1,1,0.74,0.39,0.526,1939
make,0.036,123890,174133,1,1,0.684,0.42,0.48,298023
interpret,0.036,174,245,1,1,0.646,0.625,0.673,419
sob,0.036,694,976,1,1,0.115,0.48,0.212,1670
stability,0.036,381,536,1,1,0.812,0.264,0.849,917
seller,0.036,68,96,1,1,0.635,0.471,0.635,164
hockey,0.036,329,463,1,1,0.565,0.786,0.548,792
filth,0.036,228,321,1,1,0.194,0.592,0.319,549
loopy,0.035,31,44,1,1,0.438,0.52,0.195,75
cauliflower,0.035,31,44,1,1,0.448,0.255,0.231,75
timeout,0.035,31,44,1,1,0.344,0.433,0.322,75
unfairness,0.035,31,44,1,1,0.17,0.817,0.336,75
unsure,0.035,688,968,1,1,0.143,0.58,0.217,1656
traditional,0.035,400,563,1,1,0.677,0.221,0.604,963
offence,0.035,176,248,1,1,0.312,0.798,0.446,424
revolutionary,0.035,117,165,1,1,0.635,0.887,0.824,282
qualities,0.035,348,490,1,1,0.844,0.51,0.731,838
haven,0.035,7121,10020,1,1,0.684,0.265,0.547,17141
changed,0.035,5588,7863,1,1,0.594,0.375,0.491,13451
experience,0.035,14502,20406,1,1,0.827,0.618,0.905,34908
morals,0.035,414,583,1,1,0.646,0.43,0.611,997
apocalypse,0.035,274,386,1,1,0.05,0.867,0.736,660
cameraman,0.035,26,37,1,1,0.542,0.452,0.542,63
rowing,0.035,26,37,1,1,0.458,0.443,0.467,63
synergy,0.035,26,37,1,1,0.667,0.51,0.72,63
burke,0.035,53,75,1,1,0.466,0.441,0.451,128
pulpit,0.035,26,37,1,1,0.469,0.449,0.517,63
bummed,0.034,362,510,1,1,0.296,0.43,0.227,872
retreat,0.034,384,541,1,1,0.5,0.519,0.312,925
psychologist,0.034,276,389,1,1,0.375,0.308,0.658,665
manner,0.034,479,675,1,1,0.618,0.25,0.32,1154
payday,0.034,70,99,1,1,0.833,0.741,0.571,169
enable,0.034,180,254,1,1,0.76,0.491,0.782,434
request,0.033,1065,1501,1,1,0.625,0.471,0.618,2566
enlist,0.033,131,185,1,1,0.51,0.37,0.483,316
unforeseen,0.033,21,30,1,1,0.255,0.714,0.5,51
derogatory,0.033,43,61,1,1,0.122,0.58,0.404,104
implied,0.033,131,185,1,1,0.327,0.53,0.481,316
focal,0.033,21,30,1,1,0.367,0.365,0.482,51
stun,0.033,21,30,1,1,0.333,0.71,0.451,51
propensity,0.033,21,30,1,1,0.521,0.462,0.66,51
unsatisfactory,0.033,21,30,1,1,0.122,0.52,0.189,51
airport,0.033,1116,1573,1,1,0.729,0.684,0.682,2689
classmate,0.033,258,364,1,1,0.781,0.4,0.593,622
perfect,0.033,9425,13284,1,1,0.98,0.471,0.87,22709
loft,0.033,126,178,1,1,0.51,0.378,0.343,304
aggravating,0.033,82,116,1,1,0.257,0.794,0.64,198
watch,0.033,26878,37889,1,1,0.531,0.346,0.423,64767
spaghetti,0.033,260,367,1,1,0.729,0.353,0.288,627
persecution,0.033,99,140,1,1,0.229,0.865,0.66,239
phi,0.033,38,54,1,1,0.42,0.361,0.452,92
sentencing,0.033,38,54,1,1,0.12,0.782,0.561,92
toot,0.032,55,78,1,1,0.5,0.481,0.373,133
evolve,0.032,223,315,1,1,0.655,0.692,0.896,538
decipher,0.032,72,102,1,1,0.417,0.63,0.652,174
kiddos,0.032,162,229,1,1,0.5,0.48,0.342,391
con,0.032,1687,2381,1,1,0.255,0.736,0.427,4068
mistreated,0.032,332,469,1,1,0.01,0.792,0.2,801
truthful,0.032,191,270,1,1,0.708,0.467,0.807,461
break,0.032,14729,20790,1,1,0.61,0.265,0.37,35519
deluge,0.031,16,23,1,1,0.245,0.714,0.612,39
gauge,0.031,67,95,1,1,0.438,0.646,0.518,162
refining,0.031,16,23,1,1,0.694,0.466,0.664,39
exterminate,0.031,16,23,1,1,0.177,0.857,0.736,39
overalls,0.031,16,23,1,1,0.5,0.392,0.373,39
tailed,0.031,16,23,1,1,0.438,0.358,0.351,39
rake,0.031,33,47,1,1,0.41,0.286,0.314,80
seltzer,0.031,16,23,1,1,0.448,0.452,0.406,39
surveying,0.031,16,23,1,1,0.488,0.455,0.682,39
unsustainable,0.031,33,47,1,1,0.255,0.65,0.406,80
singularly,0.031,16,23,1,1,0.571,0.33,0.527,39
toe,0.031,346,489,1,1,0.406,0.221,0.293,835
ruins,0.031,426,602,1,1,0.25,0.49,0.248,1028
diverse,0.031,278,393,1,1,0.562,0.519,0.604,671
skip,0.031,1076,1520,1,1,0.458,0.804,0.439,2596
tv,0.031,7001,9888,1,1,0.622,0.38,0.393,16889
steam,0.031,343,485,1,1,0.469,0.413,0.421,828
ineptitude,0.031,45,64,1,1,0.177,0.471,0.25,109
marks,0.031,563,796,1,1,0.43,0.48,0.424,1359
heather,0.031,212,300,1,1,0.5,0.352,0.407,512
academic,0.03,437,618,1,1,0.781,0.42,0.812,1055
whirlwind,0.03,74,105,1,1,0.417,0.915,0.67,179
supreme,0.03,506,716,1,1,0.812,0.7,0.974,1222
skirt,0.03,139,197,1,1,0.602,0.463,0.226,336
great,0.03,37593,53176,1,1,0.958,0.665,0.81,90769
stare,0.03,1350,1910,1,1,0.541,0.43,0.538,3260
consequence,0.029,298,422,1,1,0.24,0.721,0.593,720
crumbling,0.029,216,306,1,1,0.167,0.696,0.308,522
dare,0.029,1978,2799,1,1,0.677,0.788,0.684,4777
move,0.029,16013,22657,1,1,0.656,0.647,0.67,38670
improve,0.029,1409,1994,1,1,0.833,0.528,0.815,3403
autistic,0.029,652,923,1,1,0.367,0.337,0.404,1575
secretary,0.029,223,316,1,1,0.612,0.426,0.561,539
haul,0.029,117,166,1,1,0.551,0.564,0.453,283
tucker,0.029,182,258,1,1,0.475,0.558,0.429,440
funk,0.029,377,534,1,1,0.466,0.589,0.39,911
nonsense,0.029,1340,1897,1,1,0.214,0.531,0.155,3237
puck,0.029,64,91,1,1,0.398,0.49,0.349,155
redeem,0.029,100,142,1,1,0.633,0.469,0.491,242
deceased,0.028,172,244,1,1,0.021,0.538,0.188,416
suppose,0.028,2604,3689,1,1,0.551,0.343,0.348,6293
scene,0.028,3293,4665,1,1,0.57,0.34,0.578,7958
instantaneously,0.028,11,16,1,1,0.656,0.64,0.6,27
malicious,0.028,119,169,1,1,0.177,0.765,0.607,288
undisclosed,0.028,11,16,1,1,0.479,0.361,0.314,27
infomercial,0.028,11,16,1,1,0.427,0.462,0.555,27
continuation,0.028,71,101,1,1,0.615,0.47,0.566,172
payoff,0.028,47,67,1,1,0.74,0.644,0.673,114
untie,0.028,11,16,1,1,0.542,0.463,0.472,27
malleable,0.028,11,16,1,1,0.5,0.5,0.391,27
sphinx,0.028,11,16,1,1,0.604,0.324,0.49,27
disarray,0.028,23,33,1,1,0.198,0.657,0.223,56
wreck,0.028,589,835,1,1,0.22,0.77,0.339,1424
work,0.028,50867,72084,1,1,0.719,0.596,0.75,122951
gutter,0.028,162,230,1,1,0.466,0.26,0.4,392
cinema,0.028,876,1242,1,1,0.698,0.538,0.5,2118
works,0.027,6182,8765,1,1,0.776,0.434,0.657,14947
takeover,0.027,66,94,1,1,0.663,0.531,0.861,160
gasping,0.027,66,94,1,1,0.208,0.704,0.379,160
fetal,0.027,66,94,1,1,0.388,0.308,0.364,160
tray,0.027,109,155,1,1,0.549,0.25,0.345,264
staple,0.027,54,77,1,1,0.542,0.306,0.438,131
hysterical,0.027,171,243,1,1,0.29,0.942,0.398,414
vest,0.027,116,165,1,1,0.667,0.38,0.371,281
upwards,0.026,92,131,1,1,0.724,0.439,0.638,223
dialect,0.026,30,43,1,1,0.635,0.422,0.526,73
terrorize,0.026,30,43,1,1,0.041,0.907,0.577,73
cemented,0.026,30,43,1,1,0.429,0.382,0.537,73
sneaky,0.026,185,263,1,1,0.24,0.74,0.56,448
reciprocity,0.026,30,43,1,1,0.74,0.673,0.556,73
military,0.026,1553,2205,1,1,0.396,0.71,0.875,3758
crook,0.026,130,185,1,1,0.171,0.765,0.55,315
functional,0.026,180,256,1,1,0.75,0.5,0.72,436
quickly,0.025,2695,3828,1,1,0.784,0.85,0.636,6523
interest,0.025,3225,4582,1,1,0.78,0.667,0.618,7807
setup,0.025,201,286,1,1,0.667,0.398,0.635,487
initial,0.025,353,502,1,1,0.583,0.314,0.539,855
subtract,0.025,18,26,1,1,0.208,0.33,0.283,44
storing,0.025,18,26,1,1,0.63,0.378,0.548,44
fanning,0.025,18,26,1,1,0.615,0.33,0.236,44
immeasurable,0.025,75,107,1,1,0.51,0.539,0.712,182
sicken,0.025,18,26,1,1,0.051,0.5,0.294,44
tiptoe,0.025,18,26,1,1,0.51,0.49,0.407,44
piglet,0.025,18,26,1,1,0.54,0.443,0.25,44
omnipotent,0.025,37,53,1,1,0.719,0.679,0.919,90
misconception,0.025,94,134,1,1,0.21,0.557,0.291,228
personable,0.025,18,26,1,1,0.816,0.52,0.637,44
superfluous,0.025,18,26,1,1,0.316,0.469,0.393,44
ownership,0.025,177,252,1,1,0.628,0.445,0.741,429
coach,0.025,813,1156,1,1,0.633,0.823,0.735,1969
hopeful,0.025,1036,1473,1,1,0.947,0.357,0.627,2509
helmet,0.025,101,144,1,1,0.573,0.327,0.402,245
stick,0.024,3568,5074,1,1,0.396,0.364,0.382,8642
marginal,0.024,44,63,1,1,0.235,0.644,0.345,107
authenticity,0.024,115,164,1,1,0.67,0.548,0.845,279
overpriced,0.024,70,100,1,1,0.271,0.556,0.472,170
refill,0.024,96,137,1,1,0.67,0.4,0.464,233
meal,0.024,1661,2364,1,1,0.833,0.461,0.473,4025
schadenfreude,0.024,25,36,1,1,0.354,0.64,0.463,61
mafia,0.024,181,258,1,1,0.204,0.867,0.676,439
iceberg,0.024,77,110,1,1,0.344,0.54,0.648,187
commotion,0.024,25,36,1,1,0.49,0.7,0.646,61
frosted,0.024,25,36,1,1,0.748,0.471,0.218,61
rifles,0.024,25,36,1,1,0.337,0.864,0.765,61
broom,0.024,77,110,1,1,0.385,0.154,0.302,187
laughing,0.023,3796,5403,1,1,0.906,0.596,0.534,9199
scratch,0.023,443,631,1,1,0.276,0.625,0.27,1074
goods,0.023,280,399,1,1,0.888,0.396,0.726,679
talent,0.023,1123,1599,1,1,0.959,0.607,0.811,2722
bachelorette,0.023,84,120,1,1,0.735,0.78,0.465,204
courtesy,0.023,209,298,1,1,0.927,0.287,0.431,507
existing,0.023,1070,1524,1,1,0.802,0.344,0.75,2594
wrench,0.023,32,46,1,1,0.396,0.202,0.545,78
sweeping,0.022,112,160,1,1,0.344,0.431,0.355,272
earth,0.022,6715,9569,1,1,0.75,0.225,0.614,16284
lightbulb,0.022,39,56,1,1,0.573,0.255,0.302,95
claw,0.022,119,170,1,1,0.26,0.6,0.598,289
submit,0.022,279,398,1,1,0.635,0.448,0.5,677
wits,0.022,79,113,1,1,0.76,0.596,0.765,192
cool,0.022,13990,19937,1,1,0.885,0.54,0.781,33927
boa,0.022,180,257,1,1,0.255,0.569,0.542,437
lobe,0.022,46,66,1,1,0.459,0.364,0.352,112
judgmental,0.022,201,287,1,1,0.33,0.602,0.579,488
dent,0.022,53,76,1,1,0.306,0.606,0.325,129
highest,0.021,830,1184,1,1,0.771,0.64,0.71,2014
sandy,0.021,168,240,1,1,0.406,0.265,0.296,408
admitted,0.021,621,886,1,1,0.72,0.49,0.767,1507
unnatural,0.021,114,163,1,1,0.153,0.587,0.434,277
august,0.021,799,1140,1,1,0.652,0.292,0.462,1939
natural,0.021,1943,2772,1,1,0.854,0.118,0.481,4715
raft,0.021,67,96,1,1,0.51,0.229,0.228,163
formed,0.021,404,577,1,1,0.656,0.272,0.696,981
yeahhh,0.02,123,176,1,1,0.82,0.792,0.51,299
kit,0.02,303,433,1,1,0.583,0.344,0.42,736
trash,0.02,4007,5721,1,1,0.163,0.541,0.154,9728
absolute,0.02,2674,3818,1,1,0.526,0.51,0.827,6492
screaming,0.02,2959,4225,1,1,0.245,0.901,0.46,7184
devastating,0.02,677,967,1,1,0.104,0.856,0.419,1644
toss,0.02,256,366,1,1,0.418,0.725,0.575,622
general,0.02,3919,5597,1,1,0.834,0.484,0.853,9516
week,0.02,22897,32700,1,1,0.51,0.231,0.351,55597
tenor,0.02,13,19,1,1,0.587,0.451,0.5,32
unremarkable,0.02,20,29,1,1,0.271,0.155,0.23,49
conundrum,0.02,76,109,1,1,0.354,0.524,0.408,185
selfless,0.02,307,439,1,1,0.521,0.235,0.396,746
crossfire,0.02,13,19,1,1,0.316,0.896,0.722,32
fortify,0.02,13,19,1,1,0.745,0.824,0.911,32
manger,0.02,34,49,1,1,0.656,0.276,0.398,83
barring,0.02,34,49,1,1,0.292,0.67,0.42,83
brow,0.02,209,299,1,1,0.562,0.311,0.481,508
quota,0.02,34,49,1,1,0.427,0.41,0.4,83
township,0.02,13,19,1,1,0.531,0.292,0.667,32
weeding,0.02,27,39,1,1,0.458,0.528,0.454,66
aerospace,0.02,13,19,1,1,0.643,0.52,0.779,32
pollute,0.02,27,39,1,1,0.173,0.66,0.48,66
northeast,0.02,41,59,1,1,0.562,0.26,0.375,100
molding,0.02,27,39,1,1,0.552,0.308,0.546,66
surmise,0.02,13,19,1,1,0.529,0.4,0.347,32
executioner,0.02,13,19,1,1,0.235,0.816,0.676,32
aggravate,0.02,34,49,1,1,0.224,0.77,0.464,83
savant,0.02,13,19,1,1,0.781,0.451,0.818,32
seafood,0.02,69,99,1,1,0.656,0.5,0.328,168
coerce,0.02,20,29,1,1,0.26,0.741,0.517,49
regiment,0.02,13,19,1,1,0.469,0.722,0.755,32
impediment,0.02,20,29,1,1,0.163,0.6,0.409,49
linguistics,0.02,13,19,1,1,0.552,0.39,0.618,32
product,0.019,661,945,1,1,0.646,0.417,0.648,1606
signature,0.019,134,192,1,1,0.57,0.422,0.657,326
unaware,0.019,292,418,1,1,0.208,0.355,0.31,710
appreciates,0.019,371,531,1,1,0.765,0.5,0.656,902
cardinal,0.018,78,112,1,1,0.583,0.358,0.712,190
tendency,0.018,308,441,1,1,0.684,0.5,0.675,749
shape,0.018,1002,1434,1,1,0.592,0.24,0.422,2436
aspect,0.018,927,1327,1,1,0.479,0.469,0.588,2254
bozo,0.018,50,72,1,1,0.388,0.364,0.298,122
burnout,0.017,182,261,1,1,0.219,0.445,0.24,443
pile,0.017,768,1100,1,1,0.461,0.32,0.539,1868
aspen,0.017,43,62,1,1,0.479,0.28,0.395,105
distracting,0.017,300,430,1,1,0.445,0.583,0.4,730
congrats,0.017,1200,1719,1,1,0.93,0.726,0.775,2919
doctorate,0.017,36,52,1,1,0.776,0.479,0.841,88
bridal,0.017,36,52,1,1,0.823,0.655,0.596,88
seminary,0.017,36,52,1,1,0.594,0.367,0.589,88
manipulative,0.017,415,595,1,1,0.177,0.724,0.546,1010
chattering,0.016,29,42,1,1,0.46,0.663,0.304,71
unveil,0.016,29,42,1,1,0.439,0.442,0.562,71
dizziness,0.016,29,42,1,1,0.229,0.555,0.254,71
duty,0.016,832,1193,1,1,0.583,0.579,0.651,2025
realistic,0.016,490,703,1,1,0.7,0.52,0.783,1193
rapid,0.016,135,194,1,1,0.667,0.788,0.768,329
forcibly,0.016,52,75,1,1,0.365,0.704,0.647,127
skyline,0.016,52,75,1,1,0.592,0.412,0.662,127
first,0.016,44642,64017,1,1,0.625,0.5,0.788,108659
smooth,0.016,522,749,1,1,0.823,0.127,0.281,1271
unexpected,0.016,607,871,1,1,0.5,0.72,0.333,1478
adamant,0.016,75,108,1,1,0.344,0.529,0.575,183
length,0.016,349,501,1,1,0.479,0.308,0.533,850
powerless,0.016,441,633,1,1,0.125,0.5,0.328,1074
unpunished,0.015,22,32,1,1,0.292,0.594,0.519,54
readiness,0.015,22,32,1,1,0.708,0.531,0.7,54
accelerated,0.015,22,32,1,1,0.61,0.812,0.682,54
snubbed,0.015,22,32,1,1,0.265,0.528,0.279,54
derision,0.015,22,32,1,1,0.265,0.67,0.292,54
averse,0.015,22,32,1,1,0.253,0.569,0.492,54
addiction,0.015,1928,2767,1,1,0.18,0.806,0.42,4695
garage,0.015,415,596,1,1,0.531,0.283,0.455,1011
fluid,0.015,100,144,1,1,0.673,0.407,0.589,244
claustrophobic,0.015,100,144,1,1,0.092,0.755,0.4,244
hazard,0.015,139,200,1,1,0.112,0.884,0.757,339
turbulence,0.015,38,55,1,1,0.062,0.922,0.532,93
interviewer,0.015,77,111,1,1,0.552,0.736,0.816,188
cheese,0.014,1288,1850,1,1,0.74,0.28,0.281,3138
storming,0.014,132,190,1,1,0.265,0.91,0.669,322
altogether,0.014,265,381,1,1,0.833,0.324,0.644,646
contrary,0.014,375,539,1,1,0.327,0.449,0.338,914
carried,0.014,707,1016,1,1,0.49,0.382,0.534,1723
misfit,0.014,180,259,1,1,0.173,0.5,0.393,439
consumer,0.014,125,180,1,1,0.507,0.551,0.677,305
pinpoint,0.014,70,101,1,1,0.583,0.443,0.528,171
ban,0.014,450,647,1,1,0.146,0.689,0.587,1097
supermarket,0.014,214,308,1,1,0.69,0.547,0.571,522
dump,0.014,518,745,1,1,0.345,0.5,0.37,1263
grandma,0.013,2086,2999,1,1,0.796,0.208,0.491,5085
buddhist,0.013,47,68,1,1,0.57,0.182,0.481,115
extracurricular,0.013,15,22,1,1,0.457,0.471,0.743,37
bandage,0.013,47,68,1,1,0.22,0.327,0.286,115
technician,0.013,31,45,1,1,0.592,0.51,0.713,76
chiropractor,0.013,15,22,1,1,0.42,0.549,0.651,37
quilt,0.013,47,68,1,1,0.643,0.123,0.226,115
segregate,0.013,15,22,1,1,0.29,0.627,0.44,37
newsflash,0.013,63,91,1,1,0.604,0.637,0.518,154
packer,0.013,15,22,1,1,0.52,0.48,0.537,37
distort,0.013,31,45,1,1,0.1,0.74,0.366,76
large,0.013,2398,3449,1,1,0.704,0.565,0.736,5847
find,0.013,62750,90251,1,1,0.774,0.555,0.58,153001
blindness,0.013,72,104,1,1,0.245,0.48,0.196,176
discouraged,0.013,608,875,1,1,0.22,0.304,0.09,1483
derive,0.013,56,81,1,1,0.396,0.324,0.36,137
proportions,0.013,56,81,1,1,0.625,0.43,0.5,137
flip,0.013,628,904,1,1,0.281,0.529,0.435,1532
systematically,0.012,40,58,1,1,0.69,0.39,0.651,98
clue,0.012,1333,1919,1,1,0.653,0.38,0.412,3252
finger,0.012,1114,1604,1,1,0.321,0.264,0.291,2718
reverse,0.012,338,487,1,1,0.539,0.415,0.461,825
arrive,0.012,663,955,1,1,0.837,0.406,0.585,1618
soup,0.012,665,958,1,1,0.602,0.245,0.269,1623
insufferable,0.012,149,215,1,1,0.22,0.784,0.291,364
empirical,0.012,24,35,1,1,0.5,0.51,0.574,59
presume,0.012,124,179,1,1,0.448,0.635,0.635,303
evens,0.012,24,35,1,1,0.592,0.43,0.457,59
tomorrow,0.012,14310,20609,1,1,0.792,0.377,0.407,34919
womb,0.011,267,385,1,1,0.375,0.385,0.591,652
divorce,0.011,1198,1726,1,1,0.042,0.7,0.385,2924
wash,0.011,1198,1726,1,1,0.635,0.377,0.297,2924
commercial,0.011,410,591,1,1,0.806,0.49,0.528,1001
net,0.011,528,761,1,1,0.441,0.288,0.417,1289
athlete,0.011,142,205,1,1,0.781,0.718,0.686,347
rude,0.011,2121,3056,1,1,0.061,0.821,0.402,5177
talker,0.011,67,97,1,1,0.5,0.604,0.552,164
anniversary,0.011,1003,1446,1,1,0.88,0.77,0.723,2449
gasp,0.011,178,257,1,1,0.44,0.754,0.298,435
building,0.01,2976,4291,1,1,0.705,0.288,0.673,7267
hem,0.01,42,61,1,1,0.562,0.283,0.291,103
prude,0.01,42,61,1,1,0.327,0.41,0.333,103
sux,0.01,266,384,1,1,0.406,0.531,0.331,650
external,0.01,293,423,1,1,0.479,0.341,0.509,716
print,0.01,354,511,1,1,0.521,0.384,0.482,865
indicating,0.01,51,74,1,1,0.745,0.339,0.555,125
grilled,0.01,103,149,1,1,0.702,0.5,0.373,252
outlook,0.01,277,400,1,1,0.83,0.525,0.625,677
heels,0.01,306,442,1,1,0.5,0.439,0.396,748
total,0.01,2177,3142,1,1,0.771,0.286,0.714,5319
plead,0.009,105,152,1,1,0.177,0.596,0.195,257
beginning,0.009,3375,4872,1,1,0.816,0.528,0.558,8247
growth,0.009,1999,2886,1,1,0.917,0.588,0.776,4885
write,0.009,7573,10934,1,1,0.612,0.387,0.534,18507
nuisance,0.009,168,243,1,1,0.198,0.817,0.227,411
count,0.009,4283,6186,1,1,0.594,0.389,0.492,10469
skin,0.009,2963,4280,1,1,0.569,0.35,0.395,7243
freakish,0.009,17,25,1,1,0.135,0.915,0.566,42
ratty,0.009,17,25,1,1,0.354,0.45,0.358,42
refresh,0.009,188,272,1,1,0.719,0.64,0.689,460
meticulous,0.009,17,25,1,1,0.555,0.48,0.555,42
blouse,0.009,17,25,1,1,0.58,0.19,0.302,42
diminished,0.009,89,129,1,1,0.156,0.269,0.196,218
hazardous,0.009,26,38,1,1,0.061,0.75,0.67,64
data,0.009,1115,1611,1,1,0.5,0.25,0.426,2726
devout,0.009,44,64,1,1,0.62,0.357,0.464,108
actionable,0.009,17,25,1,1,0.673,0.702,0.613,42
topple,0.009,17,25,1,1,0.198,0.82,0.573,42
contemptible,0.009,17,25,1,1,0.146,0.657,0.471,42
thermal,0.009,17,25,1,1,0.48,0.36,0.509,42
strategist,0.009,17,25,1,1,0.571,0.594,0.81,42
fairly,0.008,685,990,1,1,0.79,0.406,0.75,1675
secret,0.008,3168,4577,1,1,0.479,0.58,0.509,7745
independence,0.008,1159,1675,1,1,0.896,0.663,0.911,2834
expose,0.008,507,733,1,1,0.344,0.643,0.537,1240
exercise,0.008,916,1324,1,1,0.75,0.789,0.625,2240
shock,0.008,871,1259,1,1,0.286,0.821,0.453,2130
sensitive,0.008,1471,2126,1,1,0.714,0.426,0.254,3597
go,0.008,133693,193202,1,1,0.51,0.441,0.444,326895
subsequent,0.008,82,119,1,1,0.449,0.385,0.4,201
slippers,0.007,64,93,1,1,0.573,0.413,0.236,157
carefree,0.007,194,281,1,1,0.755,0.22,0.5,475
earlier,0.007,2672,3865,1,1,0.562,0.352,0.339,6537
adverse,0.007,55,80,1,1,0.323,0.61,0.385,135
bale,0.007,55,80,1,1,0.437,0.363,0.412,135
virus,0.007,223,323,1,1,0.277,0.74,0.443,546
hurrah,0.007,46,67,1,1,0.802,0.74,0.5,113
roe,0.007,46,67,1,1,0.49,0.382,0.398,113
donate,0.007,630,912,1,1,0.774,0.462,0.577,1542
disagreement,0.007,84,122,1,1,0.104,0.618,0.236,206
hypothetical,0.007,84,122,1,1,0.48,0.367,0.361,206
appearance,0.007,717,1038,1,1,0.669,0.49,0.534,1755
coming,0.007,19310,27947,1,1,0.653,0.417,0.5,47257
studio,0.007,1526,2209,1,1,0.677,0.265,0.62,3735
internally,0.006,361,523,1,1,0.615,0.4,0.616,884
client,0.006,343,497,1,1,0.583,0.45,0.618,840
erode,0.006,28,41,1,1,0.208,0.643,0.58,69
achievement,0.006,367,532,1,1,0.896,0.808,0.759,899
grandchildren,0.006,331,480,1,1,0.796,0.545,0.426,811
burst,0.006,634,919,1,1,0.156,0.894,0.845,1553
dip,0.005,393,570,1,1,0.516,0.583,0.397,963
vibes,0.005,2759,3999,1,1,0.635,0.688,0.574,6758
retrograde,0.005,148,215,1,1,0.208,0.464,0.415,363
breakfast,0.005,1633,2368,1,1,0.885,0.33,0.429,4001
interrogate,0.005,19,28,1,1,0.323,0.808,0.68,47
gazette,0.005,19,28,1,1,0.469,0.39,0.604,47
upstanding,0.005,19,28,1,1,0.851,0.39,0.708,47
unabashed,0.005,19,28,1,1,0.292,0.614,0.488,47
recoil,0.005,19,28,1,1,0.089,0.429,0.259,47
mall,0.005,1001,1452,1,1,0.724,0.663,0.492,2453
worthless,0.005,3050,4424,1,1,0.083,0.42,0.153,7474
wot,0.004,70,102,1,1,0.52,0.48,0.357,172
spoke,0.004,2131,3092,1,1,0.635,0.433,0.483,5223
decent,0.004,1852,2688,1,1,0.823,0.296,0.653,4540
workout,0.004,573,832,1,1,0.868,0.827,0.78,1405
conflict,0.004,553,803,1,1,0.335,0.906,0.471,1356
market,0.004,1180,1713,1,1,0.724,0.48,0.521,2893
stooge,0.004,30,44,1,1,0.438,0.406,0.163,74
parts,0.004,2324,3374,1,1,0.459,0.327,0.392,5698
scribble,0.004,30,44,1,1,0.429,0.453,0.358,74
invisible,0.004,1759,2554,1,1,0.417,0.345,0.412,4313
balcony,0.003,311,452,1,1,0.562,0.392,0.38,763
corps,0.003,72,105,1,1,0.551,0.453,0.483,177
losing,0.003,7042,10227,1,1,0.076,0.686,0.223,17269
logic,0.003,890,1293,1,1,0.646,0.245,0.819,2183
yon,0.003,83,121,1,1,0.479,0.365,0.393,204
fad,0.003,41,60,1,1,0.663,0.52,0.57,101
imagination,0.003,1597,2320,1,1,0.802,0.491,0.547,3917
hypocrite,0.003,368,535,1,1,0.082,0.673,0.306,903
yummy,0.003,147,214,1,1,0.878,0.55,0.658,361
frightening,0.003,571,830,1,1,0.122,0.969,0.625,1401
portable,0.003,52,76,1,1,0.615,0.356,0.582,128
hairstyle,0.003,52,76,1,1,0.771,0.38,0.433,128
current,0.003,3077,4471,1,1,0.625,0.312,0.612,7548
autonomy,0.003,116,169,1,1,0.781,0.349,0.891,285
sticking,0.003,606,881,1,1,0.486,0.425,0.356,1487
sorely,0.003,63,92,1,1,0.284,0.727,0.37,155
mainstream,0.002,363,528,1,1,0.653,0.527,0.66,891
blinded,0.002,365,531,1,1,0.245,0.471,0.231,896
rested,0.002,215,313,1,1,0.792,0.235,0.462,528
serious,0.002,5357,7789,1,1,0.5,0.455,0.619,13146
bold,0.002,631,918,1,1,0.49,0.271,0.483,1549
essential,0.002,675,982,1,1,0.812,0.405,0.759,1657
future,0.002,10535,15320,1,1,0.888,0.644,0.786,25855
dominating,0.002,43,63,1,1,0.427,0.769,0.902,106
fir,0.002,164,239,1,1,0.521,0.275,0.306,403
overrun,0.002,43,63,1,1,0.271,0.764,0.598,106
ceramics,0.002,10,15,1,1,0.573,0.25,0.373,25
admission,0.002,142,207,1,1,0.802,0.415,0.732,349
passable,0.002,10,15,1,1,0.688,0.337,0.633,25
twelfth,0.002,21,31,1,1,0.521,0.292,0.527,52
moratorium,0.002,10,15,1,1,0.337,0.427,0.373,25
cranny,0.002,10,15,1,1,0.194,0.471,0.25,25
blot,0.002,10,15,1,1,0.365,0.304,0.223,25
hoist,0.002,10,15,1,1,0.521,0.52,0.458,25
necklace,0.002,153,223,1,1,0.76,0.294,0.373,376
chaff,0.002,10,15,1,1,0.333,0.327,0.188,25
betrothed,0.002,10,15,1,1,0.833,0.63,0.667,25
countryside,0.001,177,258,1,1,0.732,0.288,0.327,435
reliable,0.001,278,405,1,1,0.912,0.241,0.875,683
biz,0.001,190,277,1,1,0.5,0.473,0.473,467
passive,0.001,304,443,1,1,0.42,0.116,0.241,747
rudeness,0.001,56,82,1,1,0.28,0.819,0.692,138
attire,0.001,56,82,1,1,0.742,0.388,0.483,138
deviant,0.001,56,82,1,1,0.094,0.589,0.398,138
faint,0,343,500,1,1,0.063,0.429,0.167,843
felt,0,66488,96837,1,1,0.643,0.417,0.566,163325
congratulations,0,1182,1722,1,1,0.96,0.755,0.719,2904
mart,0,45,66,1,1,0.531,0.402,0.418,111
intermittent,0,45,66,1,1,0.337,0.565,0.436,111
aiding,0,45,66,1,1,0.643,0.533,0.569,111
patio,0,91,133,1,1,0.562,0.245,0.402,224
uncontrollable,0,115,168,1,1,0.265,0.79,0.626,283
careful,-0,1929,2811,1,1,0.625,0.538,0.53,4740
carcass,-0,34,50,1,1,0.115,0.529,0.309,84
gore,-0,176,257,1,1,0.26,0.608,0.518,433
succeeding,-0,117,171,1,1,0.867,0.755,0.849,288
elevated,-0.001,82,120,1,1,0.704,0.594,0.62,202
jungle,-0.001,486,709,1,1,0.5,0.51,0.481,1195
collapse,-0.001,296,432,1,1,0.208,0.689,0.342,728
extended,-0.001,774,1129,1,1,0.57,0.304,0.649,1903
oxygen,-0.001,309,451,1,1,0.908,0.31,0.575,760
industry,-0.001,1324,1931,1,1,0.65,0.447,0.836,3255
bombshell,-0.001,23,34,1,1,0.327,0.868,0.693,57
condescending,-0.001,167,244,1,1,0.583,0.363,0.593,411
concise,-0.001,23,34,1,1,0.583,0.298,0.62,57
soften,-0.001,71,104,1,1,0.694,0.194,0.392,175
mild,-0.001,287,419,1,1,0.635,0.198,0.216,706
grow,-0.001,7933,11573,1,1,0.914,0.615,0.755,19506
period,-0.001,4499,6564,1,1,0.396,0.324,0.588,11063
shrink,-0.002,158,231,1,1,0.385,0.453,0.272,389
continually,-0.002,269,393,1,1,0.646,0.438,0.698,662
reinforcement,-0.002,36,53,1,1,0.729,0.702,0.902,89
estranged,-0.002,184,269,1,1,0.156,0.382,0.377,453
psych,-0.002,308,450,1,1,0.48,0.5,0.526,758
corpse,-0.002,284,415,1,1,0.094,0.657,0.232,699
antisocial,-0.002,860,1256,1,1,0.146,0.686,0.391,2116
incorporate,-0.002,49,72,1,1,0.745,0.612,0.571,121
territory,-0.002,262,383,1,1,0.625,0.469,0.676,645
foolishness,-0.002,138,202,1,1,0.235,0.472,0.173,340
global,-0.002,922,1347,1,1,0.583,0.52,0.713,2269
woohoo,-0.002,151,221,1,1,0.658,0.67,0.451,372
soap,-0.002,316,462,1,1,0.531,0.163,0.311,778
tattoo,-0.003,847,1238,1,1,0.49,0.602,0.525,2085
blimp,-0.003,12,18,1,1,0.6,0.41,0.532,30
fixture,-0.003,25,37,1,1,0.663,0.216,0.409,62
puncture,-0.003,12,18,1,1,0.198,0.777,0.42,30
bodily,-0.003,77,113,1,1,0.594,0.481,0.557,190
abbreviation,-0.003,12,18,1,1,0.469,0.306,0.345,30
collarbone,-0.003,12,18,1,1,0.42,0.427,0.306,30
differentiation,-0.003,12,18,1,1,0.367,0.561,0.535,30
thong,-0.003,38,56,1,1,0.467,0.596,0.269,94
boiling,-0.003,155,227,1,1,0.302,0.69,0.526,382
dandruff,-0.003,12,18,1,1,0.398,0.298,0.293,30
esoteric,-0.003,25,37,1,1,0.5,0.676,0.545,62
tutor,-0.003,103,151,1,1,0.75,0.346,0.826,254
stalwart,-0.003,12,18,1,1,0.812,0.43,0.691,30
drag,-0.003,1660,2427,1,1,0.388,0.606,0.348,4087
willingly,-0.003,367,537,1,1,0.833,0.316,0.588,904
kids,-0.004,20094,29379,1,1,0.837,0.5,0.417,49473
yearly,-0.004,118,173,1,1,0.592,0.295,0.431,291
moral,-0.004,1191,1742,1,1,0.7,0.459,0.796,2933
martyr,-0.004,92,135,1,1,0.281,0.708,0.509,227
teeth,-0.004,1089,1593,1,1,0.52,0.388,0.427,2682
comprehension,-0.004,120,176,1,1,0.908,0.387,0.688,296
unwarranted,-0.004,53,78,1,1,0.091,0.5,0.345,131
credentials,-0.004,53,78,1,1,0.708,0.373,0.675,131
store,-0.004,2826,4135,1,1,0.646,0.538,0.407,6961
tantrum,-0.004,202,296,1,1,0.219,0.817,0.404,498
partake,-0.004,81,119,1,1,0.755,0.656,0.629,200
willful,-0.004,40,59,1,1,0.557,0.719,0.642,99
nay,-0.005,137,201,1,1,0.344,0.29,0.325,338
fold,-0.005,348,510,1,1,0.385,0.412,0.33,858
corporation,-0.005,83,122,1,1,0.429,0.332,0.873,205
antiquated,-0.005,27,40,1,1,0.42,0.392,0.236,67
aisle,-0.005,223,327,1,1,0.438,0.222,0.283,550
rhetorical,-0.005,55,81,1,1,0.417,0.569,0.635,136
pip,-0.005,83,122,1,1,0.448,0.43,0.366,205
shopping,-0.005,2144,3140,1,1,0.915,0.445,0.63,5284
terrible,-0.005,5705,8358,1,1,0.061,0.849,0.604,14063
theoretical,-0.006,42,62,1,1,0.615,0.27,0.546,104
ping,-0.006,145,213,1,1,0.541,0.49,0.391,358
remarkable,-0.006,218,320,1,1,0.88,0.573,0.72,538
detailed,-0.006,160,235,1,1,0.603,0.314,0.472,395
sympathize,-0.006,263,386,1,1,0.77,0.627,0.644,649
elbow,-0.006,102,150,1,1,0.448,0.133,0.254,252
effort,-0.006,3398,4983,1,1,0.698,0.778,0.858,8381
mooch,-0.007,29,43,1,1,0.378,0.413,0.309,72
unbeatable,-0.007,29,43,1,1,0.735,0.719,0.681,72
exhaustive,-0.007,14,21,1,1,0.388,0.635,0.604,35
irrationality,-0.007,14,21,1,1,0.198,0.735,0.361,35
veterinarian,-0.007,14,21,1,1,0.582,0.418,0.542,35
moisturizer,-0.007,14,21,1,1,0.75,0.28,0.386,35
arghhhh,-0.007,14,21,1,1,0.25,0.618,0.324,35
exceeding,-0.007,14,21,1,1,0.5,0.802,0.668,35
tonsils,-0.007,14,21,1,1,0.347,0.373,0.283,35
authoritative,-0.007,14,21,1,1,0.636,0.52,0.89,35
dumpster,-0.007,166,244,1,1,0.229,0.418,0.101,410
isolate,-0.007,2291,3362,1,1,0.235,0.422,0.336,5653
outdated,-0.007,106,156,1,1,0.167,0.236,0.226,262
class,-0.007,6620,9714,1,1,0.656,0.314,0.522,16334
diagnose,-0.007,91,134,1,1,0.378,0.52,0.714,225
settle,-0.007,5085,7463,1,1,0.833,0.52,0.772,12548
outburst,-0.007,61,90,1,1,0.209,0.802,0.528,151
tragedy,-0.007,837,1229,1,1,0.052,0.843,0.34,2066
secondary,-0.007,232,341,1,1,0.636,0.375,0.26,573
practiced,-0.007,108,159,1,1,0.612,0.605,0.58,267
vice,-0.008,623,915,1,1,0.296,0.778,0.48,1538
softball,-0.008,46,68,1,1,0.735,0.63,0.518,114
dearest,-0.008,443,651,1,1,0.902,0.427,0.508,1094
shirt,-0.008,1403,2061,1,1,0.698,0.186,0.231,3464
stifled,-0.008,31,46,1,1,0.229,0.731,0.193,77
resilience,-0.008,225,331,1,1,0.531,0.44,0.667,556
activate,-0.008,80,118,1,1,0.764,0.65,0.806,198
line,-0.008,7889,11592,1,1,0.541,0.18,0.353,19481
caliber,-0.009,48,71,1,1,0.429,0.551,0.606,119
bounds,-0.009,97,143,1,1,0.378,0.426,0.604,240
email,-0.009,1539,2262,1,1,0.698,0.23,0.456,3801
rise,-0.009,2114,3107,1,1,0.667,0.593,0.745,5221
economic,-0.009,459,675,1,1,0.561,0.408,0.639,1134
rant,-0.009,1922,2825,1,1,0.219,0.774,0.482,4747
detect,-0.009,65,96,1,1,0.531,0.52,0.565,161
motive,-0.009,165,243,1,1,0.667,0.588,0.663,408
downtime,-0.009,82,121,1,1,0.24,0.226,0.324,203
skittish,-0.009,16,24,1,1,0.156,0.815,0.172,40
restored,-0.009,152,224,1,1,0.892,0.41,0.728,376
resounding,-0.009,33,49,1,1,0.49,0.708,0.596,82
reincarnation,-0.009,50,74,1,1,0.786,0.747,0.676,124
exorbitant,-0.009,16,24,1,1,0.398,0.865,0.825,40
wristband,-0.009,16,24,1,1,0.551,0.194,0.292,40
refute,-0.009,33,49,1,1,0.312,0.731,0.583,82
befitting,-0.009,16,24,1,1,0.708,0.333,0.394,40
ejaculation,-0.009,16,24,1,1,0.615,0.893,0.547,40
irons,-0.009,16,24,1,1,0.531,0.441,0.625,40
brace,-0.009,101,149,1,1,0.61,0.385,0.364,250
ought,-0.009,290,427,1,1,0.438,0.511,0.434,717
grad,-0.01,691,1017,1,1,0.806,0.538,0.733,1708
toaster,-0.01,103,152,1,1,0.542,0.337,0.387,255
appear,-0.01,1607,2365,1,1,0.735,0.506,0.567,3972
hourly,-0.01,69,102,1,1,0.469,0.418,0.491,171
thinking,-0.01,33776,49703,1,1,0.72,0.308,0.595,83479
cane,-0.01,158,233,1,1,0.459,0.298,0.398,391
audio,-0.01,425,626,1,1,0.709,0.425,0.37,1051
intolerable,-0.01,88,130,1,1,0.146,0.66,0.439,218
gentle,-0.01,1443,2125,1,1,0.847,0.353,0.589,3568
simple,-0.011,4851,7143,1,1,0.653,0.13,0.314,11994
demeanor,-0.011,90,133,1,1,0.633,0.433,0.657,223
everyday,-0.011,13390,19718,1,1,0.74,0.392,0.472,33108
wisdom,-0.011,1241,1828,1,1,0.93,0.302,0.871,3069
jog,-0.011,109,161,1,1,0.51,0.708,0.519,270
probe,-0.011,54,80,1,1,0.398,0.444,0.512,134
beautiful,-0.011,23314,34336,1,1,0.875,0.614,0.648,57650
disappearing,-0.011,293,432,1,1,0.167,0.427,0.379,725
receive,-0.011,1693,2494,1,1,0.74,0.462,0.551,4187
sept,-0.011,221,326,1,1,0.521,0.333,0.361,547
preferable,-0.011,166,245,1,1,0.806,0.433,0.687,411
scared,-0.011,39819,58660,1,1,0.146,0.828,0.185,98479
morale,-0.011,75,111,1,1,0.729,0.158,0.792,186
reload,-0.011,18,27,1,1,0.562,0.611,0.571,45
colonel,-0.011,56,83,1,1,0.459,0.592,0.89,139
militant,-0.011,37,55,1,1,0.418,0.667,0.75,92
uphill,-0.012,134,198,1,1,0.396,0.723,0.572,332
fruit,-0.012,642,947,1,1,0.896,0.291,0.312,1589
worth,-0.012,15030,22164,1,1,0.872,0.51,0.889,37194
approach,-0.012,1644,2425,1,1,0.612,0.392,0.61,4069
salad,-0.012,416,614,1,1,0.75,0.26,0.307,1030
cloth,-0.012,119,176,1,1,0.51,0.19,0.287,295
demolished,-0.012,39,58,1,1,0.271,0.647,0.353,97
monogamy,-0.012,79,117,1,1,0.542,0.38,0.455,196
mistaken,-0.012,401,592,1,1,0.131,0.63,0.212,993
laptop,-0.012,887,1309,1,1,0.724,0.27,0.519,2196
terror,-0.012,605,893,1,1,0.069,0.902,0.415,1498
rightful,-0.013,60,89,1,1,0.837,0.358,0.821,149
final,-0.013,2277,3360,1,1,0.276,0.575,0.508,5637
marvel,-0.013,814,1202,1,1,0.961,0.755,0.866,2016
termination,-0.013,20,30,1,1,0.344,0.472,0.545,50
gunpoint,-0.013,20,30,1,1,0.188,0.817,0.719,50
firefighter,-0.013,41,61,1,1,0.637,0.77,0.773,102
dissociation,-0.013,62,92,1,1,0.135,0.555,0.471,154
demolition,-0.013,20,30,1,1,0.133,0.827,0.541,50
anatomy,-0.013,274,405,1,1,0.562,0.39,0.571,679
nephew,-0.014,538,795,1,1,0.719,0.337,0.412,1333
morality,-0.014,194,287,1,1,0.75,0.408,0.759,481
answer,-0.014,7862,11613,1,1,0.537,0.373,0.661,19475
vacation,-0.014,1896,2801,1,1,0.84,0.49,0.598,4697
celebrate,-0.014,3125,4617,1,1,0.917,0.857,0.859,7742
incorrect,-0.014,198,293,1,1,0.14,0.569,0.255,491
stable,-0.014,1063,1571,1,1,0.725,0.204,0.735,2634
blizzard,-0.014,89,132,1,1,0.375,0.726,0.417,221
overthinking,-0.014,1384,2046,1,1,0.408,0.761,0.525,3430
label,-0.014,503,744,1,1,0.582,0.245,0.423,1247
swarming,-0.015,22,33,1,1,0.375,0.6,0.435,55
recurrent,-0.015,22,33,1,1,0.552,0.5,0.561,55
nether,-0.015,22,33,1,1,0.24,0.265,0.259,55
detract,-0.015,22,33,1,1,0.344,0.438,0.368,55
privy,-0.015,22,33,1,1,0.583,0.481,0.648,55
parse,-0.015,22,33,1,1,0.469,0.456,0.667,55
toll,-0.015,829,1226,1,1,0.296,0.422,0.453,2055
hardship,-0.015,392,580,1,1,0.094,0.775,0.482,972
fortunate,-0.015,582,861,1,1,0.927,0.639,0.836,1443
woot,-0.015,70,104,1,1,0.602,0.49,0.481,174
coexist,-0.015,70,104,1,1,0.708,0.46,0.536,174
bow,-0.015,500,740,1,1,0.53,0.306,0.408,1240
preaching,-0.015,262,388,1,1,0.646,0.604,0.795,650
subscriber,-0.015,47,70,1,1,0.562,0.398,0.57,117
dud,-0.015,47,70,1,1,0.167,0.455,0.246,117
twins,-0.015,662,980,1,1,0.76,0.473,0.602,1642
rational,-0.016,374,554,1,1,0.775,0.347,0.632,928
dominance,-0.016,74,110,1,1,0.542,0.775,0.839,184
barley,-0.016,124,184,1,1,0.614,0.212,0.296,308
formulate,-0.016,24,36,1,1,0.851,0.456,0.673,60
blushing,-0.016,124,184,1,1,0.51,0.789,0.288,308
bur,-0.016,49,73,1,1,0.385,0.353,0.314,122
attest,-0.016,99,147,1,1,0.439,0.71,0.685,246
brotherhood,-0.016,151,224,1,1,0.99,0.471,0.76,375
marriage,-0.016,3751,5553,1,1,0.844,0.684,0.75,9304
earn,-0.016,615,911,1,1,0.865,0.769,0.817,1526
approve,-0.016,207,307,1,1,0.875,0.548,0.741,514
relative,-0.017,533,790,1,1,0.5,0.378,0.386,1323
leaflet,-0.017,26,39,1,1,0.49,0.206,0.375,65
curable,-0.017,26,39,1,1,0.823,0.292,0.574,65
correspondence,-0.017,26,39,1,1,0.663,0.423,0.491,65
curt,-0.017,26,39,1,1,0.245,0.61,0.452,65
defenseless,-0.017,109,162,1,1,0.143,0.357,0.105,271
context,-0.017,897,1330,1,1,0.531,0.3,0.553,2227
misleading,-0.017,140,208,1,1,0.07,0.66,0.272,348
punched,-0.017,171,254,1,1,0.188,0.634,0.452,425
affecting,-0.018,376,558,1,1,0.35,0.574,0.394,934
overwhelmed,-0.018,2376,3524,1,1,0.341,0.68,0.348,5900
tire,-0.018,264,392,1,1,0.438,0.385,0.381,656
unclear,-0.018,88,131,1,1,0.229,0.463,0.202,219
incase,-0.018,361,536,1,1,0.58,0.196,0.365,897
liar,-0.018,1304,1935,1,1,0.042,0.606,0.339,3239
design,-0.018,911,1352,1,1,0.796,0.327,0.632,2263
influential,-0.018,121,180,1,1,0.899,0.688,0.944,301
blame,-0.018,4669,6928,1,1,0.115,0.64,0.309,11597
newsletter,-0.018,61,91,1,1,0.622,0.385,0.49,152
kanji,-0.018,30,45,1,1,0.51,0.413,0.425,75
auto,-0.018,309,459,1,1,0.571,0.569,0.5,768
mania,-0.018,125,186,1,1,0.29,0.683,0.382,311
consider,-0.019,3353,4977,1,1,0.677,0.368,0.579,8330
clueless,-0.019,474,704,1,1,0.35,0.333,0.161,1178
center,-0.019,1418,2106,1,1,0.643,0.231,0.431,3524
jumbled,-0.019,32,48,1,1,0.292,0.602,0.445,80
nacho,-0.019,32,48,1,1,0.667,0.259,0.333,80
apprehension,-0.019,32,48,1,1,0.385,0.72,0.454,80
steal,-0.019,1228,1824,1,1,0.021,0.856,0.528,3052
chapter,-0.019,1201,1784,1,1,0.58,0.308,0.461,2985
eldest,-0.019,133,198,1,1,0.625,0.471,0.741,331
rookie,-0.019,133,198,1,1,0.583,0.37,0.198,331
facts,-0.019,2749,4083,1,1,0.688,0.471,0.693,6832
prophecy,-0.019,100,149,1,1,0.747,0.692,0.75,249
naming,-0.019,168,250,1,1,0.667,0.41,0.559,418
gratitude,-0.019,609,905,1,1,0.885,0.441,0.61,1514
deceiving,-0.019,102,152,1,1,0.099,0.636,0.426,254
pounding,-0.019,172,256,1,1,0.333,0.843,0.731,428
racking,-0.02,34,51,1,1,0.411,0.442,0.375,85
gradual,-0.02,34,51,1,1,0.571,0.35,0.509,85
texture,-0.02,69,103,1,1,0.615,0.215,0.412,172
bend,-0.02,322,479,1,1,0.571,0.324,0.368,801
demanding,-0.02,398,592,1,1,0.396,0.75,0.828,990
completion,-0.02,73,109,1,1,0.656,0.47,0.525,182
conjunction,-0.02,36,54,1,1,0.52,0.472,0.509,90
gripe,-0.021,38,57,1,1,0.184,0.526,0.241,95
abiding,-0.021,77,115,1,1,0.796,0.327,0.75,192
heavily,-0.021,668,994,1,1,0.542,0.679,0.814,1662
mashed,-0.021,79,118,1,1,0.531,0.337,0.194,197
official,-0.021,1055,1570,1,1,0.646,0.565,0.833,2625
cherishing,-0.021,40,60,1,1,0.836,0.38,0.625,100
massive,-0.021,1716,2554,1,1,0.569,0.66,0.75,4270
electronics,-0.021,83,124,1,1,0.708,0.545,0.574,207
mending,-0.021,42,63,1,1,0.5,0.633,0.657,105
hydra,-0.021,42,63,1,1,0.406,0.598,0.534,105
mainland,-0.021,42,63,1,1,0.68,0.407,0.806,105
biological,-0.021,257,383,1,1,0.59,0.41,0.615,640
prosperous,-0.022,87,130,1,1,0.948,0.627,0.89,217
menace,-0.022,87,130,1,1,0.125,0.894,0.759,217
skilled,-0.022,134,200,1,1,0.886,0.614,0.929,334
rotten,-0.022,367,547,1,1,0.104,0.59,0.327,914
portion,-0.022,371,553,1,1,0.536,0.364,0.398,924
scape,-0.022,46,69,1,1,0.29,0.625,0.536,115
liking,-0.022,2169,3231,1,1,0.963,0.604,0.589,5400
love,-0.022,257350,383312,1,1,1,0.519,0.673,640662
milk,-0.022,1155,1721,1,1,0.817,0.27,0.327,2876
heartbreaking,-0.022,1735,2585,1,1,0.146,0.811,0.423,4320
creation,-0.023,658,981,1,1,0.927,0.575,0.868,1639
hinge,-0.023,101,151,1,1,0.458,0.292,0.417,252
lovee,-0.023,50,75,1,1,0.949,0.592,0.611,125
throat,-0.023,1178,1756,1,1,0.35,0.538,0.346,2934
ton,-0.023,1269,1892,1,1,0.56,0.418,0.604,3161
enormously,-0.023,52,78,1,1,0.76,0.694,0.872,130
amazed,-0.023,480,716,1,1,0.796,0.779,0.533,1196
begin,-0.023,2789,4159,1,1,0.677,0.569,0.763,6948
entourage,-0.023,56,84,1,1,0.491,0.567,0.467,140
sneakers,-0.023,58,87,1,1,0.604,0.548,0.349,145
moderation,-0.023,58,87,1,1,0.531,0.24,0.453,145
seclusion,-0.023,176,263,1,1,0.23,0.558,0.505,439
happier,-0.024,2987,4456,1,1,0.99,0.76,0.806,7443
lottery,-0.024,180,269,1,1,0.771,0.731,0.491,449
definitive,-0.024,60,90,1,1,0.583,0.479,0.787,150
blindly,-0.024,186,278,1,1,0.439,0.598,0.278,464
lights,-0.024,3875,5782,1,1,0.75,0.48,0.575,9657
wad,-0.024,62,93,1,1,0.333,0.318,0.259,155
headache,-0.024,692,1033,1,1,0.168,0.755,0.273,1725
affect,-0.024,1287,1921,1,1,0.458,0.569,0.578,3208
team,-0.024,7434,11096,1,1,0.708,0.461,0.688,18530
defeat,-0.024,772,1153,1,1,0.092,0.5,0.224,1925
masses,-0.025,295,441,1,1,0.552,0.453,0.473,736
saver,-0.025,76,114,1,1,0.745,0.382,0.802,190
read,-0.025,19672,29384,1,1,0.74,0.283,0.611,49056
warn,-0.025,323,483,1,1,0.429,0.647,0.564,806
warning,-0.025,1015,1517,1,1,0.229,0.774,0.629,2532
fork,-0.026,189,283,1,1,0.406,0.3,0.529,472
weighing,-0.026,197,295,1,1,0.449,0.441,0.468,492
previous,-0.026,1009,1509,1,1,0.521,0.337,0.348,2518
habit,-0.026,1524,2279,1,1,0.625,0.226,0.585,3803
editing,-0.026,423,633,1,1,0.604,0.404,0.493,1056
illegal,-0.026,879,1315,1,1,0.061,0.787,0.337,2194
pi,-0.026,110,165,1,1,0.469,0.265,0.4,275
marvelous,-0.026,122,183,1,1,0.948,0.637,0.778,305
tyranny,-0.026,124,186,1,1,0.112,0.792,0.705,310
intentionally,-0.026,376,563,1,1,0.45,0.676,0.696,939
rental,-0.027,126,189,1,1,0.51,0.37,0.308,315
hardy,-0.027,130,195,1,1,0.571,0.569,0.81,325
parenthood,-0.027,130,195,1,1,0.75,0.63,0.782,325
virtual,-0.027,1103,1651,1,1,0.598,0.532,0.463,2754
hive,-0.027,138,207,1,1,0.471,0.452,0.544,345
importance,-0.027,911,1364,1,1,0.75,0.58,0.864,2275
tell,-0.027,49611,74267,1,1,0.551,0.35,0.457,123878
typo,-0.027,170,255,1,1,0.224,0.415,0.255,425
convenience,-0.027,349,523,1,1,0.781,0.448,0.613,872
unhealthy,-0.027,1405,2104,1,1,0.115,0.549,0.214,3509
defeated,-0.027,777,1164,1,1,0.104,0.582,0.145,1941
sincere,-0.027,584,875,1,1,0.918,0.265,0.725,1459
beloved,-0.028,1220,1828,1,1,0.969,0.613,0.708,3048
determined,-0.028,713,1069,1,1,0.76,0.528,0.673,1782
can,-0.028,320858,480920,1,1,0.662,0.36,0.454,801778
deploy,-0.029,25,38,1,1,0.5,0.52,0.585,63
militants,-0.029,11,17,1,1,0.26,0.673,0.652,28
paranoia,-0.029,517,776,1,1,0.146,0.841,0.407,1293
roomful,-0.029,19,29,1,1,0.786,0.425,0.634,48
tactile,-0.029,21,32,1,1,0.573,0.41,0.491,53
corset,-0.029,11,17,1,1,0.49,0.52,0.381,28
confetti,-0.029,43,65,1,1,0.781,0.573,0.25,108
rightly,-0.029,141,212,1,1,0.74,0.471,0.782,353
casserole,-0.029,27,41,1,1,0.57,0.36,0.328,68
fabricated,-0.029,61,92,1,1,0.418,0.427,0.555,153
inference,-0.029,17,26,1,1,0.359,0.479,0.398,43
cornflakes,-0.029,19,29,1,1,0.729,0.346,0.355,48
statistic,-0.029,111,167,1,1,0.508,0.42,0.609,278
attainable,-0.029,29,44,1,1,0.76,0.5,0.759,73
coleslaw,-0.029,11,17,1,1,0.707,0.312,0.336,28
vernacular,-0.029,13,20,1,1,0.479,0.453,0.615,33
perpetuity,-0.029,13,20,1,1,0.59,0.434,0.759,33
ticked,-0.029,55,83,1,1,0.469,0.386,0.455,138
prolong,-0.029,41,62,1,1,0.573,0.567,0.535,103
snarl,-0.029,13,20,1,1,0.43,0.787,0.455,33
improbable,-0.029,23,35,1,1,0.097,0.412,0.439,58
restraining,-0.029,67,101,1,1,0.296,0.702,0.672,168
arched,-0.029,23,35,1,1,0.582,0.403,0.398,58
intercession,-0.029,15,23,1,1,0.503,0.486,0.598,38
ravine,-0.029,13,20,1,1,0.354,0.673,0.413,33
malfunction,-0.029,37,56,1,1,0.125,0.577,0.229,93
outwards,-0.029,23,35,1,1,0.44,0.472,0.4,58
courthouse,-0.029,21,32,1,1,0.571,0.503,0.818,53
crappy,-0.029,533,800,1,1,0.039,0.582,0.208,1333
impede,-0.029,13,20,1,1,0.271,0.51,0.604,33
uncontrolled,-0.029,29,44,1,1,0.188,0.891,0.544,73
blistering,-0.029,13,20,1,1,0.344,0.569,0.39,33
homeroom,-0.029,17,26,1,1,0.604,0.48,0.491,43
chivalry,-0.029,19,29,1,1,0.857,0.38,0.848,48
insulate,-0.029,13,20,1,1,0.365,0.358,0.286,33
shorthand,-0.029,11,17,1,1,0.459,0.45,0.461,28
scoot,-0.029,37,56,1,1,0.51,0.49,0.412,93
redirect,-0.029,45,68,1,1,0.469,0.36,0.648,113
eyelash,-0.029,27,41,1,1,0.48,0.25,0.278,68
fatigued,-0.029,53,80,1,1,0.146,0.433,0.245,133
quarterly,-0.029,19,29,1,1,0.604,0.38,0.448,48
outset,-0.029,11,17,1,1,0.75,0.5,0.582,28
erroneous,-0.029,23,35,1,1,0.057,0.561,0.245,58
hemp,-0.029,19,29,1,1,0.469,0.439,0.422,48
storyteller,-0.029,41,62,1,1,0.73,0.357,0.462,103
accelerate,-0.029,25,38,1,1,0.615,0.902,0.759,63
foil,-0.029,53,80,1,1,0.312,0.204,0.342,133
faction,-0.029,45,68,1,1,0.469,0.43,0.448,113
regulate,-0.029,49,74,1,1,0.51,0.275,0.481,123
lawyer,-0.029,411,617,1,1,0.521,0.569,0.784,1028
tremor,-0.029,23,35,1,1,0.104,0.833,0.455,58
gloss,-0.029,39,59,1,1,0.757,0.466,0.625,98
gymnastics,-0.029,55,83,1,1,0.745,0.677,0.508,138
indispensable,-0.029,25,38,1,1,0.71,0.449,0.802,63
goblet,-0.029,13,20,1,1,0.786,0.353,0.442,33
gulp,-0.029,45,68,1,1,0.551,0.66,0.409,113
compact,-0.029,27,41,1,1,0.458,0.417,0.673,68
clot,-0.029,13,20,1,1,0.15,0.558,0.275,33
bib,-0.029,11,17,1,1,0.385,0.396,0.339,28
administrator,-0.029,21,32,1,1,0.538,0.48,0.902,53
offer,-0.029,3821,5732,1,1,0.75,0.745,0.596,9553
influenza,-0.029,11,17,1,1,0.271,0.718,0.321,28
toughness,-0.029,31,47,1,1,0.552,0.618,0.837,78
cannibalism,-0.029,17,26,1,1,0.094,0.89,0.583,43
instantaneous,-0.029,13,20,1,1,0.75,0.5,0.585,33
vicarious,-0.029,15,23,1,1,0.479,0.452,0.517,38
veronica,-0.029,149,224,1,1,0.594,0.399,0.402,373
skipper,-0.029,15,23,1,1,0.44,0.577,0.692,38
unisex,-0.029,17,26,1,1,0.492,0.417,0.417,43
overheated,-0.029,11,17,1,1,0.25,0.598,0.547,28
buzzer,-0.029,21,32,1,1,0.549,0.716,0.48,53
miscellaneous,-0.029,11,17,1,1,0.531,0.321,0.196,28
handler,-0.029,47,71,1,1,0.439,0.593,0.861,118
shoes,-0.029,1438,2158,1,1,0.729,0.324,0.21,3596
punishment,-0.03,588,883,1,1,0.083,0.825,0.536,1471
credit,-0.03,1387,2083,1,1,0.673,0.549,0.648,3470
granted,-0.03,1390,2088,1,1,0.882,0.348,0.779,3478
raised,-0.031,1842,2768,1,1,0.656,0.326,0.643,4610
cringe,-0.031,558,839,1,1,0.245,0.84,0.377,1397
wed,-0.031,172,259,1,1,0.604,0.549,0.448,431
halfway,-0.031,484,728,1,1,0.51,0.254,0.339,1212
woods,-0.031,2322,3491,1,1,0.594,0.269,0.364,5813
ask,-0.031,20514,30842,1,1,0.531,0.44,0.459,51356
appropriate,-0.032,545,820,1,1,0.833,0.368,0.759,1365
attendance,-0.032,134,202,1,1,0.812,0.5,0.592,336
getaway,-0.032,128,193,1,1,0.5,0.76,0.368,321
chemistry,-0.032,382,575,1,1,0.625,0.52,0.694,957
trend,-0.032,628,945,1,1,0.625,0.458,0.706,1573
crop,-0.032,122,184,1,1,0.615,0.26,0.5,306
related,-0.032,1990,2995,1,1,0.677,0.365,0.519,4985
smelling,-0.032,207,312,1,1,0.458,0.481,0.349,519
arrange,-0.032,207,312,1,1,0.74,0.49,0.571,519
abide,-0.032,100,151,1,1,0.635,0.354,0.705,251
flesh,-0.033,674,1015,1,1,0.604,0.39,0.475,1689
chalk,-0.033,86,130,1,1,0.385,0.185,0.121,216
buffoon,-0.033,84,127,1,1,0.344,0.651,0.29,211
practical,-0.033,315,475,1,1,0.71,0.49,0.608,790
savannah,-0.033,76,115,1,1,0.729,0.212,0.309,191
mansions,-0.034,74,112,1,1,0.735,0.529,0.777,186
carol,-0.034,370,558,1,1,0.673,0.412,0.436,928
express,-0.034,3357,5059,1,1,0.76,0.623,0.691,8416
occasion,-0.034,429,647,1,1,0.7,0.451,0.398,1076
consideration,-0.034,283,427,1,1,0.589,0.38,0.687,710
advanced,-0.034,275,415,1,1,0.844,0.623,0.797,690
major,-0.034,2665,4018,1,1,0.684,0.538,0.874,6683
cuss,-0.034,123,186,1,1,0.354,0.538,0.443,309
vouch,-0.035,60,91,1,1,0.625,0.417,0.746,151
guest,-0.035,731,1103,1,1,0.719,0.49,0.558,1834
voice,-0.035,11503,17350,1,1,0.594,0.343,0.528,28853
clapping,-0.035,119,180,1,1,0.823,0.894,0.686,299
destruct,-0.035,58,88,1,1,0.071,0.868,0.525,146
hedge,-0.035,58,88,1,1,0.604,0.602,0.569,146
potential,-0.035,1619,2443,1,1,0.806,0.625,0.84,4062
wonderful,-0.035,6742,10172,1,1,0.971,0.776,0.83,16914
innocent,-0.035,1517,2290,1,1,0.729,0.206,0.34,3807
disturb,-0.035,692,1045,1,1,0.175,0.76,0.481,1737
submitting,-0.035,52,79,1,1,0.667,0.61,0.611,131
affliction,-0.035,156,236,1,1,0.294,0.635,0.392,392
celebrated,-0.036,407,615,1,1,0.875,0.69,0.763,1022
settlement,-0.036,50,76,1,1,0.635,0.412,0.723,126
giving,-0.036,9392,14183,1,1,0.795,0.333,0.585,23575
enthusiasm,-0.036,195,295,1,1,0.938,0.816,0.798,490
obvious,-0.036,2031,3068,1,1,0.625,0.336,0.585,5099
doubled,-0.036,93,141,1,1,0.427,0.536,0.56,234
sesame,-0.036,46,70,1,1,0.673,0.25,0.382,116
loose,-0.036,1244,1880,1,1,0.573,0.312,0.365,3124
whatsoever,-0.036,635,960,1,1,0.4,0.314,0.302,1595
footprint,-0.037,44,67,1,1,0.592,0.292,0.336,111
oils,-0.037,44,67,1,1,0.459,0.229,0.391,111
difficulty,-0.037,402,608,1,1,0.079,0.74,0.368,1010
navy,-0.037,267,404,1,1,0.531,0.76,0.764,671
drastic,-0.037,132,200,1,1,0.194,0.839,0.657,332
restriction,-0.037,42,64,1,1,0.13,0.59,0.569,106
commentator,-0.037,42,64,1,1,0.492,0.51,0.607,106
feces,-0.037,42,64,1,1,0.24,0.407,0.307,106
clinical,-0.037,253,383,1,1,0.337,0.412,0.64,636
maximum,-0.037,210,318,1,1,0.724,0.724,0.852,528
hubby,-0.037,800,1210,1,1,0.548,0.435,0.43,2010
use,-0.037,18642,28185,1,1,0.438,0.358,0.409,46827
oppressed,-0.037,251,380,1,1,0.119,0.64,0.259,631
enjoying,-0.037,4378,6620,1,1,0.908,0.759,0.759,10998
monstrous,-0.037,81,123,1,1,0.094,0.942,0.649,204
reign,-0.037,202,306,1,1,0.806,0.567,0.873,508
creed,-0.037,120,182,1,1,0.573,0.245,0.544,302
murderer,-0.038,352,533,1,1,0.01,0.96,0.65,885
side,-0.038,23236,35163,1,1,0.439,0.288,0.395,58399
frozen,-0.038,819,1240,1,1,0.344,0.346,0.375,2059
agile,-0.038,36,55,1,1,0.8,0.657,0.775,91
residency,-0.038,73,111,1,1,0.694,0.357,0.679,184
phenomenon,-0.038,256,388,1,1,0.625,0.721,0.848,644
interpretation,-0.038,219,332,1,1,0.677,0.594,0.62,551
toothbrush,-0.038,71,108,1,1,0.517,0.33,0.321,179
conquer,-0.038,573,868,1,1,0.694,0.873,0.971,1441
report,-0.039,1896,2872,1,1,0.583,0.444,0.575,4768
hellhole,-0.039,67,102,1,1,0.2,0.615,0.421,169
institute,-0.039,98,149,1,1,0.604,0.48,0.807,247
demos,-0.039,32,49,1,1,0.418,0.37,0.368,81
forceful,-0.039,32,49,1,1,0.533,0.673,0.898,81
shrunk,-0.039,32,49,1,1,0.163,0.354,0.218,81
absurdity,-0.039,63,96,1,1,0.115,0.528,0.227,159
discouraging,-0.04,158,240,1,1,0.167,0.469,0.281,398
cursed,-0.04,792,1201,1,1,0.083,0.783,0.393,1993
reclaim,-0.04,92,140,1,1,0.469,0.724,0.648,232
weight,-0.04,3551,5385,1,1,0.45,0.38,0.577,8936
would,-0.04,103242,156562,1,1,0.493,0.412,0.427,259804
batch,-0.04,148,225,1,1,0.56,0.357,0.357,373
freeze,-0.04,324,492,1,1,0.191,0.406,0.481,816
expectation,-0.04,349,530,1,1,0.771,0.69,0.707,879
race,-0.041,1921,2915,1,1,0.592,0.426,0.658,4836
offload,-0.041,28,43,1,1,0.479,0.444,0.525,71
avid,-0.041,86,131,1,1,0.582,0.459,0.593,217
region,-0.041,260,395,1,1,0.54,0.295,0.712,655
speciality,-0.041,28,43,1,1,0.854,0.47,0.885,71
action,-0.041,2164,3284,1,1,0.76,0.898,0.802,5448
years,-0.041,44841,68062,1,1,0.653,0.33,0.508,112903
pleasing,-0.041,248,377,1,1,0.917,0.449,0.788,625
uniform,-0.041,217,330,1,1,0.57,0.245,0.655,547
percentage,-0.041,215,327,1,1,0.469,0.4,0.553,542
disintegrate,-0.041,26,40,1,1,0.143,0.66,0.364,66
swinging,-0.041,215,327,1,1,0.656,0.51,0.312,542
godmother,-0.041,26,40,1,1,0.733,0.311,0.53,66
globe,-0.041,375,570,1,1,0.76,0.315,0.364,945
trafficking,-0.042,240,365,1,1,0.25,0.71,0.399,605
analogy,-0.042,105,160,1,1,0.51,0.367,0.509,265
pancakes,-0.042,211,321,1,1,0.844,0.373,0.402,532
wrist,-0.042,307,467,1,1,0.706,0.34,0.265,774
knots,-0.042,76,116,1,1,0.418,0.346,0.267,192
obtain,-0.042,126,192,1,1,0.76,0.438,0.731,318
solidified,-0.042,49,75,1,1,0.633,0.415,0.745,124
envision,-0.042,74,113,1,1,0.625,0.449,0.483,187
chemotherapy,-0.042,24,37,1,1,0.163,0.689,0.517,61
strangle,-0.042,49,75,1,1,0.094,0.927,0.527,124
compatible,-0.042,222,338,1,1,0.892,0.387,0.638,560
emerge,-0.043,120,183,1,1,0.602,0.594,0.731,303
microphone,-0.043,95,145,1,1,0.551,0.431,0.462,240
dignity,-0.043,592,901,1,1,0.844,0.391,0.873,1493
attitude,-0.043,2111,3212,1,1,0.76,0.644,0.861,5323
heaven,-0.043,4308,6556,1,1,0.896,0.385,0.6,10864
ruff,-0.044,68,104,1,1,0.365,0.51,0.375,172
agricultural,-0.044,22,34,1,1,0.686,0.321,0.473,56
sidekick,-0.044,68,104,1,1,0.602,0.439,0.509,172
ulcer,-0.044,22,34,1,1,0.286,0.596,0.377,56
shutter,-0.044,22,34,1,1,0.191,0.38,0.482,56
peel,-0.044,112,171,1,1,0.439,0.25,0.279,283
divine,-0.044,736,1121,1,1,0.918,0.571,0.885,1857
warms,-0.044,332,506,1,1,0.594,0.58,0.632,838
disliked,-0.044,219,334,1,1,0.062,0.51,0.221,553
closet,-0.044,1133,1726,1,1,0.531,0.204,0.33,2859
light,-0.044,14085,21451,1,1,0.771,0.32,0.519,35536
possibly,-0.045,2514,3830,1,1,0.448,0.4,0.5,6344
knuckles,-0.045,106,162,1,1,0.271,0.461,0.32,268
prospective,-0.045,41,63,1,1,0.678,0.5,0.717,104
toolbox,-0.045,20,31,1,1,0.531,0.316,0.472,51
wall,-0.045,4198,6399,1,1,0.417,0.25,0.509,10597
bewildered,-0.045,81,124,1,1,0.23,0.63,0.3,205
psychosis,-0.046,119,182,1,1,0.167,0.859,0.312,301
oneday,-0.046,39,60,1,1,0.667,0.245,0.374,99
journey,-0.046,8724,13308,1,1,0.91,0.702,0.625,22032
survival,-0.046,710,1084,1,1,0.541,0.798,0.879,1794
healer,-0.046,191,292,1,1,0.863,0.378,0.741,483
commons,-0.047,75,115,1,1,0.633,0.396,0.623,190
nitro,-0.047,18,28,1,1,0.5,0.647,0.639,46
argument,-0.047,1080,1649,1,1,0.51,0.464,0.698,2729
split,-0.047,867,1324,1,1,0.344,0.618,0.41,2191
annoy,-0.047,1089,1663,1,1,0.094,0.765,0.286,2752
quietly,-0.047,1214,1854,1,1,0.561,0.125,0.321,3068
choosing,-0.047,1946,2972,1,1,0.719,0.529,0.689,4918
discern,-0.047,73,112,1,1,0.459,0.566,0.518,185
redeemed,-0.047,73,112,1,1,0.625,0.378,0.434,185
manual,-0.047,109,167,1,1,0.635,0.245,0.449,276
guts,-0.047,638,975,1,1,0.592,0.649,0.582,1613
speeding,-0.047,90,138,1,1,0.438,0.908,0.645,228
kindred,-0.047,162,248,1,1,0.76,0.418,0.517,410
saliva,-0.047,35,54,1,1,0.214,0.265,0.236,89
platter,-0.047,35,54,1,1,0.686,0.245,0.219,89
proceeding,-0.047,35,54,1,1,0.688,0.428,0.753,89
diversity,-0.047,323,494,1,1,0.806,0.472,0.711,817
evil,-0.048,3918,5987,1,1,0.04,0.827,0.545,9905
conflicting,-0.048,124,190,1,1,0.173,0.738,0.553,314
gusto,-0.048,300,459,1,1,0.692,0.729,0.62,759
tool,-0.048,739,1130,1,1,0.49,0.35,0.594,1869
time,-0.048,196138,299793,1,1,0.604,0.288,0.609,495931
profit,-0.048,349,534,1,1,0.93,0.462,0.721,883
need,-0.048,169990,259917,1,1,0.51,0.574,0.2,429907
deserving,-0.048,411,629,1,1,0.802,0.596,0.858,1040
expense,-0.048,239,366,1,1,0.317,0.451,0.377,605
part,-0.048,26842,41049,1,1,0.663,0.278,0.36,67891
financial,-0.048,1193,1825,1,1,0.667,0.5,0.722,3018
rota,-0.049,16,25,1,1,0.32,0.462,0.209,41
tricycle,-0.049,16,25,1,1,0.633,0.402,0.368,41
heaving,-0.049,50,77,1,1,0.201,0.843,0.491,127
accumulate,-0.049,33,51,1,1,0.573,0.536,0.607,84
differing,-0.049,50,77,1,1,0.418,0.41,0.455,127
sigma,-0.049,33,51,1,1,0.49,0.472,0.535,84
propose,-0.049,237,363,1,1,0.604,0.72,0.71,600
repeated,-0.049,267,409,1,1,0.429,0.472,0.314,676
underestimate,-0.049,365,559,1,1,0.413,0.464,0.193,924
infection,-0.049,165,253,1,1,0.083,0.735,0.407,418
arsenal,-0.049,231,354,1,1,0.365,0.741,0.752,585
puzzled,-0.049,65,100,1,1,0.204,0.5,0.272,165
overwhelm,-0.049,180,276,1,1,0.25,0.823,0.462,456
shitty,-0.049,5146,7877,1,1,0.02,0.679,0.163,13023
binary,-0.049,129,198,1,1,0.49,0.356,0.42,327
indicate,-0.05,144,221,1,1,0.594,0.35,0.676,365
headstone,-0.05,31,48,1,1,0.24,0.378,0.349,79
antics,-0.05,127,195,1,1,0.448,0.74,0.236,322
fervent,-0.05,31,48,1,1,0.646,0.632,0.773,79
imp,-0.05,63,97,1,1,0.35,0.448,0.42,160
cupping,-0.05,31,48,1,1,0.49,0.61,0.402,79
backpack,-0.05,159,244,1,1,0.729,0.278,0.333,403
salon,-0.05,127,195,1,1,0.531,0.296,0.463,322
asparagus,-0.05,31,48,1,1,0.469,0.317,0.264,79
aids,-0.05,351,538,1,1,0.561,0.48,0.5,889
spiritual,-0.05,1320,2022,1,1,0.938,0.327,0.564,3342
likely,-0.05,4707,7209,1,1,0.633,0.356,0.454,11916
stupidity,-0.05,648,993,1,1,0.06,0.418,0.151,1641
tic,-0.05,78,120,1,1,0.271,0.438,0.25,198
trifling,-0.05,46,71,1,1,0.375,0.418,0.183,117
denying,-0.05,311,477,1,1,0.08,0.542,0.272,788
ways,-0.051,6954,10657,1,1,0.688,0.56,0.425,17611
certified,-0.051,153,235,1,1,0.781,0.422,0.806,388
popcorn,-0.051,399,612,1,1,0.875,0.441,0.231,1011
developer,-0.051,106,163,1,1,0.844,0.653,0.864,269
minor,-0.051,545,836,1,1,0.25,0.235,0.175,1381
unlikely,-0.051,316,485,1,1,0.271,0.293,0.245,801
deceptive,-0.051,44,68,1,1,0.027,0.605,0.294,112
efficacy,-0.051,14,22,1,1,0.802,0.49,0.906,36
trance,-0.051,89,137,1,1,0.469,0.481,0.382,226
fluctuating,-0.051,29,45,1,1,0.292,0.591,0.395,74
expendable,-0.051,44,68,1,1,0.479,0.49,0.423,112
residual,-0.051,29,45,1,1,0.448,0.288,0.327,74
resolute,-0.051,29,45,1,1,0.771,0.51,0.712,74
slavery,-0.051,179,275,1,1,0.052,0.783,0.218,454
coliseum,-0.051,14,22,1,1,0.612,0.663,0.704,36
wrap,-0.052,937,1438,1,1,0.594,0.441,0.275,2375
inspired,-0.052,1741,2672,1,1,0.967,0.702,0.736,4413
insanity,-0.052,521,800,1,1,0.098,0.847,0.337,1321
recent,-0.052,1690,2594,1,1,0.592,0.365,0.589,4284
sitter,-0.052,100,154,1,1,0.656,0.429,0.404,254
bounce,-0.052,474,728,1,1,0.375,0.633,0.386,1202
pane,-0.052,42,65,1,1,0.385,0.25,0.444,107
strings,-0.052,414,636,1,1,0.457,0.292,0.355,1050
supernatural,-0.052,255,392,1,1,0.622,0.824,0.733,647
powder,-0.052,98,151,1,1,0.521,0.25,0.194,249
channel,-0.052,1564,2402,1,1,0.49,0.287,0.405,3966
unrealistic,-0.053,322,495,1,1,0.229,0.5,0.245,817
muddled,-0.053,27,42,1,1,0.25,0.615,0.263,69
injure,-0.053,27,42,1,1,0.177,0.71,0.364,69
strut,-0.053,27,42,1,1,0.58,0.48,0.464,69
metric,-0.053,55,85,1,1,0.519,0.248,0.573,140
hammering,-0.053,27,42,1,1,0.347,0.779,0.557,69
saddens,-0.053,219,337,1,1,0.104,0.436,0.144,556
people,-0.053,282315,433752,1,1,0.604,0.4,0.5,716067
fortitude,-0.053,81,125,1,1,0.823,0.608,0.897,206
incest,-0.054,105,162,1,1,0.073,0.853,0.491,267
greatest,-0.054,3138,4827,1,1,0.847,0.627,0.922,7965
insight,-0.054,534,822,1,1,0.613,0.363,0.649,1356
son,-0.054,7396,11378,1,1,0.792,0.365,0.528,18774
covert,-0.054,38,59,1,1,0.5,0.57,0.508,97
bureaucratic,-0.054,12,19,1,1,0.28,0.63,0.573,31
caddy,-0.054,12,19,1,1,0.58,0.47,0.38,31
altercation,-0.054,12,19,1,1,0.17,0.806,0.5,31
elastic,-0.054,25,39,1,1,0.656,0.518,0.385,64
spectator,-0.054,38,59,1,1,0.694,0.56,0.667,97
birthmark,-0.054,12,19,1,1,0.63,0.461,0.5,31
autopilot,-0.054,38,59,1,1,0.594,0.462,0.632,97
cleanup,-0.054,25,39,1,1,0.729,0.314,0.451,64
legality,-0.054,12,19,1,1,0.765,0.343,0.713,31
thickness,-0.054,12,19,1,1,0.552,0.37,0.443,31
overriding,-0.054,12,19,1,1,0.24,0.49,0.384,31
inaudible,-0.054,12,19,1,1,0.28,0.398,0.358,31
idiots,-0.055,1128,1737,1,1,0.143,0.6,0.144,2865
drones,-0.055,75,116,1,1,0.398,0.577,0.588,191
quirk,-0.055,75,116,1,1,0.49,0.384,0.618,191
concealed,-0.055,49,76,1,1,0.344,0.363,0.352,125
feel,-0.056,464320,715215,1,1,0.802,0.602,0.596,1179535
thumping,-0.056,36,56,1,1,0.214,0.755,0.566,92
overthrow,-0.056,36,56,1,1,0.26,0.868,0.62,92
baseless,-0.056,60,93,1,1,0.292,0.382,0.375,153
soiled,-0.057,23,36,1,1,0.106,0.529,0.213,59
patent,-0.057,23,36,1,1,0.724,0.391,0.609,59
waterproof,-0.057,23,36,1,1,0.779,0.423,0.545,59
dedication,-0.057,303,468,1,1,0.867,0.471,0.682,771
boundary,-0.057,69,107,1,1,0.561,0.427,0.518,176
riddance,-0.058,80,124,1,1,0.323,0.562,0.472,204
entertainer,-0.058,80,124,1,1,0.888,0.709,0.759,204
vinegar,-0.058,45,70,1,1,0.276,0.37,0.356,115
other,-0.058,74355,114769,1,1,0.472,0.23,0.259,189124
affinity,-0.058,56,87,1,1,0.8,0.5,0.537,143
fuse,-0.058,67,104,1,1,0.373,0.565,0.574,171
headset,-0.058,78,121,1,1,0.602,0.34,0.302,199
rice,-0.058,585,904,1,1,0.667,0.208,0.33,1489
marketing,-0.058,381,589,1,1,0.521,0.774,0.675,970
planting,-0.058,100,155,1,1,0.635,0.343,0.595,255
foul,-0.058,212,328,1,1,0.224,0.46,0.355,540
plight,-0.059,210,325,1,1,0.45,0.52,0.547,535
typically,-0.059,454,702,1,1,0.569,0.377,0.559,1156
identify,-0.059,808,1249,1,1,0.635,0.48,0.667,2057
tract,-0.059,10,16,1,1,0.406,0.422,0.339,26
moat,-0.059,21,33,1,1,0.398,0.38,0.314,54
casualty,-0.059,32,50,1,1,0.235,0.274,0.132,82
evasion,-0.059,21,33,1,1,0.229,0.51,0.418,54
birdman,-0.059,10,16,1,1,0.49,0.567,0.604,26
squeal,-0.059,43,67,1,1,0.25,0.731,0.375,110
yoke,-0.059,21,33,1,1,0.281,0.62,0.582,54
tumour,-0.059,21,33,1,1,0.092,0.627,0.464,54
enslavement,-0.059,10,16,1,1,0.086,0.635,0.302,26
truckload,-0.059,10,16,1,1,0.48,0.45,0.534,26
leakage,-0.059,10,16,1,1,0.188,0.731,0.528,26
mislead,-0.059,76,118,1,1,0.167,0.765,0.412,194
adjoining,-0.059,10,16,1,1,0.52,0.4,0.393,26
brownstone,-0.059,10,16,1,1,0.559,0.423,0.439,26
mouthwash,-0.059,10,16,1,1,0.438,0.385,0.352,26
roundup,-0.059,10,16,1,1,0.52,0.58,0.474,26
stockpile,-0.059,10,16,1,1,0.542,0.315,0.425,26
responsive,-0.059,43,67,1,1,0.816,0.569,0.573,110
contraction,-0.059,10,16,1,1,0.292,0.755,0.603,26
cogent,-0.059,10,16,1,1,0.765,0.479,0.836,26
enemy,-0.06,1695,2622,1,1,0.135,0.794,0.591,4317
disappointed,-0.06,2093,3238,1,1,0.071,0.472,0.241,5331
makeup,-0.06,902,1396,1,1,0.74,0.333,0.331,2298
visible,-0.06,476,737,1,1,0.75,0.342,0.509,1213
executive,-0.06,231,358,1,1,0.704,0.449,0.894,589
exposure,-0.06,251,389,1,1,0.57,0.83,0.63,640
civilian,-0.06,83,129,1,1,0.7,0.229,0.598,212
order,-0.061,5156,7981,1,1,0.78,0.295,0.814,13137
rearrange,-0.061,72,112,1,1,0.656,0.51,0.729,184
purposely,-0.061,364,564,1,1,0.646,0.706,0.703,928
average,-0.061,1061,1643,1,1,0.684,0.28,0.455,2704
relay,-0.061,103,160,1,1,0.738,0.542,0.543,263
indication,-0.061,134,208,1,1,0.719,0.432,0.75,342
freeway,-0.061,134,208,1,1,0.531,0.644,0.648,342
legit,-0.061,3073,4759,1,1,0.747,0.427,0.849,7832
condition,-0.061,1643,2545,1,1,0.5,0.469,0.519,4188
migration,-0.061,81,126,1,1,0.492,0.731,0.566,207
efficient,-0.061,132,205,1,1,0.959,0.604,0.83,337
troop,-0.061,50,78,1,1,0.375,0.696,0.75,128
complacency,-0.061,50,78,1,1,0.604,0.503,0.519,128
recycling,-0.061,101,157,1,1,0.552,0.32,0.509,258
juju,-0.061,70,109,1,1,0.541,0.519,0.206,179
champ,-0.061,212,329,1,1,0.854,0.754,0.896,541
oval,-0.062,210,326,1,1,0.417,0.28,0.33,536
mullet,-0.062,39,61,1,1,0.521,0.356,0.377,100
stopping,-0.062,879,1363,1,1,0.388,0.382,0.473,2242
fixed,-0.062,964,1495,1,1,0.684,0.167,0.509,2459
improved,-0.062,317,492,1,1,0.919,0.48,0.679,809
stark,-0.062,493,765,1,1,0.33,0.63,0.577,1258
party,-0.063,10670,16551,1,1,0.948,0.84,0.547,27221
resignation,-0.063,106,165,1,1,0.145,0.392,0.31,271
kayak,-0.063,57,89,1,1,0.592,0.6,0.364,146
insider,-0.063,57,89,1,1,0.625,0.562,0.75,146
eulogy,-0.063,28,44,1,1,0.625,0.443,0.667,72
wager,-0.063,57,89,1,1,0.479,0.816,0.615,146
times,-0.063,40489,62832,1,1,0.49,0.279,0.439,103321
degree,-0.063,1222,1897,1,1,0.724,0.365,0.663,3119
conscious,-0.063,769,1194,1,1,0.74,0.333,0.705,1963
observing,-0.064,218,339,1,1,0.583,0.4,0.685,557
fumble,-0.064,37,58,1,1,0.36,0.551,0.412,95
service,-0.064,3426,5320,1,1,0.684,0.408,0.535,8746
improvement,-0.064,290,451,1,1,0.786,0.5,0.611,741
informal,-0.064,55,86,1,1,0.48,0.398,0.441,141
second,-0.065,9325,14492,1,1,0.49,0.21,0.25,23817
mate,-0.065,4814,7482,1,1,0.847,0.417,0.669,12296
glow,-0.065,636,989,1,1,0.918,0.5,0.745,1625
mum,-0.065,3941,6126,1,1,0.802,0.317,0.698,10067
device,-0.065,284,442,1,1,0.562,0.404,0.627,726
ambassador,-0.065,136,212,1,1,0.651,0.529,0.917,348
tremendous,-0.065,291,453,1,1,0.6,0.888,0.773,744
swelling,-0.066,35,55,1,1,0.323,0.608,0.25,90
unkind,-0.066,98,153,1,1,0.135,0.409,0.31,251
layover,-0.066,26,41,1,1,0.52,0.355,0.5,67
hohoho,-0.066,26,41,1,1,0.677,0.433,0.33,67
yogurt,-0.066,98,153,1,1,0.66,0.269,0.24,251
overtaken,-0.066,35,55,1,1,0.594,0.552,0.702,90
unfavorable,-0.066,17,27,1,1,0.133,0.45,0.232,44
lacrosse,-0.066,17,27,1,1,0.573,0.656,0.509,44
omission,-0.066,17,27,1,1,0.367,0.333,0.275,44
canvass,-0.066,17,27,1,1,0.675,0.356,0.397,44
canal,-0.066,80,125,1,1,0.673,0.259,0.321,205
density,-0.066,44,69,1,1,0.602,0.471,0.561,113
pajamas,-0.066,152,237,1,1,0.719,0.17,0.264,389
like,-0.066,387280,602611,1,1,0.719,0.353,0.446,989891
run,-0.066,11239,17492,1,1,0.542,0.787,0.543,28731
wounds,-0.066,689,1073,1,1,0.102,0.735,0.345,1762
hygiene,-0.066,105,164,1,1,0.781,0.287,0.537,269
recognized,-0.066,421,656,1,1,0.875,0.458,0.786,1077
necessity,-0.066,324,505,1,1,0.567,0.471,0.588,829
protein,-0.066,78,122,1,1,0.75,0.337,0.654,200
scales,-0.067,69,108,1,1,0.439,0.33,0.491,177
printing,-0.067,60,94,1,1,0.646,0.654,0.615,154
african,-0.067,424,661,1,1,0.49,0.423,0.555,1085
conviction,-0.067,189,295,1,1,0.615,0.704,0.826,484
happiest,-0.067,1483,2311,1,1,0.99,0.716,0.746,3794
eviction,-0.067,42,66,1,1,0.185,0.731,0.455,108
running,-0.067,6017,9378,1,1,0.73,0.858,0.442,15395
badly,-0.068,2360,3680,1,1,0.073,0.509,0.286,6040
testament,-0.068,142,222,1,1,0.594,0.42,0.806,364
unconditional,-0.068,526,821,1,1,0.76,0.493,0.715,1347
incidence,-0.068,24,38,1,1,0.417,0.527,0.429,62
fencing,-0.068,24,38,1,1,0.542,0.654,0.539,62
pick,-0.068,6330,9876,1,1,0.5,0.464,0.525,16206
interview,-0.069,1343,2096,1,1,0.573,0.77,0.619,3439
heated,-0.069,172,269,1,1,0.479,0.497,0.542,441
poisoning,-0.069,147,230,1,1,0.094,0.837,0.526,377
trivial,-0.069,122,191,1,1,0.406,0.387,0.337,313
patriarchal,-0.069,72,113,1,1,0.531,0.5,0.857,185
devastated,-0.069,631,986,1,1,0.12,0.544,0.264,1617
whole,-0.07,26521,41438,1,1,0.653,0.357,0.572,67959
disown,-0.07,95,149,1,1,0.153,0.637,0.368,244
linen,-0.07,31,49,1,1,0.656,0.323,0.286,80
pastry,-0.07,31,49,1,1,0.87,0.407,0.419,80
bidder,-0.07,15,24,1,1,0.465,0.474,0.433,39
godson,-0.07,15,24,1,1,0.68,0.515,0.429,39
gleeful,-0.07,15,24,1,1,0.906,0.806,0.679,39
painless,-0.07,47,74,1,1,0.785,0.173,0.491,121
malign,-0.07,15,24,1,1,0.14,0.765,0.481,39
asterisk,-0.07,15,24,1,1,0.541,0.288,0.273,39
courses,-0.07,191,299,1,1,0.735,0.412,0.534,490
slant,-0.07,15,24,1,1,0.469,0.396,0.536,39
aunt,-0.07,1327,2074,1,1,0.667,0.291,0.42,3401
plane,-0.07,1021,1596,1,1,0.51,0.356,0.386,2617
do,-0.07,231971,362489,1,1,0.67,0.548,0.536,594460
spa,-0.07,150,235,1,1,0.622,0.151,0.386,385
nervousness,-0.071,70,110,1,1,0.163,0.915,0.241,180
compatibility,-0.071,54,85,1,1,0.816,0.45,0.673,139
flaw,-0.071,258,404,1,1,0.319,0.491,0.175,662
cherish,-0.071,1249,1954,1,1,0.896,0.491,0.652,3203
merciful,-0.071,77,121,1,1,0.854,0.346,0.5,198
disabled,-0.071,1153,1804,1,1,0.308,0.443,0.235,2957
diploma,-0.071,61,96,1,1,0.75,0.462,0.731,157
allot,-0.071,84,132,1,1,0.622,0.481,0.616,216
thriller,-0.072,252,395,1,1,0.49,0.796,0.645,647
legalized,-0.072,22,35,1,1,0.76,0.44,0.855,57
economical,-0.072,22,35,1,1,0.667,0.564,0.673,57
adaptable,-0.072,22,35,1,1,0.735,0.423,0.641,57
receptionist,-0.072,45,71,1,1,0.677,0.43,0.385,116
response,-0.072,2506,3924,1,1,0.615,0.5,0.472,6430
stern,-0.072,75,118,1,1,0.552,0.394,0.415,193
soothing,-0.072,529,829,1,1,0.625,0.179,0.519,1358
limitation,-0.073,29,46,1,1,0.19,0.431,0.225,75
mouthpiece,-0.073,29,46,1,1,0.573,0.346,0.393,75
representing,-0.073,216,339,1,1,0.796,0.464,0.833,555
wise,-0.073,1890,2962,1,1,0.878,0.25,0.861,4852
bulb,-0.073,66,104,1,1,0.562,0.208,0.3,170
spoken,-0.073,1270,1991,1,1,0.551,0.363,0.545,3261
archangel,-0.073,36,57,1,1,0.837,0.5,0.708,93
garbage,-0.073,1447,2269,1,1,0.188,0.51,0.192,3716
shady,-0.073,330,518,1,1,0.323,0.509,0.375,848
assignment,-0.074,256,402,1,1,0.483,0.398,0.745,658
possessing,-0.074,43,68,1,1,0.461,0.593,0.612,111
bolt,-0.074,87,137,1,1,0.354,0.363,0.426,224
tranquility,-0.074,182,286,1,1,0.84,0.135,0.442,468
naked,-0.074,3249,5096,1,1,0.323,0.885,0.288,8345
colossal,-0.074,50,79,1,1,0.698,0.692,0.9,129
referral,-0.074,50,79,1,1,0.694,0.314,0.603,129
debt,-0.074,978,1535,1,1,0.204,0.598,0.336,2513
requirement,-0.075,157,247,1,1,0.51,0.439,0.728,404
details,-0.075,961,1509,1,1,0.583,0.367,0.481,2470
tournament,-0.075,171,269,1,1,0.694,0.74,0.611,440
syrup,-0.075,92,145,1,1,0.62,0.223,0.318,237
husband,-0.075,7339,11524,1,1,0.771,0.5,0.655,18863
sexist,-0.075,390,613,1,1,0.255,0.798,0.411,1003
simply,-0.075,4884,7674,1,1,0.535,0.148,0.393,12558
moving,-0.076,6979,10967,1,1,0.479,0.673,0.358,17946
clairvoyant,-0.076,13,21,1,1,0.765,0.531,0.897,34
rupture,-0.076,13,21,1,1,0.125,0.633,0.43,34
debrief,-0.076,13,21,1,1,0.247,0.343,0.549,34
tarnish,-0.076,20,32,1,1,0.204,0.441,0.342,52
audacious,-0.076,13,21,1,1,0.74,0.875,0.825,34
entanglement,-0.076,13,21,1,1,0.302,0.765,0.248,34
battleground,-0.076,13,21,1,1,0.156,0.958,0.812,34
objectivity,-0.076,27,43,1,1,0.765,0.431,0.711,70
dodgy,-0.076,83,131,1,1,0.281,0.51,0.254,214
garrison,-0.076,27,43,1,1,0.51,0.527,0.679,70
reins,-0.076,20,32,1,1,0.48,0.448,0.545,52
anorexic,-0.076,34,54,1,1,0.16,0.618,0.245,88
jitters,-0.076,13,21,1,1,0.224,0.918,0.192,34
melee,-0.076,41,65,1,1,0.541,0.704,0.611,106
grace,-0.076,1726,2714,1,1,0.906,0.304,0.462,4440
disposable,-0.076,193,304,1,1,0.271,0.439,0.25,497
member,-0.077,3426,5389,1,1,0.698,0.333,0.555,8815
campaign,-0.077,1496,2354,1,1,0.602,0.73,0.823,3850
lab,-0.077,627,987,1,1,0.479,0.5,0.6,1614
leaning,-0.077,496,781,1,1,0.48,0.409,0.352,1277
receiving,-0.077,738,1162,1,1,0.719,0.562,0.623,1900
unreal,-0.077,405,638,1,1,0.173,0.431,0.296,1043
load,-0.077,851,1340,1,1,0.385,0.417,0.528,2191
minded,-0.077,1128,1776,1,1,0.656,0.394,0.627,2904
acknowledgment,-0.077,53,84,1,1,0.796,0.528,0.777,137
recognize,-0.078,1433,2257,1,1,0.76,0.315,0.6,3690
rifle,-0.078,86,136,1,1,0.329,0.9,0.718,222
scores,-0.078,159,251,1,1,0.594,0.469,0.629,410
sneaking,-0.078,192,303,1,1,0.203,0.755,0.545,495
unconscious,-0.078,152,240,1,1,0.24,0.356,0.195,392
bleed,-0.078,491,774,1,1,0.041,0.843,0.346,1265
clarify,-0.078,244,385,1,1,0.652,0.535,0.625,629
validate,-0.078,428,675,1,1,0.76,0.431,0.745,1103
slump,-0.079,143,226,1,1,0.194,0.438,0.13,369
deteriorate,-0.079,51,81,1,1,0.083,0.471,0.202,132
multiplied,-0.079,51,81,1,1,0.802,0.559,0.729,132
assertion,-0.079,51,81,1,1,0.74,0.442,0.75,132
confederate,-0.079,25,40,1,1,0.551,0.546,0.792,65
canteen,-0.079,51,81,1,1,0.688,0.6,0.514,132
praise,-0.079,992,1565,1,1,0.776,0.387,0.658,2557
vaccine,-0.08,44,70,1,1,0.5,0.52,0.555,114
motivating,-0.08,179,283,1,1,0.958,0.82,0.787,462
dun,-0.08,364,575,1,1,0.458,0.431,0.339,939
insane,-0.08,2398,3785,1,1,0.062,0.67,0.265,6183
crime,-0.08,1745,2755,1,1,0.071,0.943,0.63,4500
children,-0.08,9906,15637,1,1,0.857,0.538,0.435,25543
valley,-0.08,823,1300,1,1,0.729,0.306,0.386,2123
peaceful,-0.08,4737,7480,1,1,0.867,0.108,0.569,12217
recite,-0.08,94,149,1,1,0.688,0.398,0.453,243
conscientious,-0.08,18,29,1,1,0.688,0.404,0.688,47
directive,-0.08,18,29,1,1,0.604,0.53,0.918,47
hesitation,-0.08,189,299,1,1,0.286,0.396,0.217,488
windshield,-0.08,37,59,1,1,0.615,0.375,0.333,96
refine,-0.08,18,29,1,1,0.653,0.46,0.64,47
concert,-0.08,3873,6116,1,1,0.938,0.867,0.718,9989
content,-0.08,7344,11597,1,1,0.764,0.296,0.559,18941
smart,-0.081,2818,4451,1,1,0.906,0.607,0.923,7269
bracket,-0.081,87,138,1,1,0.49,0.35,0.682,225
admitting,-0.081,558,882,1,1,0.62,0.5,0.546,1440
urge,-0.081,1707,2697,1,1,0.418,0.68,0.653,4404
resolution,-0.081,375,593,1,1,0.78,0.55,0.745,968
crunch,-0.081,118,187,1,1,0.292,0.63,0.406,305
eek,-0.081,49,78,1,1,0.292,0.529,0.343,127
frantically,-0.081,80,127,1,1,0.375,0.898,0.735,207
officer,-0.081,447,707,1,1,0.542,0.43,0.877,1154
opposed,-0.081,390,617,1,1,0.092,0.46,0.606,1007
ritual,-0.082,185,293,1,1,0.375,0.52,0.508,478
basin,-0.082,30,48,1,1,0.552,0.231,0.398,78
carpet,-0.082,228,361,1,1,0.52,0.17,0.339,589
drugged,-0.082,104,165,1,1,0.102,0.75,0.321,269
pass,-0.082,5994,9478,1,1,0.51,0.324,0.362,15472
coding,-0.082,116,184,1,1,0.442,0.344,0.667,300
incarnate,-0.082,42,67,1,1,0.552,0.651,0.593,109
brainstorm,-0.082,42,67,1,1,0.794,0.784,0.636,109
push,-0.082,5391,8526,1,1,0.417,0.608,0.524,13917
parliamentary,-0.082,54,86,1,1,0.49,0.554,0.755,140
march,-0.082,1690,2674,1,1,0.531,0.2,0.483,4364
ago,-0.083,14282,22600,1,1,0.317,0.28,0.404,36882
absurd,-0.083,320,507,1,1,0.188,0.656,0.284,827
predatory,-0.083,126,200,1,1,0.083,0.865,0.731,326
remove,-0.083,1080,1710,1,1,0.292,0.539,0.472,2790
grounded,-0.083,313,496,1,1,0.531,0.601,0.509,809
lanky,-0.083,23,37,1,1,0.412,0.426,0.37,60
untidy,-0.083,11,18,1,1,0.106,0.61,0.254,29
fatality,-0.083,11,18,1,1,0.062,0.798,0.595,29
abruptly,-0.083,83,132,1,1,0.25,0.808,0.556,215
begrudge,-0.083,23,37,1,1,0.177,0.731,0.377,60
hindrance,-0.083,35,56,1,1,0.135,0.545,0.473,91
quart,-0.083,11,18,1,1,0.439,0.265,0.436,29
uncivilized,-0.083,11,18,1,1,0.133,0.6,0.4,29
handcuff,-0.083,11,18,1,1,0.31,0.59,0.593,29
suggestive,-0.083,35,56,1,1,0.552,0.5,0.555,91
discredit,-0.083,83,132,1,1,0.075,0.529,0.355,215
dissident,-0.083,11,18,1,1,0.35,0.582,0.413,29
memorials,-0.083,11,18,1,1,0.771,0.333,0.679,29
symmetrical,-0.083,11,18,1,1,0.542,0.263,0.569,29
sabotage,-0.083,215,341,1,1,0.135,0.906,0.5,556
putrid,-0.083,47,75,1,1,0.146,0.62,0.385,122
outright,-0.083,167,265,1,1,0.767,0.396,0.755,432
subvert,-0.083,23,37,1,1,0.357,0.557,0.536,60
circumcision,-0.083,11,18,1,1,0.327,0.657,0.528,29
valuation,-0.083,11,18,1,1,0.615,0.48,0.795,29
definite,-0.084,124,197,1,1,0.708,0.292,0.741,321
thrown,-0.084,976,1547,1,1,0.5,0.55,0.619,2523
infrastructure,-0.084,141,224,1,1,0.604,0.46,0.694,365
alienate,-0.084,141,224,1,1,0.247,0.5,0.523,365
narcissist,-0.084,442,701,1,1,0.173,0.614,0.629,1143
exposed,-0.084,743,1178,1,1,0.471,0.661,0.509,1921
food,-0.084,10248,16241,1,1,0.888,0.324,0.527,26489
lea,-0.084,105,167,1,1,0.583,0.294,0.358,272
piece,-0.084,7535,11944,1,1,0.646,0.245,0.367,19479
hash,-0.084,93,148,1,1,0.344,0.453,0.355,241
secretive,-0.084,93,148,1,1,0.39,0.25,0.538,241
holder,-0.084,134,213,1,1,0.592,0.33,0.713,347
budge,-0.084,40,64,1,1,0.719,0.755,0.543,104
pedestrian,-0.084,40,64,1,1,0.438,0.36,0.448,104
tethered,-0.084,40,64,1,1,0.26,0.472,0.351,104
sacred,-0.085,441,700,1,1,0.833,0.375,0.862,1141
muffled,-0.085,57,91,1,1,0.479,0.33,0.421,148
vaginal,-0.085,28,45,1,1,0.449,0.765,0.42,73
minimal,-0.085,219,348,1,1,0.448,0.147,0.206,567
disrespectful,-0.085,536,851,1,1,0.031,0.694,0.273,1387
opportunity,-0.085,2550,4047,1,1,0.938,0.745,0.833,6597
serenity,-0.085,304,483,1,1,0.9,0.122,0.557,787
halftime,-0.085,45,72,1,1,0.458,0.352,0.429,117
immoral,-0.085,137,218,1,1,0.143,0.622,0.385,355
audible,-0.085,91,145,1,1,0.673,0.37,0.462,236
conclude,-0.086,154,245,1,1,0.53,0.267,0.679,399
percent,-0.086,537,853,1,1,0.47,0.35,0.356,1390
sunk,-0.086,113,180,1,1,0.146,0.531,0.185,293
boarding,-0.086,244,388,1,1,0.531,0.402,0.534,632
workplace,-0.086,419,666,1,1,0.592,0.431,0.583,1085
spectacles,-0.086,16,26,1,1,0.816,0.775,0.648,42
freshener,-0.086,16,26,1,1,0.704,0.38,0.473,42
blown,-0.086,662,1052,1,1,0.333,0.548,0.412,1714
accordance,-0.086,16,26,1,1,0.659,0.349,0.6,42
reappear,-0.086,33,53,1,1,0.688,0.625,0.632,86
computing,-0.086,16,26,1,1,0.745,0.398,0.695,42
serum,-0.086,16,26,1,1,0.52,0.231,0.443,42
overdrive,-0.086,67,107,1,1,0.303,0.715,0.732,174
blurt,-0.086,33,53,1,1,0.408,0.439,0.441,86
bordering,-0.086,33,53,1,1,0.643,0.382,0.438,86
baking,-0.087,274,436,1,1,0.549,0.455,0.451,710
aftermath,-0.087,184,293,1,1,0.312,0.449,0.444,477
mayor,-0.087,262,417,1,1,0.469,0.481,0.818,679
continuously,-0.087,413,657,1,1,0.719,0.417,0.702,1070
bone,-0.087,1255,1996,1,1,0.337,0.37,0.413,3251
prominent,-0.088,143,228,1,1,0.676,0.627,0.779,371
caffeine,-0.088,165,263,1,1,0.562,0.759,0.5,428
strive,-0.088,519,826,1,1,0.582,0.837,0.769,1345
psychotherapy,-0.088,21,34,1,1,0.396,0.547,0.651,55
closed,-0.088,2346,3733,1,1,0.24,0.164,0.318,6079
applicable,-0.088,70,112,1,1,0.469,0.43,0.667,182
advisor,-0.089,124,198,1,1,0.646,0.35,0.689,322
touched,-0.089,1519,2419,1,1,0.592,0.38,0.404,3938
shameful,-0.089,406,647,1,1,0.04,0.68,0.264,1053
thwart,-0.089,26,42,1,1,0.281,0.684,0.409,68
pundit,-0.089,26,42,1,1,0.644,0.582,0.833,68
supplier,-0.089,26,42,1,1,0.615,0.462,0.736,68
involve,-0.089,404,644,1,1,0.694,0.49,0.728,1048
successor,-0.089,26,42,1,1,0.729,0.531,0.648,68
see,-0.089,92576,147484,1,1,0.635,0.269,0.312,240060
validity,-0.089,58,93,1,1,0.646,0.47,0.706,151
allow,-0.089,4786,7626,1,1,0.698,0.429,0.538,12412
destroyed,-0.089,1076,1715,1,1,0.031,0.696,0.288,2791
items,-0.09,433,691,1,1,0.542,0.401,0.434,1124
unnoticed,-0.09,253,404,1,1,0.302,0.44,0.26,657
calculator,-0.09,36,58,1,1,0.513,0.283,0.588,94
inaccurate,-0.09,73,117,1,1,0.135,0.45,0.25,190
fruition,-0.09,36,58,1,1,0.776,0.567,0.664,94
wobble,-0.09,36,58,1,1,0.375,0.62,0.35,94
church,-0.09,3429,5469,1,1,0.708,0.198,0.61,8898
bath,-0.091,1093,1744,1,1,0.725,0.26,0.263,2837
leader,-0.091,1971,3145,1,1,0.833,0.582,0.926,5116
proportion,-0.091,88,141,1,1,0.541,0.462,0.518,229
ergo,-0.091,46,74,1,1,0.385,0.4,0.385,120
techno,-0.091,46,74,1,1,0.561,0.539,0.5,120
tribal,-0.091,93,149,1,1,0.417,0.404,0.482,242
conversion,-0.091,98,157,1,1,0.48,0.605,0.736,255
benevolent,-0.091,51,82,1,1,0.786,0.407,0.651,133
censor,-0.091,51,82,1,1,0.344,0.276,0.538,133
swarm,-0.091,56,90,1,1,0.302,0.735,0.458,146
efficiency,-0.091,56,90,1,1,0.802,0.509,0.892,146
particular,-0.092,1682,2686,1,1,0.562,0.402,0.552,4368
say,-0.092,72597,115920,1,1,0.571,0.31,0.482,188517
relaxation,-0.092,133,213,1,1,0.873,0.161,0.381,346
shorts,-0.092,317,507,1,1,0.622,0.481,0.287,824
wait,-0.092,23211,37086,1,1,0.224,0.167,0.264,60297
offered,-0.092,1006,1608,1,1,0.582,0.49,0.544,2614
mourning,-0.093,427,683,1,1,0.177,0.49,0.266,1110
wrestling,-0.093,385,616,1,1,0.449,0.868,0.774,1001
resist,-0.093,719,1150,1,1,0.414,0.676,0.651,1869
rogue,-0.093,166,266,1,1,0.334,0.713,0.636,432
anti,-0.093,1112,1779,1,1,0.365,0.412,0.384,2891
pray,-0.093,8498,13594,1,1,0.714,0.127,0.627,22092
uncut,-0.094,14,23,1,1,0.448,0.422,0.278,37
queues,-0.094,39,63,1,1,0.385,0.479,0.269,102
sharpened,-0.094,19,31,1,1,0.573,0.647,0.727,50
shoveling,-0.094,34,55,1,1,0.265,0.62,0.537,89
minimized,-0.094,14,23,1,1,0.458,0.137,0.208,37
plagiarism,-0.094,14,23,1,1,0.135,0.716,0.436,37
brewing,-0.094,74,119,1,1,0.74,0.593,0.609,193
misled,-0.094,74,119,1,1,0.177,0.606,0.353,193
spasm,-0.094,14,23,1,1,0.194,0.594,0.366,37
feared,-0.094,429,687,1,1,0.24,0.733,0.509,1116
decaf,-0.094,14,23,1,1,0.48,0.324,0.353,37
leery,-0.094,14,23,1,1,0.337,0.64,0.41,37
allocate,-0.094,14,23,1,1,0.673,0.462,0.672,37
upkeep,-0.094,19,31,1,1,0.59,0.442,0.685,50
misbehave,-0.094,24,39,1,1,0.02,0.847,0.304,63
impromptu,-0.094,49,79,1,1,0.541,0.729,0.415,128
parental,-0.094,189,303,1,1,0.76,0.43,0.627,492
comprehensive,-0.094,59,95,1,1,0.796,0.385,0.644,154
hunch,-0.094,49,79,1,1,0.561,0.63,0.567,128
debauchery,-0.094,24,39,1,1,0.354,0.901,0.5,63
offended,-0.094,735,1177,1,1,0.188,0.69,0.337,1912
treasure,-0.094,981,1571,1,1,0.927,0.592,0.821,2552
exit,-0.094,425,681,1,1,0.37,0.353,0.399,1106
constantly,-0.094,8432,13502,1,1,0.663,0.561,0.7,21934
embarrassment,-0.095,496,795,1,1,0.143,0.685,0.226,1291
explanation,-0.095,619,992,1,1,0.615,0.61,0.825,1611
riot,-0.095,185,297,1,1,0.061,0.946,0.586,482
choose,-0.095,9071,14539,1,1,0.615,0.542,0.648,23610
chance,-0.096,7501,12025,1,1,0.833,0.551,0.525,19526
literally,-0.096,27225,43654,1,1,0.571,0.353,0.673,70879
gear,-0.096,297,477,1,1,0.51,0.577,0.509,774
inquiry,-0.096,95,153,1,1,0.541,0.42,0.536,248
bail,-0.096,191,307,1,1,0.373,0.52,0.561,498
choke,-0.096,421,676,1,1,0.167,0.788,0.676,1097
hurtful,-0.096,464,745,1,1,0.104,0.68,0.463,1209
clowns,-0.096,368,591,1,1,0.6,0.673,0.391,959
levy,-0.097,42,68,1,1,0.438,0.42,0.491,110
goals,-0.097,2282,3663,1,1,0.719,0.49,0.795,5945
expecting,-0.097,1318,2116,1,1,0.561,0.45,0.302,3434
betrayed,-0.097,1113,1788,1,1,0.122,0.769,0.308,2901
caring,-0.097,3453,5546,1,1,0.635,0.469,0.5,8999
giggling,-0.098,154,248,1,1,0.886,0.726,0.391,402
forgiving,-0.098,228,367,1,1,0.885,0.317,0.556,595
jubilee,-0.098,27,44,1,1,0.916,0.5,0.579,71
adequate,-0.098,111,179,1,1,0.854,0.264,0.705,290
revolting,-0.098,55,89,1,1,0.102,0.69,0.3,144
recycle,-0.098,55,89,1,1,0.521,0.392,0.526,144
ohno,-0.098,27,44,1,1,0.396,0.475,0.38,71
vector,-0.098,27,44,1,1,0.538,0.308,0.482,71
calorie,-0.098,27,44,1,1,0.333,0.54,0.427,71
dial,-0.098,241,388,1,1,0.62,0.427,0.596,629
stuff,-0.098,14554,23399,1,1,0.622,0.367,0.263,37953
overprotective,-0.099,50,81,1,1,0.448,0.673,0.741,131
huge,-0.099,6412,10311,1,1,0.573,0.625,0.783,16723
intentional,-0.099,188,303,1,1,0.65,0.615,0.75,491
nuclear,-0.099,280,451,1,1,0.219,0.856,0.781,731
ration,-0.099,22,36,1,1,0.521,0.346,0.39,58
peanut,-0.099,380,612,1,1,0.646,0.202,0.246,992
transit,-0.099,155,250,1,1,0.439,0.59,0.588,405
stadium,-0.099,370,596,1,1,0.635,0.679,0.611,966
summertime,-0.1,191,308,1,1,0.837,0.5,0.455,499
wiggle,-0.1,40,65,1,1,0.531,0.676,0.359,105
grieving,-0.1,804,1295,1,1,0.093,0.673,0.403,2099
vandalism,-0.101,17,28,1,1,0.083,0.904,0.509,45
ripe,-0.101,107,173,1,1,0.671,0.337,0.67,280
asserting,-0.101,17,28,1,1,0.694,0.531,0.736,45
ballpark,-0.101,17,28,1,1,0.724,0.694,0.529,45
minty,-0.101,17,28,1,1,0.635,0.292,0.361,45
decidedly,-0.101,35,57,1,1,0.75,0.48,0.843,92
periodically,-0.101,89,144,1,1,0.48,0.314,0.515,233
anesthetic,-0.101,17,28,1,1,0.35,0.264,0.482,45
bonnet,-0.101,17,28,1,1,0.406,0.509,0.473,45
magenta,-0.101,17,28,1,1,0.635,0.275,0.415,45
instance,-0.101,318,513,1,1,0.547,0.45,0.558,831
premier,-0.101,120,194,1,1,0.755,0.519,0.792,314
jaw,-0.101,205,331,1,1,0.5,0.51,0.42,536
objective,-0.101,205,331,1,1,0.724,0.337,0.736,536
fetus,-0.101,79,128,1,1,0.479,0.519,0.395,207
deceit,-0.102,110,178,1,1,0.02,0.696,0.343,288
assumed,-0.102,464,749,1,1,0.612,0.247,0.454,1213
monetary,-0.102,61,99,1,1,0.583,0.494,0.716,160
humidity,-0.102,30,49,1,1,0.464,0.373,0.367,79
nice,-0.102,27342,44102,1,1,0.93,0.442,0.65,71444
genocide,-0.102,149,241,1,1,0.02,0.878,0.627,390
fascination,-0.102,74,120,1,1,0.885,0.773,0.835,194
save,-0.102,9970,16087,1,1,0.77,0.439,0.682,26057
compassionate,-0.102,470,759,1,1,0.857,0.404,0.411,1229
benign,-0.102,43,70,1,1,0.694,0.44,0.509,113
nickel,-0.102,56,91,1,1,0.51,0.347,0.406,147
silently,-0.103,870,1405,1,1,0.448,0.185,0.306,2275
bill,-0.103,1905,3076,1,1,0.396,0.402,0.535,4981
purchasing,-0.103,82,133,1,1,0.667,0.653,0.661,215
diaper,-0.103,108,175,1,1,0.409,0.274,0.155,283
physics,-0.103,186,301,1,1,0.582,0.415,0.664,487
guide,-0.103,2101,3394,1,1,0.688,0.315,0.62,5495
residences,-0.103,12,20,1,1,0.618,0.418,0.509,32
zoom,-0.103,103,167,1,1,0.49,0.52,0.462,270
demolish,-0.103,25,41,1,1,0.125,0.632,0.7,66
zeal,-0.103,25,41,1,1,0.367,0.741,0.616,66
skillful,-0.103,12,20,1,1,0.802,0.616,0.908,32
forego,-0.103,12,20,1,1,0.396,0.661,0.291,32
unexplored,-0.103,12,20,1,1,0.401,0.64,0.388,32
hearse,-0.103,12,20,1,1,0.177,0.49,0.324,32
eugenics,-0.103,12,20,1,1,0.448,0.53,0.518,32
spoiler,-0.103,332,537,1,1,0.347,0.527,0.38,869
liberating,-0.104,426,689,1,1,0.915,0.62,0.745,1115
rash,-0.104,98,159,1,1,0.219,0.82,0.491,257
coconut,-0.104,98,159,1,1,0.622,0.265,0.227,257
fluent,-0.104,72,117,1,1,0.76,0.5,0.614,189
unattended,-0.104,72,117,1,1,0.255,0.4,0.167,189
horoscope,-0.104,145,235,1,1,0.5,0.36,0.49,380
repent,-0.104,132,214,1,1,0.449,0.422,0.386,346
directly,-0.104,1058,1711,1,1,0.747,0.4,0.702,2769
worried,-0.104,5482,8863,1,1,0.094,0.824,0.395,14345
regain,-0.104,200,324,1,1,0.729,0.52,0.759,524
hushed,-0.104,46,75,1,1,0.292,0.194,0.272,121
gain,-0.104,1767,2858,1,1,0.917,0.64,0.822,4625
let,-0.104,79908,129234,1,1,0.427,0.373,0.307,209142
observe,-0.105,318,515,1,1,0.771,0.39,0.36,833
monthly,-0.105,386,625,1,1,0.622,0.314,0.364,1011
probable,-0.105,67,109,1,1,0.583,0.433,0.481,176
justifiable,-0.105,33,54,1,1,0.786,0.413,0.821,87
extend,-0.105,324,525,1,1,0.646,0.57,0.689,849
rally,-0.105,442,716,1,1,0.612,0.68,0.554,1158
hire,-0.105,550,891,1,1,0.688,0.558,0.556,1441
sake,-0.105,1928,3122,1,1,0.49,0.573,0.407,5050
driveway,-0.106,146,237,1,1,0.612,0.392,0.689,383
interpreter,-0.106,20,33,1,1,0.708,0.461,0.596,53
fowl,-0.106,20,33,1,1,0.51,0.388,0.364,53
verdict,-0.106,62,101,1,1,0.325,0.689,0.8,163
communist,-0.106,196,318,1,1,0.265,0.702,0.632,514
butter,-0.106,509,825,1,1,0.65,0.292,0.202,1334
unseen,-0.106,304,493,1,1,0.427,0.351,0.421,797
afar,-0.106,320,519,1,1,0.396,0.373,0.358,839
birth,-0.106,1450,2350,1,1,0.896,0.655,0.536,3800
baggy,-0.107,28,46,1,1,0.521,0.278,0.452,74
tone,-0.107,1017,1649,1,1,0.551,0.355,0.411,2666
shortage,-0.107,94,153,1,1,0.094,0.455,0.198,247
owe,-0.107,1163,1886,1,1,0.5,0.429,0.386,3049
dispute,-0.107,65,106,1,1,0.219,0.75,0.585,171
breath,-0.107,3574,5796,1,1,0.684,0.392,0.451,9370
tingling,-0.107,36,59,1,1,0.427,0.615,0.34,95
runaway,-0.107,295,479,1,1,0.271,0.77,0.402,774
screening,-0.107,192,312,1,1,0.562,0.57,0.709,504
articulate,-0.107,237,385,1,1,0.677,0.462,0.618,622
sliver,-0.107,81,132,1,1,0.388,0.347,0.291,213
bro,-0.107,11960,19401,1,1,0.794,0.349,0.684,31361
horseshit,-0.107,44,72,1,1,0.153,0.582,0.179,116
disagree,-0.108,1205,1956,1,1,0.133,0.59,0.345,3161
principles,-0.108,288,468,1,1,0.698,0.286,0.84,756
uncle,-0.108,1476,2396,1,1,0.653,0.255,0.578,3872
attend,-0.108,1031,1674,1,1,0.65,0.42,0.625,2705
misunderstand,-0.108,129,210,1,1,0.177,0.548,0.382,339
niece,-0.108,527,856,1,1,0.771,0.32,0.4,1383
fine,-0.108,20566,33382,1,1,0.823,0.24,0.647,53948
crowds,-0.108,867,1408,1,1,0.469,0.723,0.806,2275
balanced,-0.108,230,374,1,1,0.806,0.255,0.745,604
gather,-0.108,719,1168,1,1,0.648,0.51,0.546,1887
disrespect,-0.108,634,1030,1,1,0.062,0.637,0.302,1664
dizzy,-0.108,193,314,1,1,0.199,0.582,0.193,507
hallway,-0.109,342,556,1,1,0.573,0.23,0.279,898
housing,-0.109,617,1003,1,1,0.776,0.304,0.591,1620
shitload,-0.109,31,51,1,1,0.02,0.606,0.161,82
conquering,-0.109,79,129,1,1,0.76,0.873,0.936,208
crud,-0.109,23,38,1,1,0.312,0.33,0.444,61
jumble,-0.109,15,25,1,1,0.357,0.613,0.331,40
genital,-0.109,23,38,1,1,0.385,0.694,0.453,61
intestines,-0.109,23,38,1,1,0.292,0.547,0.398,61
vapor,-0.109,23,38,1,1,0.51,0.358,0.318,61
spectrum,-0.109,383,623,1,1,0.312,0.7,0.527,1006
slaughtering,-0.109,15,25,1,1,0.133,0.947,0.714,40
abstain,-0.109,39,64,1,1,0.385,0.385,0.427,103
obligation,-0.109,207,337,1,1,0.222,0.596,0.718,544
theatrics,-0.109,15,25,1,1,0.694,0.539,0.486,40
act,-0.11,7420,12063,1,1,0.656,0.704,0.735,19483
morbid,-0.11,122,199,1,1,0.09,0.833,0.395,321
chant,-0.11,114,186,1,1,0.771,0.698,0.65,300
betray,-0.11,331,539,1,1,0.042,0.87,0.536,870
provided,-0.11,503,819,1,1,0.871,0.353,0.648,1322
basis,-0.111,1311,2134,1,1,0.602,0.26,0.426,3445
liver,-0.111,160,261,1,1,0.439,0.29,0.385,421
godsend,-0.111,50,82,1,1,0.865,0.562,0.613,132
politics,-0.111,1881,3062,1,1,0.25,0.528,0.855,4943
included,-0.111,1331,2167,1,1,0.76,0.402,0.57,3498
silence,-0.111,8026,13067,1,1,0.438,0.2,0.223,21093
foot,-0.111,1180,1922,1,1,0.49,0.29,0.254,3102
lackluster,-0.111,34,56,1,1,0.25,0.311,0.264,90
indebted,-0.111,34,56,1,1,0.138,0.698,0.275,90
buckle,-0.111,104,170,1,1,0.416,0.373,0.361,274
viva,-0.111,69,113,1,1,0.84,0.567,0.644,182
shame,-0.111,4750,7737,1,1,0.06,0.67,0.155,12487
impose,-0.112,96,157,1,1,0.503,0.721,0.745,253
brush,-0.112,449,732,1,1,0.49,0.265,0.186,1181
dreaded,-0.112,123,201,1,1,0.122,0.706,0.46,324
finding,-0.112,6729,10963,1,1,0.796,0.469,0.664,17692
fathom,-0.112,293,478,1,1,0.52,0.41,0.523,771
sobriety,-0.112,204,333,1,1,0.68,0.31,0.583,537
varsity,-0.112,53,87,1,1,0.71,0.594,0.67,140
cyclical,-0.112,26,43,1,1,0.38,0.45,0.554,69
henceforth,-0.112,26,43,1,1,0.527,0.404,0.466,69
devalued,-0.112,26,43,1,1,0.321,0.462,0.212,69
compliant,-0.112,26,43,1,1,0.677,0.31,0.519,69
registry,-0.112,26,43,1,1,0.573,0.32,0.583,69
charade,-0.112,53,87,1,1,0.458,0.55,0.346,140
behavioral,-0.112,72,118,1,1,0.612,0.44,0.708,190
ether,-0.112,118,193,1,1,0.49,0.306,0.412,311
unnecessary,-0.113,703,1147,1,1,0.219,0.358,0.19,1850
noted,-0.113,232,379,1,1,0.615,0.382,0.464,611
headaches,-0.113,246,402,1,1,0.104,0.72,0.259,648
clarinet,-0.113,18,30,1,1,0.592,0.453,0.411,48
circumstantial,-0.113,18,30,1,1,0.5,0.538,0.519,48
auditorium,-0.113,37,61,1,1,0.529,0.49,0.538,98
construction,-0.113,189,309,1,1,0.848,0.612,0.759,498
example,-0.113,2291,3739,1,1,0.542,0.337,0.51,6030
perspective,-0.113,1680,2742,1,1,0.688,0.47,0.704,4422
diminish,-0.114,116,190,1,1,0.24,0.357,0.167,306
skewed,-0.114,48,79,1,1,0.34,0.48,0.361,127
facility,-0.114,206,337,1,1,0.625,0.5,0.654,543
differences,-0.114,446,729,1,1,0.365,0.582,0.342,1175
wrongdoing,-0.114,29,48,1,1,0.112,0.745,0.451,77
chopper,-0.114,29,48,1,1,0.594,0.56,0.509,77
deposit,-0.114,119,195,1,1,0.54,0.379,0.483,314
irritation,-0.114,59,97,1,1,0.073,0.833,0.496,156
home,-0.115,72535,118506,1,1,0.854,0.27,0.545,191041
iffy,-0.115,70,115,1,1,0.38,0.442,0.333,185
calculated,-0.115,70,115,1,1,0.633,0.425,0.683,185
discomfort,-0.115,278,455,1,1,0.153,0.719,0.272,733
baggage,-0.115,300,491,1,1,0.61,0.363,0.427,791
newborn,-0.115,177,290,1,1,0.918,0.58,0.372,467
ecosystem,-0.115,62,102,1,1,0.729,0.259,0.633,164
answering,-0.115,843,1379,1,1,0.684,0.5,0.607,2222
offensive,-0.116,361,591,1,1,0.135,0.882,0.6,952
fibrosis,-0.116,10,17,1,1,0.16,0.469,0.546,27
breadth,-0.116,32,53,1,1,0.667,0.49,0.644,85
subdivision,-0.116,10,17,1,1,0.592,0.455,0.43,27
profanity,-0.116,32,53,1,1,0.115,0.79,0.491,85
fated,-0.116,131,215,1,1,0.582,0.472,0.692,346
prohibited,-0.116,32,53,1,1,0.115,0.77,0.482,85
rubbish,-0.116,417,683,1,1,0.198,0.454,0.164,1100
shelling,-0.116,10,17,1,1,0.337,0.917,0.773,27
spandex,-0.116,10,17,1,1,0.429,0.52,0.429,27
hatchet,-0.116,21,35,1,1,0.333,0.608,0.5,56
diagonal,-0.116,10,17,1,1,0.5,0.343,0.41,27
preventive,-0.116,10,17,1,1,0.643,0.388,0.657,27
teacher,-0.116,1921,3145,1,1,0.76,0.404,0.885,5066
feather,-0.116,167,274,1,1,0.677,0.208,0.144,441
forgiveness,-0.117,587,962,1,1,0.667,0.43,0.471,1549
pagan,-0.117,57,94,1,1,0.292,0.578,0.542,151
parenting,-0.117,452,741,1,1,0.812,0.52,0.676,1193
beaten,-0.117,441,723,1,1,0.083,0.846,0.265,1164
idea,-0.117,12226,20029,1,1,0.75,0.538,0.704,32255
touching,-0.118,1070,1754,1,1,0.76,0.439,0.491,2824
realize,-0.118,20123,32976,1,1,0.757,0.462,0.647,53099
protective,-0.118,309,507,1,1,0.844,0.459,0.86,816
declare,-0.118,210,345,1,1,0.677,0.623,0.668,555
flog,-0.118,24,40,1,1,0.408,0.52,0.382,64
stub,-0.118,24,40,1,1,0.396,0.32,0.367,64
karmic,-0.118,24,40,1,1,0.357,0.459,0.464,64
sorting,-0.119,113,186,1,1,0.469,0.4,0.642,299
check,-0.119,8624,14149,1,1,0.523,0.552,0.602,22773
radical,-0.119,372,611,1,1,0.5,0.792,0.811,983
bonkers,-0.119,116,191,1,1,0.306,0.847,0.278,307
preparing,-0.119,618,1015,1,1,0.735,0.538,0.585,1633
crunchy,-0.119,52,86,1,1,0.625,0.56,0.539,138
alas,-0.12,524,861,1,1,0.571,0.31,0.279,1385
guard,-0.12,915,1503,1,1,0.592,0.51,0.725,2418
preach,-0.12,460,756,1,1,0.602,0.48,0.702,1216
presence,-0.12,4327,7106,1,1,0.874,0.431,0.607,11433
necessary,-0.12,2066,3394,1,1,0.75,0.433,0.679,5460
operation,-0.12,192,316,1,1,0.475,0.611,0.755,508
listen,-0.12,23346,38354,1,1,0.771,0.36,0.445,61700
fess,-0.12,27,45,1,1,0.395,0.42,0.37,72
spinach,-0.12,41,68,1,1,0.583,0.2,0.368,109
dialogue,-0.12,419,689,1,1,0.599,0.441,0.625,1108
gob,-0.12,27,45,1,1,0.28,0.357,0.447,72
untrained,-0.12,13,22,1,1,0.149,0.529,0.282,35
jaguar,-0.12,27,45,1,1,0.559,0.71,0.654,72
valet,-0.12,13,22,1,1,0.635,0.406,0.389,35
vested,-0.12,27,45,1,1,0.663,0.415,0.648,72
intuitively,-0.12,13,22,1,1,0.67,0.561,0.648,35
gazebo,-0.12,13,22,1,1,0.469,0.402,0.341,35
sustain,-0.12,251,413,1,1,0.635,0.358,0.593,664
auditory,-0.12,27,45,1,1,0.531,0.481,0.57,72
platform,-0.12,1357,2230,1,1,0.602,0.34,0.718,3587
animosity,-0.12,41,68,1,1,0.51,0.724,0.545,109
wireless,-0.12,55,91,1,1,0.635,0.444,0.537,146
jeopardy,-0.12,83,137,1,1,0.129,0.908,0.536,220
question,-0.12,6504,10689,1,1,0.51,0.41,0.509,17193
believable,-0.121,86,142,1,1,0.866,0.39,0.676,228
classified,-0.121,72,119,1,1,0.571,0.46,0.663,191
faithfulness,-0.121,58,96,1,1,0.833,0.426,0.602,154
awful,-0.121,4574,7521,1,1,0.061,0.786,0.45,12095
loosen,-0.121,44,73,1,1,0.487,0.337,0.218,117
confidence,-0.121,2250,3701,1,1,0.959,0.276,0.943,5951
serial,-0.121,509,838,1,1,0.469,0.35,0.472,1347
cooperative,-0.122,30,50,1,1,0.816,0.461,0.67,80
bawl,-0.122,92,152,1,1,0.385,0.88,0.561,244
gas,-0.122,1000,1646,1,1,0.396,0.408,0.519,2646
compose,-0.122,78,129,1,1,0.639,0.432,0.694,207
paralyzed,-0.122,157,259,1,1,0.194,0.48,0.198,416
rattled,-0.122,47,78,1,1,0.354,0.641,0.33,125
thrilled,-0.122,304,501,1,1,0.898,0.818,0.807,805
tripping,-0.122,417,687,1,1,0.276,0.594,0.293,1104
continent,-0.122,166,274,1,1,0.551,0.373,0.833,440
funds,-0.123,319,526,1,1,0.633,0.33,0.461,845
jihad,-0.123,33,55,1,1,0.323,0.66,0.444,88
infallible,-0.123,16,27,1,1,0.776,0.687,0.809,43
wheeze,-0.123,33,55,1,1,0.229,0.462,0.461,88
wince,-0.123,16,27,1,1,0.286,0.415,0.294,43
ait,-0.123,16,27,1,1,0.385,0.39,0.402,43
whet,-0.123,16,27,1,1,0.643,0.465,0.43,43
rainbow,-0.123,810,1335,1,1,0.878,0.35,0.462,2145
failing,-0.123,1092,1800,1,1,0.125,0.49,0.268,2892
martial,-0.123,90,149,1,1,0.48,0.71,0.737,239
head,-0.124,21612,35629,1,1,0.53,0.472,0.558,57241
cord,-0.124,167,276,1,1,0.388,0.378,0.358,443
possession,-0.124,133,220,1,1,0.677,0.676,0.848,353
humanity,-0.124,1704,2811,1,1,0.75,0.36,0.727,4515
resent,-0.124,193,319,1,1,0.073,0.553,0.163,512
assumption,-0.124,253,418,1,1,0.479,0.431,0.417,671
employment,-0.124,199,329,1,1,0.75,0.594,0.611,528
bowels,-0.124,19,32,1,1,0.194,0.448,0.362,51
saffron,-0.124,19,32,1,1,0.443,0.373,0.349,51
baton,-0.124,39,65,1,1,0.272,0.235,0.519,104
urn,-0.124,19,32,1,1,0.194,0.52,0.295,51
diffuse,-0.124,19,32,1,1,0.43,0.431,0.321,51
dishonor,-0.124,19,32,1,1,0.104,0.62,0.185,51
expected,-0.125,1751,2890,1,1,0.729,0.412,0.545,4641
parking,-0.125,840,1387,1,1,0.777,0.469,0.51,2227
lots,-0.125,7901,13041,1,1,0.604,0.417,0.424,20942
brighter,-0.125,778,1285,1,1,0.918,0.698,0.833,2063
truth,-0.125,10438,17233,1,1,0.971,0.4,0.685,27671
select,-0.125,217,359,1,1,0.615,0.406,0.602,576
precious,-0.125,2799,4623,1,1,0.917,0.5,0.726,7422
unfamiliar,-0.126,298,493,1,1,0.219,0.558,0.273,791
widen,-0.126,45,75,1,1,0.562,0.538,0.527,120
savor,-0.126,68,113,1,1,0.827,0.552,0.526,181
moment,-0.126,17130,28303,1,1,0.604,0.435,0.509,45433
environment,-0.126,1602,2648,1,1,0.646,0.194,0.528,4250
factual,-0.126,97,161,1,1,0.656,0.44,0.545,258
cottage,-0.126,195,323,1,1,0.6,0.279,0.361,518
brains,-0.126,645,1067,1,1,0.663,0.557,0.722,1712
snore,-0.126,74,123,1,1,0.245,0.61,0.481,197
have,-0.127,393365,650423,1,1,0.757,0.389,0.593,1043788
dogma,-0.127,51,85,1,1,0.53,0.46,0.719,136
pushover,-0.127,25,42,1,1,0.347,0.558,0.375,67
courier,-0.127,25,42,1,1,0.551,0.383,0.441,67
yank,-0.127,25,42,1,1,0.271,0.63,0.538,67
turmoil,-0.127,207,343,1,1,0.198,0.888,0.417,550
volumes,-0.127,210,348,1,1,0.552,0.452,0.52,558
reserve,-0.127,158,262,1,1,0.585,0.289,0.589,420
convince,-0.127,1669,2762,1,1,0.708,0.539,0.763,4431
snowball,-0.127,54,90,1,1,0.717,0.444,0.321,144
pedophile,-0.128,202,335,1,1,0.051,0.724,0.43,537
crux,-0.128,28,47,1,1,0.469,0.558,0.519,75
racket,-0.128,28,47,1,1,0.52,0.356,0.352,75
seriousness,-0.128,234,388,1,1,0.439,0.365,0.75,622
confide,-0.128,449,744,1,1,0.669,0.472,0.595,1193
eloquent,-0.128,60,100,1,1,0.87,0.68,0.741,160
finish,-0.128,2638,4369,1,1,0.471,0.429,0.545,7007
revolve,-0.128,156,259,1,1,0.592,0.546,0.402,415
rare,-0.128,1779,2947,1,1,0.396,0.413,0.236,4726
macro,-0.128,31,52,1,1,0.552,0.469,0.647,83
inflammatory,-0.128,31,52,1,1,0.177,0.642,0.404,83
omniscient,-0.128,31,52,1,1,0.656,0.334,0.778,83
private,-0.129,2412,3997,1,1,0.661,0.422,0.644,6409
kindergarten,-0.129,171,284,1,1,0.833,0.462,0.308,455
dashed,-0.129,34,57,1,1,0.276,0.393,0.338,91
plaid,-0.129,34,57,1,1,0.48,0.33,0.417,91
anchor,-0.129,212,352,1,1,0.52,0.284,0.564,564
close,-0.129,17990,29826,1,1,0.292,0.26,0.263,47816
reactive,-0.129,37,62,1,1,0.434,0.817,0.721,99
transfer,-0.13,321,533,1,1,0.702,0.49,0.519,854
rehabilitation,-0.13,40,67,1,1,0.406,0.528,0.606,107
fundraiser,-0.13,40,67,1,1,0.61,0.577,0.667,107
motherless,-0.13,40,67,1,1,0.163,0.541,0.337,107
bogus,-0.13,87,145,1,1,0.219,0.353,0.144,232
grounds,-0.13,175,291,1,1,0.667,0.5,0.598,466
surreal,-0.13,287,477,1,1,0.55,0.529,0.67,764
fruits,-0.131,205,341,1,1,0.865,0.357,0.259,546
robe,-0.131,105,175,1,1,0.594,0.216,0.298,280
scraping,-0.131,52,87,1,1,0.265,0.479,0.305,139
equipment,-0.131,161,268,1,1,0.745,0.495,0.7,429
adrenaline,-0.131,111,185,1,1,0.765,0.965,0.825,296
scandalous,-0.131,55,92,1,1,0.135,0.907,0.556,147
chug,-0.131,55,92,1,1,0.401,0.413,0.358,147
welfare,-0.131,241,401,1,1,0.802,0.378,0.679,642
terrorists,-0.131,241,401,1,1,0.062,0.967,0.688,642
founding,-0.132,67,112,1,1,0.698,0.404,0.898,179
kudos,-0.132,286,476,1,1,0.925,0.587,0.642,762
educational,-0.132,150,250,1,1,0.745,0.457,0.764,400
history,-0.132,3263,5425,1,1,0.729,0.382,0.754,8688
footage,-0.132,233,388,1,1,0.625,0.235,0.364,621
test,-0.132,1751,2912,1,1,0.449,0.5,0.509,4663
influence,-0.132,779,1296,1,1,0.622,0.663,0.824,2075
outskirts,-0.132,97,162,1,1,0.474,0.519,0.312,259
heed,-0.133,106,177,1,1,0.75,0.49,0.569,283
good,-0.133,108995,181350,1,1,0.938,0.368,0.534,290345
surprised,-0.133,2609,4343,1,1,0.784,0.855,0.539,6952
defending,-0.133,592,986,1,1,0.604,0.871,0.812,1578
whisper,-0.134,851,1418,1,1,0.49,0.225,0.265,2269
benefit,-0.134,1231,2051,1,1,0.906,0.422,0.806,3282
tradition,-0.134,346,577,1,1,0.83,0.43,0.75,923
avoiding,-0.134,921,1535,1,1,0.457,0.433,0.309,2456
devotee,-0.134,17,29,1,1,0.816,0.461,0.577,46
unintelligible,-0.134,11,19,1,1,0.208,0.472,0.283,30
fasten,-0.134,11,19,1,1,0.458,0.585,0.529,30
chagrin,-0.134,14,24,1,1,0.104,0.704,0.472,38
collision,-0.134,32,54,1,1,0.245,0.848,0.585,86
shareholder,-0.134,11,19,1,1,0.656,0.632,0.915,30
falter,-0.134,38,64,1,1,0.421,0.65,0.346,102
colonial,-0.134,44,74,1,1,0.553,0.327,0.613,118
blower,-0.134,17,29,1,1,0.564,0.55,0.536,46
onward,-0.134,86,144,1,1,0.667,0.538,0.741,230
snob,-0.134,50,84,1,1,0.296,0.52,0.309,134
chaplain,-0.134,26,44,1,1,0.582,0.37,0.577,70
orthodox,-0.134,50,84,1,1,0.388,0.471,0.647,134
gladiator,-0.134,17,29,1,1,0.5,0.833,0.866,46
comprehend,-0.134,431,719,1,1,0.875,0.365,0.689,1150
imperialist,-0.134,17,29,1,1,0.284,0.786,0.833,46
archaic,-0.134,38,64,1,1,0.271,0.327,0.332,102
allocation,-0.134,11,19,1,1,0.604,0.388,0.679,30
jolt,-0.134,29,49,1,1,0.365,0.708,0.358,78
optimum,-0.134,11,19,1,1,0.892,0.469,0.808,30
grieved,-0.134,47,79,1,1,0.104,0.46,0.191,126
vise,-0.134,32,54,1,1,0.533,0.391,0.451,86
rerun,-0.134,23,39,1,1,0.333,0.62,0.529,62
worsening,-0.134,47,79,1,1,0.115,0.685,0.202,126
retrospective,-0.134,23,39,1,1,0.594,0.481,0.528,62
retardation,-0.134,14,24,1,1,0.125,0.36,0.155,38
awed,-0.134,20,34,1,1,0.364,0.774,0.361,54
complimentary,-0.134,29,49,1,1,0.823,0.413,0.435,78
distinguishing,-0.134,14,24,1,1,0.622,0.363,0.64,38
trousers,-0.134,53,89,1,1,0.625,0.314,0.442,142
gadget,-0.134,29,49,1,1,0.635,0.559,0.382,78
tangent,-0.134,38,64,1,1,0.573,0.373,0.454,102
repugnant,-0.134,56,94,1,1,0.061,0.735,0.453,150
thaw,-0.134,26,44,1,1,0.438,0.321,0.327,70
inertia,-0.134,23,39,1,1,0.344,0.288,0.322,62
intention,-0.135,540,901,1,1,0.531,0.48,0.636,1441
understood,-0.135,3056,5096,1,1,0.78,0.441,0.686,8152
satisfying,-0.135,486,811,1,1,0.89,0.606,0.814,1297
muscle,-0.135,234,391,1,1,0.359,0.49,0.645,625
surrender,-0.135,409,683,1,1,0.115,0.396,0.186,1092
racial,-0.136,156,261,1,1,0.292,0.519,0.513,417
honest,-0.136,6312,10536,1,1,0.927,0.254,0.75,16848
viewing,-0.136,302,505,1,1,0.69,0.394,0.598,807
scholarship,-0.136,99,166,1,1,0.866,0.49,0.625,265
affirmation,-0.137,181,303,1,1,0.75,0.5,0.689,484
fret,-0.137,160,268,1,1,0.289,0.46,0.231,428
blackmail,-0.137,78,131,1,1,0.094,0.802,0.482,209
spirit,-0.137,4114,6876,1,1,0.786,0.37,0.621,10990
shaving,-0.137,72,121,1,1,0.5,0.469,0.353,193
clockwork,-0.137,69,116,1,1,0.49,0.373,0.528,185
month,-0.138,8758,14643,1,1,0.688,0.255,0.411,23401
phrase,-0.138,560,937,1,1,0.63,0.264,0.314,1497
solar,-0.138,243,407,1,1,0.622,0.452,0.645,650
fend,-0.138,173,290,1,1,0.646,0.731,0.537,463
spine,-0.138,262,439,1,1,0.495,0.461,0.6,701
squeaky,-0.138,51,86,1,1,0.229,0.771,0.367,137
pushy,-0.138,51,86,1,1,0.08,0.906,0.741,137
swamp,-0.138,360,603,1,1,0.245,0.425,0.235,963
luck,-0.139,4301,7198,1,1,0.854,0.49,0.717,11499
fraternity,-0.139,48,81,1,1,0.892,0.536,0.679,129
access,-0.139,1351,2262,1,1,0.714,0.472,0.567,3613
fighter,-0.139,607,1017,1,1,0.637,0.76,0.898,1624
weigh,-0.139,205,344,1,1,0.333,0.396,0.375,549
multitude,-0.139,122,205,1,1,0.562,0.765,0.847,327
notwithstanding,-0.14,33,56,1,1,0.367,0.316,0.433,89
devotional,-0.14,33,56,1,1,0.74,0.394,0.655,89
hurt,-0.14,20362,34139,1,1,0.062,0.773,0.291,54501
commune,-0.141,64,108,1,1,0.5,0.488,0.655,172
strained,-0.141,64,108,1,1,0.122,0.656,0.58,172
conceive,-0.141,64,108,1,1,0.708,0.538,0.7,172
insignificant,-0.141,482,809,1,1,0.083,0.306,0.114,1291
eat,-0.141,13288,22289,1,1,0.731,0.5,0.464,35577
analytical,-0.141,30,51,1,1,0.625,0.324,0.8,81
survive,-0.141,3869,6492,1,1,0.77,0.824,0.726,10361
skirts,-0.141,58,98,1,1,0.622,0.538,0.241,156
keep,-0.141,55059,92395,1,1,0.714,0.296,0.547,147454
offend,-0.142,198,333,1,1,0.094,0.804,0.333,531
reluctant,-0.142,139,234,1,1,0.292,0.63,0.432,373
scandal,-0.142,195,328,1,1,0.122,0.821,0.557,523
articles,-0.142,488,820,1,1,0.552,0.324,0.565,1308
chairman,-0.142,80,135,1,1,0.656,0.567,0.933,215
trustworthy,-0.142,208,350,1,1,0.969,0.315,0.824,558
tow,-0.142,77,130,1,1,0.531,0.5,0.508,207
madam,-0.142,230,387,1,1,0.58,0.308,0.571,617
investment,-0.142,252,424,1,1,0.72,0.592,0.745,676
robin,-0.142,605,1017,1,1,0.552,0.363,0.393,1622
sluggish,-0.142,24,41,1,1,0.224,0.124,0.155,65
impart,-0.142,24,41,1,1,0.521,0.441,0.694,65
terrorist,-0.143,415,698,1,1,0.019,0.93,0.679,1113
peacefully,-0.143,616,1036,1,1,0.901,0.19,0.639,1652
weird,-0.143,16464,27674,1,1,0.26,0.66,0.402,44138
reconciliation,-0.143,46,78,1,1,0.896,0.57,0.604,124
caution,-0.143,140,236,1,1,0.552,0.712,0.547,376
rosary,-0.143,46,78,1,1,0.806,0.14,0.43,124
ruin,-0.143,2426,4079,1,1,0.125,0.588,0.192,6505
medley,-0.143,90,152,1,1,0.487,0.352,0.4,242
equip,-0.144,21,36,1,1,0.65,0.519,0.713,57
civilization,-0.144,241,406,1,1,0.823,0.452,0.839,647
jittery,-0.144,21,36,1,1,0.344,0.856,0.255,57
agnostic,-0.144,40,68,1,1,0.306,0.396,0.574,108
publishing,-0.144,160,270,1,1,0.708,0.615,0.66,430
forgetful,-0.144,59,100,1,1,0.24,0.343,0.264,159
propaganda,-0.145,514,866,1,1,0.521,0.651,0.618,1380
qualify,-0.145,157,265,1,1,0.73,0.594,0.52,422
perimeter,-0.145,18,31,1,1,0.47,0.443,0.555,49
impaired,-0.145,56,95,1,1,0.13,0.459,0.269,151
spokesman,-0.145,18,31,1,1,0.72,0.48,0.611,49
colt,-0.145,56,95,1,1,0.561,0.587,0.543,151
epileptic,-0.145,18,31,1,1,0.146,0.794,0.34,49
actuality,-0.145,91,154,1,1,0.75,0.464,0.6,245
solace,-0.145,1002,1689,1,1,0.776,0.294,0.453,2691
negligence,-0.146,53,90,1,1,0.092,0.57,0.251,143
voluntarily,-0.146,107,181,1,1,0.847,0.46,0.527,288
disparity,-0.146,34,58,1,1,0.208,0.482,0.361,92
finally,-0.146,15500,26131,1,1,0.583,0.433,0.465,41631
comfy,-0.146,652,1100,1,1,0.93,0.241,0.625,1752
shudder,-0.146,66,112,1,1,0.344,0.791,0.559,178
equally,-0.147,788,1330,1,1,0.625,0.264,0.436,2118
interject,-0.147,15,26,1,1,0.333,0.648,0.658,41
twitchy,-0.147,15,26,1,1,0.094,0.918,0.281,41
newness,-0.147,15,26,1,1,0.74,0.522,0.588,41
hairspray,-0.147,15,26,1,1,0.549,0.279,0.269,41
hijack,-0.147,31,53,1,1,0.042,0.908,0.594,84
mower,-0.147,15,26,1,1,0.458,0.51,0.368,41
zealot,-0.147,15,26,1,1,0.48,0.793,0.654,41
punishable,-0.147,15,26,1,1,0.198,0.588,0.433,41
spaniel,-0.147,15,26,1,1,0.561,0.435,0.385,41
stampede,-0.147,15,26,1,1,0.235,0.875,0.683,41
divide,-0.147,329,556,1,1,0.333,0.52,0.417,885
slay,-0.147,156,264,1,1,0.133,0.92,0.585,420
altar,-0.147,92,156,1,1,0.724,0.387,0.635,248
corporate,-0.148,378,639,1,1,0.592,0.454,0.745,1017
exert,-0.148,44,75,1,1,0.694,0.735,0.806,119
disgrace,-0.148,504,852,1,1,0.061,0.531,0.331,1356
reverend,-0.148,28,48,1,1,0.65,0.337,0.576,76
culinary,-0.148,28,48,1,1,0.654,0.443,0.519,76
mechanics,-0.148,70,119,1,1,0.542,0.5,0.761,189
tent,-0.149,238,403,1,1,0.51,0.275,0.333,641
belated,-0.149,83,141,1,1,0.24,0.4,0.214,224
waver,-0.149,41,70,1,1,0.426,0.63,0.255,111
clothing,-0.149,374,633,1,1,0.75,0.343,0.407,1007
aircraft,-0.149,54,92,1,1,0.646,0.644,0.691,146
impressed,-0.149,397,672,1,1,0.806,0.77,0.429,1069
hooray,-0.149,122,207,1,1,0.61,0.481,0.536,329
discover,-0.149,1365,2309,1,1,0.771,0.793,0.673,3674
wasp,-0.149,80,136,1,1,0.39,0.62,0.406,216
damned,-0.149,596,1009,1,1,0.1,0.76,0.465,1605
jean,-0.15,421,713,1,1,0.602,0.444,0.364,1134
merry,-0.15,2913,4930,1,1,0.979,0.731,0.764,7843
cylinder,-0.15,12,21,1,1,0.459,0.324,0.447,33
flimsy,-0.15,25,43,1,1,0.302,0.396,0.189,68
announcer,-0.15,25,43,1,1,0.602,0.57,0.732,68
tapering,-0.15,12,21,1,1,0.344,0.38,0.237,33
retract,-0.15,38,65,1,1,0.316,0.443,0.358,103
heresy,-0.15,12,21,1,1,0.265,0.765,0.443,33
flare,-0.15,139,236,1,1,0.558,0.823,0.508,375
employee,-0.15,315,534,1,1,0.582,0.361,0.481,849
murder,-0.15,1170,1982,1,1,0.061,0.942,0.615,3152
composure,-0.15,61,104,1,1,0.802,0.354,0.717,165
critical,-0.151,669,1134,1,1,0.312,0.802,0.545,1803
right,-0.151,78031,132188,1,1,0.74,0.352,0.71,210219
subject,-0.151,1166,1976,1,1,0.602,0.344,0.558,3142
crabby,-0.151,35,60,1,1,0.198,0.812,0.37,95
burglar,-0.151,35,60,1,1,0.05,0.769,0.404,95
motherland,-0.151,35,60,1,1,0.677,0.375,0.731,95
congregation,-0.151,71,121,1,1,0.561,0.49,0.7,192
peripheral,-0.151,35,60,1,1,0.406,0.406,0.549,95
appreciated,-0.151,2056,3485,1,1,0.91,0.434,0.779,5541
questionable,-0.151,189,321,1,1,0.268,0.551,0.365,510
journalist,-0.151,366,621,1,1,0.542,0.452,0.732,987
whereabouts,-0.151,58,99,1,1,0.439,0.382,0.356,157
sighting,-0.152,22,38,1,1,0.582,0.56,0.627,60
snooze,-0.152,45,77,1,1,0.235,0.357,0.282,122
recount,-0.152,22,38,1,1,0.479,0.402,0.509,60
advice,-0.152,5205,8828,1,1,0.698,0.408,0.688,14033
historic,-0.152,101,172,1,1,0.816,0.473,0.784,273
overdose,-0.152,496,842,1,1,0.11,0.82,0.468,1338
negativity,-0.152,1327,2252,1,1,0.06,0.52,0.273,3579
revolution,-0.152,322,547,1,1,0.417,0.902,0.798,869
complicated,-0.152,1242,2108,1,1,0.211,0.66,0.455,3350
wrapper,-0.153,32,55,1,1,0.625,0.358,0.391,87
trickle,-0.153,32,55,1,1,0.5,0.196,0.231,87
incredible,-0.153,2307,3917,1,1,0.857,0.796,0.902,6224
pastor,-0.153,495,841,1,1,0.698,0.236,0.746,1336
contemplate,-0.153,290,493,1,1,0.74,0.347,0.642,783
weights,-0.153,105,179,1,1,0.458,0.5,0.722,284
whelp,-0.153,52,89,1,1,0.344,0.458,0.31,141
drained,-0.154,882,1499,1,1,0.31,0.441,0.352,2381
earthly,-0.154,102,174,1,1,0.625,0.318,0.518,276
hurting,-0.154,4487,7625,1,1,0.153,0.778,0.221,12112
ignorance,-0.154,991,1685,1,1,0.153,0.417,0.209,2676
faithful,-0.154,768,1306,1,1,0.888,0.333,0.627,2074
scenario,-0.154,592,1007,1,1,0.667,0.51,0.683,1599
union,-0.154,632,1075,1,1,0.854,0.226,0.766,1707
bulletin,-0.154,19,33,1,1,0.573,0.294,0.361,52
pansy,-0.154,19,33,1,1,0.653,0.283,0.589,52
manpower,-0.154,9,16,1,1,0.531,0.62,0.543,25
enmity,-0.154,9,16,1,1,0.094,0.706,0.382,25
triage,-0.154,9,16,1,1,0.398,0.433,0.479,25
sidestep,-0.154,9,16,1,1,0.378,0.559,0.407,25
sander,-0.154,9,16,1,1,0.438,0.58,0.445,25
wiper,-0.154,9,16,1,1,0.5,0.38,0.535,25
farcical,-0.154,9,16,1,1,0.406,0.481,0.259,25
shrewd,-0.154,9,16,1,1,0.551,0.673,0.816,25
yesteryear,-0.154,9,16,1,1,0.469,0.259,0.331,25
treasury,-0.154,29,50,1,1,0.812,0.541,0.736,79
monarchy,-0.154,29,50,1,1,0.45,0.557,0.87,79
rationing,-0.154,9,16,1,1,0.396,0.404,0.54,25
dismissive,-0.154,79,135,1,1,0.188,0.541,0.43,214
prefix,-0.154,9,16,1,1,0.521,0.232,0.463,25
docked,-0.154,9,16,1,1,0.281,0.754,0.398,25
samba,-0.154,9,16,1,1,0.781,0.74,0.465,25
nylon,-0.154,9,16,1,1,0.49,0.304,0.295,25
diction,-0.154,9,16,1,1,0.439,0.373,0.679,25
antibiotic,-0.154,9,16,1,1,0.51,0.373,0.658,25
info,-0.154,1190,2024,1,1,0.75,0.33,0.642,3214
waist,-0.154,346,589,1,1,0.542,0.448,0.351,935
disgusting,-0.155,2439,4149,1,1,0.031,0.796,0.245,6588
pattern,-0.155,434,739,1,1,0.479,0.422,0.664,1173
explain,-0.155,4178,7109,1,1,0.719,0.517,0.736,11287
indictment,-0.155,66,113,1,1,0.245,0.745,0.577,179
landlord,-0.155,180,307,1,1,0.684,0.5,0.858,487
lot,-0.155,47526,80876,1,1,0.531,0.215,0.37,128402
remainder,-0.155,113,193,1,1,0.398,0.357,0.324,306
logistics,-0.156,46,79,1,1,0.633,0.5,0.73,125
blessing,-0.156,2047,3485,1,1,0.929,0.264,0.8,5532
sync,-0.156,130,222,1,1,0.802,0.44,0.67,352
turkey,-0.156,523,891,1,1,0.634,0.245,0.247,1414
tolerant,-0.156,100,171,1,1,0.765,0.192,0.618,271
varying,-0.156,90,154,1,1,0.552,0.471,0.385,244
secular,-0.156,90,154,1,1,0.463,0.461,0.52,244
hale,-0.156,90,154,1,1,0.479,0.435,0.5,244
deterrent,-0.156,26,45,1,1,0.292,0.461,0.385,71
superman,-0.156,242,413,1,1,0.945,0.794,0.929,655
destroying,-0.157,627,1069,1,1,0.041,0.828,0.66,1696
leverage,-0.157,70,120,1,1,0.459,0.5,0.629,190
obey,-0.157,131,224,1,1,0.677,0.433,0.533,355
screech,-0.157,43,74,1,1,0.214,0.802,0.306,117
motivational,-0.157,165,282,1,1,0.906,0.646,0.858,447
virtually,-0.157,287,490,1,1,0.594,0.521,0.625,777
frequently,-0.157,660,1126,1,1,0.596,0.423,0.634,1786
muster,-0.157,155,265,1,1,0.635,0.46,0.548,420
jesus,-0.157,7590,12944,1,1,0.8,0.4,0.62,20534
paper,-0.157,2110,3599,1,1,0.52,0.123,0.293,5709
impolite,-0.158,16,28,1,1,0.167,0.59,0.282,44
eggnog,-0.158,33,57,1,1,0.635,0.36,0.259,90
deodorant,-0.158,67,115,1,1,0.48,0.265,0.269,182
immersion,-0.158,33,57,1,1,0.51,0.556,0.564,90
lenient,-0.158,16,28,1,1,0.52,0.451,0.34,44
immediately,-0.158,2403,4100,1,1,0.552,0.78,0.707,6503
warrants,-0.159,40,69,1,1,0.562,0.431,0.881,109
baseline,-0.159,40,69,1,1,0.483,0.367,0.509,109
trim,-0.159,40,69,1,1,0.5,0.466,0.43,109
tenacity,-0.159,40,69,1,1,0.74,0.657,0.889,109
entire,-0.159,8012,13680,1,1,0.689,0.462,0.698,21692
liberty,-0.159,269,460,1,1,0.938,0.579,0.836,729
subscription,-0.159,170,291,1,1,0.583,0.333,0.651,461
obscene,-0.159,64,110,1,1,0.05,0.745,0.348,174
tanned,-0.159,23,40,1,1,0.615,0.55,0.491,63
pointer,-0.159,23,40,1,1,0.583,0.382,0.5,63
paramount,-0.16,54,93,1,1,0.771,0.615,0.902,147
tend,-0.16,3162,5405,1,1,0.604,0.398,0.412,8567
organizer,-0.16,30,52,1,1,0.604,0.577,0.846,82
embarrassing,-0.16,1067,1825,1,1,0.226,0.809,0.225,2892
prediction,-0.16,130,223,1,1,0.562,0.635,0.585,353
swollen,-0.16,106,182,1,1,0.236,0.51,0.277,288
admin,-0.16,341,584,1,1,0.688,0.42,0.854,925
exempt,-0.161,44,76,1,1,0.588,0.455,0.664,120
scalp,-0.161,44,76,1,1,0.347,0.346,0.302,120
violently,-0.161,148,254,1,1,0.12,0.97,0.527,402
berlin,-0.161,304,521,1,1,0.592,0.423,0.571,825
previously,-0.161,318,545,1,1,0.594,0.337,0.623,863
greatly,-0.161,547,937,1,1,0.75,0.708,0.877,1484
predicting,-0.161,58,100,1,1,0.463,0.647,0.679,158
intimidation,-0.161,58,100,1,1,0.177,0.791,0.644,158
decorating,-0.161,117,201,1,1,0.863,0.548,0.462,318
exam,-0.161,742,1271,1,1,0.479,0.663,0.577,2013
monumental,-0.161,65,112,1,1,0.656,0.594,0.955,177
criticise,-0.161,65,112,1,1,0.073,0.7,0.452,177
commander,-0.162,145,249,1,1,0.531,0.615,0.906,394
unfaithful,-0.162,79,136,1,1,0.031,0.806,0.298,215
injured,-0.162,382,655,1,1,0.083,0.68,0.302,1037
roster,-0.162,107,184,1,1,0.531,0.306,0.381,291
regional,-0.162,107,184,1,1,0.62,0.4,0.607,291
submission,-0.162,114,196,1,1,0.531,0.58,0.633,310
underage,-0.162,198,340,1,1,0.469,0.461,0.3,538
succinct,-0.163,13,23,1,1,0.51,0.413,0.566,36
agreeable,-0.163,20,35,1,1,0.906,0.5,0.696,55
incognito,-0.163,34,59,1,1,0.61,0.49,0.446,93
licorice,-0.163,13,23,1,1,0.677,0.31,0.4,36
anthropology,-0.163,13,23,1,1,0.49,0.367,0.582,36
trine,-0.163,13,23,1,1,0.396,0.365,0.317,36
finite,-0.163,41,71,1,1,0.384,0.347,0.293,112
glaring,-0.163,76,131,1,1,0.694,0.794,0.798,207
stairwell,-0.163,27,47,1,1,0.51,0.292,0.333,74
groundwork,-0.163,13,23,1,1,0.5,0.375,0.593,36
overkill,-0.163,20,35,1,1,0.379,0.861,0.678,55
twitching,-0.163,41,71,1,1,0.292,0.7,0.482,112
charter,-0.163,34,59,1,1,0.677,0.382,0.518,93
criticism,-0.163,424,728,1,1,0.115,0.563,0.505,1152
feedback,-0.164,548,941,1,1,0.622,0.557,0.645,1489
standpoint,-0.164,59,102,1,1,0.585,0.388,0.652,161
absorbing,-0.164,59,102,1,1,0.49,0.49,0.578,161
verify,-0.164,98,169,1,1,0.761,0.481,0.704,267
sister,-0.164,9367,16086,1,1,0.916,0.324,0.562,25453
humiliated,-0.165,176,303,1,1,0.104,0.712,0.216,479
topless,-0.165,84,145,1,1,0.625,0.765,0.414,229
present,-0.165,2773,4764,1,1,0.724,0.286,0.634,7537
hover,-0.165,38,66,1,1,0.51,0.431,0.404,104
ambiguity,-0.165,38,66,1,1,0.164,0.46,0.37,104
raw,-0.165,847,1456,1,1,0.143,0.349,0.342,2303
zillion,-0.165,31,54,1,1,0.612,0.559,0.63,85
smoothie,-0.166,56,97,1,1,0.806,0.333,0.281,153
racism,-0.166,781,1344,1,1,0.122,0.673,0.487,2125
evaluation,-0.166,74,128,1,1,0.542,0.667,0.764,202
creepy,-0.166,2353,4049,1,1,0.125,0.861,0.373,6402
fraudulent,-0.166,67,116,1,1,0.15,0.774,0.417,183
cursing,-0.167,139,240,1,1,0.112,0.86,0.446,379
thanksgiving,-0.167,631,1087,1,1,0.927,0.449,0.637,1718
clearing,-0.167,175,302,1,1,0.68,0.333,0.509,477
labor,-0.167,445,767,1,1,0.594,0.639,0.754,1212
doormat,-0.167,53,92,1,1,0.458,0.269,0.267,145
aspirin,-0.167,17,30,1,1,0.479,0.271,0.422,47
gunman,-0.167,35,61,1,1,0.167,0.922,0.689,96
parmesan,-0.167,17,30,1,1,0.698,0.321,0.382,47
liabilities,-0.167,17,30,1,1,0.429,0.608,0.694,47
dislocated,-0.167,17,30,1,1,0.125,0.625,0.2,47
terrace,-0.167,53,92,1,1,0.615,0.269,0.411,145
tutoring,-0.167,35,61,1,1,0.663,0.402,0.702,96
width,-0.167,17,30,1,1,0.583,0.28,0.518,47
kool-aid,-0.167,35,61,1,1,0.531,0.318,0.393,96
interrupt,-0.167,190,328,1,1,0.21,0.635,0.509,518
publish,-0.167,154,266,1,1,0.714,0.547,0.603,420
poop,-0.168,338,583,1,1,0.163,0.43,0.172,921
luggage,-0.168,100,173,1,1,0.561,0.226,0.319,273
dismiss,-0.168,201,347,1,1,0.167,0.541,0.509,548
national,-0.168,2767,4769,1,1,0.698,0.365,0.663,7536
venting,-0.168,527,909,1,1,0.375,0.388,0.418,1436
candles,-0.168,332,573,1,1,0.615,0.206,0.268,905
plentiful,-0.168,28,49,1,1,0.833,0.735,0.745,77
photograph,-0.169,235,406,1,1,0.677,0.353,0.358,641
jarring,-0.169,68,118,1,1,0.21,0.673,0.309,186
moan,-0.169,355,613,1,1,0.357,0.735,0.352,968
cartel,-0.169,39,68,1,1,0.438,0.394,0.602,107
secluded,-0.169,360,622,1,1,0.357,0.265,0.24,982
downfall,-0.17,251,434,1,1,0.2,0.717,0.182,685
freshen,-0.17,10,18,1,1,0.806,0.363,0.566,28
amazement,-0.17,21,37,1,1,0.75,0.8,0.639,58
corned,-0.17,10,18,1,1,0.459,0.441,0.425,28
reversal,-0.17,32,56,1,1,0.38,0.51,0.591,88
ballistic,-0.17,10,18,1,1,0.26,0.806,0.685,28
bestseller,-0.17,10,18,1,1,0.771,0.643,0.7,28
hellish,-0.17,98,170,1,1,0.125,0.86,0.545,268
convocation,-0.17,10,18,1,1,0.538,0.611,0.663,28
fallible,-0.17,10,18,1,1,0.365,0.537,0.402,28
plausible,-0.17,65,113,1,1,0.714,0.404,0.51,178
fluctuate,-0.17,21,37,1,1,0.285,0.617,0.48,58
examiner,-0.17,10,18,1,1,0.406,0.575,0.812,28
figurative,-0.17,21,37,1,1,0.479,0.45,0.634,58
alive,-0.171,7003,12101,1,1,0.816,0.637,0.731,19104
regretted,-0.171,135,234,1,1,0.352,0.54,0.368,369
incompetent,-0.171,238,412,1,1,0.133,0.566,0.239,650
front,-0.171,5820,10059,1,1,0.677,0.35,0.623,15879
vomiting,-0.171,80,139,1,1,0.156,0.78,0.157,219
intended,-0.171,533,922,1,1,0.406,0.542,0.587,1455
amaze,-0.171,139,241,1,1,0.896,0.843,0.783,380
segment,-0.171,176,305,1,1,0.469,0.29,0.44,481
puke,-0.171,165,286,1,1,0.204,0.545,0.292,451
perfectionist,-0.171,47,82,1,1,0.667,0.704,0.905,129
heartfelt,-0.171,276,478,1,1,0.904,0.44,0.54,754
orientation,-0.172,243,421,1,1,0.667,0.454,0.686,664
mentor,-0.172,380,658,1,1,0.719,0.455,0.777,1038
defensive,-0.172,221,383,1,1,0.542,0.64,0.678,604
nefarious,-0.172,36,63,1,1,0.184,0.72,0.528,99
speculation,-0.172,62,108,1,1,0.325,0.683,0.394,170
trailer,-0.172,637,1103,1,1,0.541,0.49,0.473,1740
wired,-0.172,218,378,1,1,0.398,0.42,0.537,596
menopause,-0.172,103,179,1,1,0.204,0.46,0.306,282
reproach,-0.172,25,44,1,1,0.24,0.755,0.384,69
sewage,-0.172,25,44,1,1,0.255,0.343,0.339,69
workings,-0.172,25,44,1,1,0.704,0.56,0.745,69
secrecy,-0.172,51,89,1,1,0.294,0.549,0.475,140
resign,-0.172,404,700,1,1,0.25,0.543,0.273,1104
purple,-0.172,1296,2244,1,1,0.7,0.298,0.33,3540
troops,-0.172,304,527,1,1,0.385,0.718,0.804,831
roof,-0.173,773,1339,1,1,0.602,0.226,0.342,2112
assert,-0.173,40,70,1,1,0.75,0.619,0.809,110
memo,-0.173,96,167,1,1,0.625,0.235,0.407,263
humbly,-0.173,55,96,1,1,0.771,0.194,0.37,151
dental,-0.173,111,193,1,1,0.573,0.404,0.463,304
chaos,-0.173,952,1650,1,1,0.016,0.923,0.373,2602
flat,-0.173,1873,3246,1,1,0.408,0.236,0.303,5119
lean,-0.173,2004,3473,1,1,0.734,0.353,0.438,5477
pacing,-0.173,100,174,1,1,0.583,0.551,0.491,274
unimaginable,-0.173,115,200,1,1,0.573,0.634,0.589,315
tidings,-0.174,14,25,1,1,0.61,0.51,0.694,39
savanna,-0.174,14,25,1,1,0.606,0.147,0.394,39
statutory,-0.174,14,25,1,1,0.51,0.376,0.539,39
flank,-0.174,14,25,1,1,0.448,0.458,0.443,39
fauna,-0.174,14,25,1,1,0.646,0.346,0.404,39
contracting,-0.174,14,25,1,1,0.594,0.49,0.769,39
planets,-0.174,386,670,1,1,0.724,0.318,0.658,1056
dish,-0.174,251,436,1,1,0.552,0.255,0.264,687
daily,-0.175,5543,9617,1,1,0.653,0.347,0.473,15160
exasperated,-0.175,33,58,1,1,0.229,0.816,0.377,91
sellout,-0.175,33,58,1,1,0.398,0.49,0.465,91
credence,-0.175,33,58,1,1,0.76,0.46,0.737,91
fuss,-0.175,154,268,1,1,0.406,0.876,0.48,422
perseverance,-0.175,124,216,1,1,0.888,0.63,0.796,340
council,-0.175,431,749,1,1,0.875,0.279,0.635,1180
apologize,-0.175,1269,2204,1,1,0.551,0.378,0.389,3473
topic,-0.175,1376,2390,1,1,0.52,0.276,0.427,3766
outpatient,-0.176,18,32,1,1,0.26,0.4,0.395,50
oracle,-0.176,37,65,1,1,0.552,0.531,0.67,102
bouncy,-0.176,18,32,1,1,0.562,0.565,0.429,50
verbal,-0.176,208,362,1,1,0.52,0.291,0.562,570
gassy,-0.176,18,32,1,1,0.354,0.497,0.304,50
mishap,-0.176,18,32,1,1,0.071,0.654,0.227,50
bowls,-0.176,98,171,1,1,0.551,0.28,0.277,269
intent,-0.176,296,515,1,1,0.55,0.481,0.5,811
insurmountable,-0.176,60,105,1,1,0.62,0.627,0.737,165
ope,-0.176,41,72,1,1,0.375,0.38,0.395,113
oppression,-0.177,194,338,1,1,0.08,0.673,0.615,532
recollection,-0.177,45,79,1,1,0.722,0.337,0.566,124
billing,-0.177,22,39,1,1,0.406,0.481,0.67,61
microscopic,-0.177,22,39,1,1,0.36,0.327,0.433,61
mother,-0.177,8833,15366,1,1,0.931,0.408,0.725,24199
blog,-0.177,848,1476,1,1,0.639,0.39,0.432,2324
reported,-0.177,633,1102,1,1,0.418,0.442,0.567,1735
spook,-0.178,49,86,1,1,0.327,0.887,0.322,135
bug,-0.178,820,1428,1,1,0.286,0.5,0.246,2248
derail,-0.178,26,46,1,1,0.108,0.802,0.375,72
covet,-0.178,26,46,1,1,0.302,0.779,0.524,72
stronghold,-0.178,26,46,1,1,0.708,0.636,0.954,72
normal,-0.178,7317,12739,1,1,0.74,0.127,0.38,20056
traction,-0.178,57,100,1,1,0.429,0.585,0.648,157
collective,-0.178,552,962,1,1,0.583,0.458,0.698,1514
forsaken,-0.179,332,579,1,1,0.05,0.49,0.192,911
stomach,-0.179,1362,2373,1,1,0.367,0.402,0.438,3735
substantially,-0.179,30,53,1,1,0.646,0.471,0.684,83
thanks,-0.179,22257,38773,1,1,0.918,0.472,0.461,61030
think,-0.179,123116,214505,1,1,0.786,0.408,0.618,337621
sauna,-0.179,65,114,1,1,0.781,0.35,0.455,179
gel,-0.179,65,114,1,1,0.524,0.206,0.279,179
focus,-0.179,5420,9445,1,1,0.69,0.382,0.648,14865
tense,-0.179,244,426,1,1,0.396,0.439,0.655,670
multiple,-0.179,2348,4093,1,1,0.66,0.51,0.578,6441
pro,-0.179,1038,1810,1,1,0.667,0.471,0.692,2848
ridge,-0.179,73,128,1,1,0.484,0.402,0.349,201
gallon,-0.179,73,128,1,1,0.531,0.327,0.345,201
thunder,-0.179,486,848,1,1,0.296,0.916,0.526,1334
separately,-0.18,151,264,1,1,0.31,0.365,0.368,415
prioritize,-0.18,190,332,1,1,0.671,0.594,0.784,522
yelp,-0.18,38,67,1,1,0.417,0.709,0.431,105
morphine,-0.18,38,67,1,1,0.229,0.49,0.496,105
lifelong,-0.18,362,632,1,1,0.823,0.33,0.64,994
sane,-0.18,999,1743,1,1,0.76,0.235,0.67,2742
nightstand,-0.18,42,74,1,1,0.49,0.13,0.327,116
fail,-0.18,2178,3800,1,1,0.177,0.578,0.154,5978
army,-0.18,4617,8056,1,1,0.417,0.759,0.902,12673
weapon,-0.18,426,744,1,1,0.054,0.84,0.831,1170
ground,-0.18,2977,5196,1,1,0.398,0.343,0.602,8173
uncover,-0.181,54,95,1,1,0.771,0.552,0.648,149
confinement,-0.181,290,507,1,1,0.333,0.656,0.52,797
sensitivity,-0.181,121,212,1,1,0.75,0.417,0.395,333
anomaly,-0.181,66,116,1,1,0.188,0.538,0.404,182
analyze,-0.181,145,254,1,1,0.667,0.462,0.71,399
intimidated,-0.182,244,427,1,1,0.177,0.663,0.208,671
convincing,-0.182,371,649,1,1,0.76,0.527,0.9,1020
warned,-0.182,407,712,1,1,0.302,0.604,0.547,1119
sham,-0.182,106,186,1,1,0.354,0.602,0.395,292
choice,-0.182,6597,11536,1,1,0.745,0.52,0.664,18133
primary,-0.183,521,912,1,1,0.562,0.39,0.545,1433
foundation,-0.183,482,844,1,1,0.771,0.385,0.73,1326
stayed,-0.183,3023,5290,1,1,0.497,0.27,0.395,8313
repayment,-0.183,11,20,1,1,0.479,0.49,0.474,31
memorabilia,-0.183,11,20,1,1,0.78,0.412,0.491,31
skiing,-0.183,39,69,1,1,0.823,0.824,0.62,108
fuzz,-0.183,23,41,1,1,0.521,0.482,0.363,64
unfounded,-0.183,47,83,1,1,0.271,0.52,0.41,130
disrupt,-0.183,111,195,1,1,0.265,0.64,0.349,306
adorn,-0.183,11,20,1,1,0.91,0.424,0.482,31
salted,-0.183,31,55,1,1,0.333,0.4,0.304,86
awestruck,-0.183,11,20,1,1,0.615,0.767,0.68,31
groin,-0.183,11,20,1,1,0.296,0.452,0.364,31
animus,-0.183,11,20,1,1,0.698,0.676,0.466,31
clashing,-0.183,15,27,1,1,0.177,0.764,0.575,42
method,-0.183,335,587,1,1,0.64,0.275,0.698,922
disable,-0.183,35,62,1,1,0.115,0.43,0.269,97
mimicking,-0.183,23,41,1,1,0.316,0.433,0.364,64
wringer,-0.183,11,20,1,1,0.365,0.519,0.321,31
sift,-0.183,23,41,1,1,0.542,0.412,0.461,64
pita,-0.183,23,41,1,1,0.551,0.279,0.255,64
politeness,-0.183,27,48,1,1,0.875,0.353,0.618,75
coexisting,-0.183,11,20,1,1,0.551,0.349,0.648,31
raptors,-0.183,55,97,1,1,0.28,0.565,0.591,152
glib,-0.183,15,27,1,1,0.438,0.433,0.381,42
expensive,-0.183,1475,2582,1,1,0.323,0.54,0.53,4057
firing,-0.183,131,230,1,1,0.188,0.931,0.803,361
femininity,-0.183,43,76,1,1,0.75,0.479,0.451,119
hammock,-0.183,39,69,1,1,0.673,0.255,0.287,108
unsavory,-0.183,11,20,1,1,0.071,0.637,0.353,31
panhandle,-0.183,15,27,1,1,0.441,0.431,0.414,42
eavesdrop,-0.183,15,27,1,1,0.375,0.71,0.368,42
panorama,-0.183,11,20,1,1,0.719,0.402,0.625,31
numerous,-0.184,432,757,1,1,0.622,0.462,0.609,1189
urgent,-0.184,212,372,1,1,0.327,0.918,0.623,584
alarm,-0.184,634,1111,1,1,0.241,0.882,0.698,1745
ethics,-0.184,168,295,1,1,0.658,0.296,0.731,463
gender,-0.184,1481,2595,1,1,0.688,0.346,0.611,4076
cleanse,-0.185,116,204,1,1,0.625,0.31,0.66,320
freak,-0.185,1428,2503,1,1,0.052,0.839,0.464,3931
intimidate,-0.185,100,176,1,1,0.21,0.804,0.632,276
respects,-0.185,274,481,1,1,0.84,0.387,0.824,755
babe,-0.185,3926,6882,1,1,0.86,0.536,0.424,10808
carrier,-0.185,88,155,1,1,0.533,0.588,0.638,243
confident,-0.185,1629,2857,1,1,0.765,0.324,0.723,4486
sucks,-0.185,19159,33603,1,1,0.115,0.683,0.302,52762
reading,-0.186,10175,17848,1,1,0.781,0.183,0.415,28023
atone,-0.186,60,106,1,1,0.418,0.673,0.411,166
lining,-0.186,219,385,1,1,0.571,0.363,0.472,604
shocking,-0.186,427,750,1,1,0.378,0.853,0.833,1177
grappling,-0.186,52,92,1,1,0.448,0.676,0.516,144
calf,-0.186,52,92,1,1,0.531,0.366,0.336,144
story,-0.186,15554,27296,1,1,0.653,0.406,0.704,42850
picky,-0.186,917,1610,1,1,0.257,0.729,0.598,2527
shall,-0.186,3367,5910,1,1,0.51,0.385,0.412,9277
locker,-0.186,146,257,1,1,0.439,0.3,0.393,403
fraction,-0.186,97,171,1,1,0.417,0.33,0.4,268
higher,-0.186,1968,3455,1,1,0.866,0.528,0.713,5423
editorial,-0.186,44,78,1,1,0.583,0.33,0.57,122
adultery,-0.186,44,78,1,1,0.12,0.922,0.51,122
institution,-0.187,175,308,1,1,0.58,0.311,0.79,483
figure,-0.187,5155,9052,1,1,0.688,0.328,0.509,14207
represent,-0.187,638,1121,1,1,0.781,0.433,0.861,1759
studied,-0.187,229,403,1,1,0.786,0.306,0.806,632
impunity,-0.187,36,64,1,1,0.313,0.721,0.602,100
otto,-0.188,32,57,1,1,0.427,0.425,0.404,89
weakness,-0.188,1249,2196,1,1,0.088,0.37,0.125,3445
reflux,-0.188,28,50,1,1,0.281,0.559,0.347,78
raging,-0.188,347,611,1,1,0.219,0.927,0.598,958
tether,-0.188,28,50,1,1,0.323,0.62,0.407,78
bad,-0.188,47613,83751,1,1,0.125,0.625,0.373,131364
considerable,-0.189,53,94,1,1,0.653,0.314,0.683,147
variations,-0.189,53,94,1,1,0.458,0.548,0.353,147
hardworking,-0.189,161,284,1,1,0.719,0.583,0.792,445
punt,-0.189,24,43,1,1,0.365,0.48,0.393,67
exemplary,-0.189,24,43,1,1,0.833,0.343,0.729,67
alzheimers,-0.189,24,43,1,1,0.194,0.518,0.319,67
onslaught,-0.189,49,87,1,1,0.198,0.939,0.717,136
grouping,-0.189,24,43,1,1,0.745,0.58,0.698,67
teammate,-0.189,95,168,1,1,0.865,0.449,0.66,263
insect,-0.189,70,124,1,1,0.276,0.633,0.242,194
unbelievable,-0.19,388,684,1,1,0.771,0.79,0.717,1072
invade,-0.19,158,279,1,1,0.408,0.892,0.714,437
quality,-0.19,2294,4041,1,1,0.896,0.443,0.852,6335
district,-0.19,305,538,1,1,0.438,0.327,0.66,843
mat,-0.19,171,302,1,1,0.459,0.221,0.304,473
achieve,-0.19,1166,2055,1,1,0.816,0.545,0.843,3221
magnitude,-0.19,83,147,1,1,0.608,0.613,0.774,230
takeout,-0.19,83,147,1,1,0.736,0.392,0.368,230
retake,-0.19,20,36,1,1,0.616,0.471,0.591,56
threatening,-0.19,390,688,1,1,0.071,0.875,0.652,1078
align,-0.19,138,244,1,1,0.656,0.364,0.627,382
sensible,-0.191,227,401,1,1,0.625,0.454,0.312,628
prove,-0.191,2040,3598,1,1,0.583,0.52,0.566,5638
contract,-0.191,342,604,1,1,0.594,0.412,0.636,946
rollercoaster,-0.192,258,456,1,1,0.802,0.91,0.651,714
apologist,-0.192,50,89,1,1,0.406,0.429,0.526,139
compression,-0.192,16,29,1,1,0.646,0.521,0.579,45
earnestly,-0.192,33,59,1,1,0.847,0.49,0.717,92
stubble,-0.192,16,29,1,1,0.333,0.442,0.264,45
selfharm,-0.192,16,29,1,1,0.35,0.62,0.407,45
change,-0.192,17031,30066,1,1,0.625,0.575,0.606,47097
boat,-0.192,2422,4277,1,1,0.516,0.42,0.554,6699
queue,-0.192,366,647,1,1,0.458,0.344,0.365,1013
react,-0.192,657,1161,1,1,0.5,0.716,0.717,1818
patient,-0.192,1842,3254,1,1,0.583,0.193,0.34,5096
clumsy,-0.193,153,271,1,1,0.125,0.42,0.144,424
sauce,-0.193,380,672,1,1,0.562,0.515,0.288,1052
barrage,-0.193,42,75,1,1,0.388,0.871,0.627,117
stone,-0.193,1941,3432,1,1,0.216,0.183,0.561,5373
penalty,-0.194,163,289,1,1,0.062,0.49,0.24,452
playoff,-0.194,81,144,1,1,0.622,0.716,0.55,225
system,-0.194,4000,7075,1,1,0.615,0.346,0.764,11075
mil,-0.194,181,321,1,1,0.534,0.388,0.347,502
foreman,-0.194,12,22,1,1,0.458,0.612,0.75,34
unorganized,-0.194,12,22,1,1,0.26,0.657,0.173,34
positively,-0.194,246,436,1,1,0.969,0.645,0.795,682
dak,-0.194,25,45,1,1,0.51,0.417,0.424,70
vindication,-0.194,25,45,1,1,0.531,0.632,0.764,70
conform,-0.194,129,229,1,1,0.479,0.38,0.375,358
disciplinary,-0.194,12,22,1,1,0.562,0.593,0.796,34
benevolence,-0.194,12,22,1,1,0.786,0.34,0.717,34
sherry,-0.194,77,137,1,1,0.594,0.477,0.315,214
backup,-0.194,342,606,1,1,0.52,0.51,0.553,948
trusting,-0.195,695,1231,1,1,0.857,0.508,0.75,1926
progressive,-0.195,408,723,1,1,0.755,0.606,0.81,1131
intend,-0.195,282,500,1,1,0.562,0.52,0.519,782
crap,-0.195,2351,4163,1,1,0.083,0.644,0.167,6514
prescribed,-0.195,95,169,1,1,0.531,0.391,0.463,264
exorcist,-0.195,47,84,1,1,0.219,0.906,0.716,131
limit,-0.195,694,1230,1,1,0.427,0.453,0.5,1924
specify,-0.195,34,61,1,1,0.656,0.405,0.6,95
aspiration,-0.195,34,61,1,1,0.704,0.724,0.675,95
syndrome,-0.196,767,1360,1,1,0.229,0.51,0.246,2127
pencil,-0.196,179,318,1,1,0.552,0.2,0.263,497
gratuitous,-0.196,21,38,1,1,0.735,0.65,0.452,59
sludge,-0.196,21,38,1,1,0.354,0.396,0.229,59
pivotal,-0.196,43,77,1,1,0.582,0.471,0.536,120
unchallenged,-0.196,21,38,1,1,0.552,0.394,0.545,59
transplant,-0.196,65,116,1,1,0.445,0.806,0.62,181
ruling,-0.197,136,242,1,1,0.177,0.566,0.41,378
reschedule,-0.197,30,54,1,1,0.438,0.422,0.537,84
nexus,-0.197,30,54,1,1,0.496,0.368,0.412,84
way,-0.197,77695,137861,1,1,0.48,0.275,0.42,215556
discrimination,-0.197,296,526,1,1,0.051,0.724,0.379,822
avoid,-0.197,4560,8094,1,1,0.427,0.442,0.415,12654
seasoned,-0.197,39,70,1,1,0.812,0.57,0.509,109
shortly,-0.198,275,489,1,1,0.582,0.31,0.36,764
relaxed,-0.198,423,752,1,1,0.865,0.09,0.382,1175
accomplishment,-0.198,209,372,1,1,0.917,0.694,0.888,581
avenger,-0.198,75,134,1,1,0.337,0.865,0.67,209
pending,-0.198,84,150,1,1,0.396,0.441,0.473,234
crazy,-0.198,15453,27455,1,1,0.156,0.843,0.321,42908
pregnancy,-0.198,1034,1838,1,1,0.74,0.769,0.569,2872
pineapple,-0.199,156,278,1,1,0.677,0.316,0.245,434
apparently,-0.199,4241,7539,1,1,0.531,0.41,0.426,11780
croft,-0.199,17,31,1,1,0.531,0.429,0.421,48
strengthening,-0.199,62,111,1,1,0.913,0.627,0.945,173
sanctimonious,-0.199,35,63,1,1,0.24,0.365,0.327,98
grunting,-0.199,17,31,1,1,0.198,0.827,0.481,48
improvise,-0.199,17,31,1,1,0.646,0.65,0.519,48
case,-0.199,6407,11394,1,1,0.427,0.275,0.441,17801
educated,-0.199,500,890,1,1,0.816,0.297,0.625,1390
merit,-0.2,94,168,1,1,0.854,0.5,0.722,262
condone,-0.2,94,168,1,1,0.571,0.441,0.619,262
license,-0.2,361,643,1,1,0.5,0.394,0.702,1004
additional,-0.2,239,426,1,1,0.673,0.462,0.526,665
wording,-0.2,67,120,1,1,0.653,0.5,0.588,187
dear,-0.2,10463,18628,1,1,0.88,0.434,0.629,29091
dorm,-0.2,1629,2901,1,1,0.719,0.194,0.327,4530
apology,-0.201,341,608,1,1,0.571,0.346,0.402,949
offense,-0.201,556,991,1,1,0.23,0.765,0.51,1547
satanic,-0.201,95,170,1,1,0.062,0.843,0.72,265
position,-0.201,2407,4290,1,1,0.604,0.451,0.538,6697
annoyance,-0.202,169,302,1,1,0.167,0.718,0.342,471
frighten,-0.202,68,122,1,1,0.255,0.843,0.5,190
irritable,-0.202,137,245,1,1,0.112,0.952,0.462,382
pillar,-0.202,91,163,1,1,0.583,0.33,0.684,254
china,-0.202,1003,1789,1,1,0.561,0.443,0.556,2792
mom,-0.202,19352,34506,1,1,0.927,0.336,0.639,53858
bigotry,-0.202,225,402,1,1,0.356,0.737,0.481,627
defective,-0.202,59,106,1,1,0.122,0.58,0.274,165
education,-0.202,1232,2198,1,1,0.896,0.275,0.84,3430
prior,-0.202,406,725,1,1,0.468,0.35,0.417,1131
payment,-0.203,240,429,1,1,0.629,0.452,0.643,669
continuing,-0.203,544,972,1,1,0.667,0.5,0.52,1516
frustrating,-0.203,1575,2813,1,1,0.042,0.696,0.264,4388
expect,-0.203,4520,8072,1,1,0.469,0.327,0.377,12592
powdered,-0.203,13,24,1,1,0.52,0.375,0.42,37
payout,-0.203,13,24,1,1,0.646,0.6,0.575,37
condiment,-0.203,13,24,1,1,0.52,0.333,0.433,37
autocratic,-0.203,13,24,1,1,0.542,0.577,0.727,37
sizable,-0.203,13,24,1,1,0.727,0.337,0.657,37
flour,-0.203,27,49,1,1,0.53,0.235,0.239,76
overcome,-0.204,2455,4385,1,1,0.719,0.689,0.848,6840
legitimate,-0.204,219,392,1,1,0.792,0.363,0.841,611
doomed,-0.204,800,1430,1,1,0.041,0.755,0.301,2230
burned,-0.204,571,1021,1,1,0.163,0.603,0.347,1592
continued,-0.204,843,1507,1,1,0.635,0.44,0.5,2350
bankrupt,-0.205,145,260,1,1,0.163,0.673,0.337,405
boiler,-0.205,32,58,1,1,0.561,0.59,0.509,90
piles,-0.205,84,151,1,1,0.469,0.423,0.468,235
reopen,-0.205,51,92,1,1,0.656,0.528,0.568,143
billion,-0.205,1244,2226,1,1,0.719,0.564,0.782,3470
swear,-0.205,7392,13224,1,1,0.601,0.577,0.658,20616
blessed,-0.205,3288,5884,1,1,0.91,0.279,0.696,9172
undue,-0.206,18,33,1,1,0.156,0.573,0.318,51
practise,-0.206,56,101,1,1,0.713,0.49,0.616,157
predisposed,-0.206,18,33,1,1,0.531,0.571,0.483,51
smallest,-0.206,403,722,1,1,0.281,0.34,0.129,1125
coffin,-0.206,194,348,1,1,0.073,0.432,0.343,542
format,-0.206,142,255,1,1,0.562,0.308,0.438,397
angered,-0.206,61,110,1,1,0.01,0.86,0.547,171
annoyed,-0.206,1955,3501,1,1,0.104,0.783,0.345,5456
temperament,-0.206,42,76,1,1,0.42,0.625,0.703,118
turbo,-0.206,42,76,1,1,0.583,0.729,0.596,118
economics,-0.207,114,205,1,1,0.625,0.481,0.632,319
chew,-0.207,186,334,1,1,0.52,0.49,0.404,520
talented,-0.207,1136,2036,1,1,0.939,0.635,0.938,3172
disengage,-0.207,23,42,1,1,0.406,0.529,0.304,65
whispered,-0.207,422,757,1,1,0.548,0.358,0.309,1179
bumpy,-0.207,76,137,1,1,0.306,0.683,0.419,213
deputy,-0.207,81,146,1,1,0.429,0.53,0.787,227
mindfulness,-0.207,110,198,1,1,0.729,0.635,0.745,308
wacko,-0.208,28,51,1,1,0.271,0.574,0.33,79
loss,-0.208,5036,9031,1,1,0.062,0.567,0.211,14067
unfortunate,-0.208,591,1061,1,1,0.073,0.487,0.195,1652
standard,-0.208,761,1366,1,1,0.673,0.143,0.605,2127
satisfactory,-0.208,33,60,1,1,0.959,0.569,0.702,93
contestant,-0.208,33,60,1,1,0.76,0.53,0.602,93
learner,-0.208,33,60,1,1,0.698,0.475,0.398,93
tribulation,-0.208,33,60,1,1,0.448,0.612,0.484,93
bunk,-0.209,121,218,1,1,0.438,0.332,0.339,339
agreeing,-0.209,204,367,1,1,0.854,0.48,0.557,571
hurricane,-0.209,302,543,1,1,0.177,0.958,0.787,845
slur,-0.209,43,78,1,1,0.115,0.814,0.427,121
knowingly,-0.209,92,166,1,1,0.5,0.459,0.481,258
grudge,-0.209,92,166,1,1,0.115,0.647,0.414,258
skill,-0.209,548,985,1,1,0.847,0.701,0.833,1533
optional,-0.209,107,193,1,1,0.755,0.35,0.44,300
supporter,-0.209,598,1075,1,1,0.721,0.51,0.698,1673
win,-0.209,5329,9574,1,1,0.927,0.694,0.888,14903
bowed,-0.21,58,105,1,1,0.41,0.418,0.368,163
value,-0.21,3174,5704,1,1,0.875,0.582,0.802,8878
received,-0.21,1274,2290,1,1,0.646,0.436,0.561,3564
supposed,-0.21,6038,10851,1,1,0.296,0.378,0.379,16889
space,-0.21,12867,23123,1,1,0.8,0.317,0.573,35990
prep,-0.211,242,436,1,1,0.688,0.509,0.555,678
goal,-0.211,2238,4026,1,1,0.83,0.356,0.669,6264
wheelchair,-0.211,153,276,1,1,0.24,0.337,0.245,429
fault,-0.211,4929,8869,1,1,0.188,0.558,0.184,13798
ludicrous,-0.211,49,89,1,1,0.137,0.553,0.274,138
veracity,-0.211,9,17,1,1,0.735,0.724,0.798,26
sinker,-0.211,14,26,1,1,0.302,0.557,0.538,40
falafel,-0.211,9,17,1,1,0.56,0.402,0.351,26
blackboard,-0.211,14,26,1,1,0.469,0.255,0.287,40
vigor,-0.211,19,35,1,1,0.86,0.755,0.811,54
tamper,-0.211,9,17,1,1,0.184,0.802,0.545,26
unglued,-0.211,9,17,1,1,0.378,0.446,0.352,26
tablet,-0.211,114,206,1,1,0.562,0.33,0.438,320
beady,-0.211,9,17,1,1,0.448,0.417,0.443,26
disastrous,-0.211,89,161,1,1,0.071,0.741,0.439,250
potluck,-0.211,14,26,1,1,0.621,0.561,0.433,40
paradoxical,-0.211,49,89,1,1,0.406,0.547,0.433,138
unharmed,-0.211,14,26,1,1,0.74,0.378,0.491,40
canton,-0.211,24,44,1,1,0.542,0.472,0.536,68
unwise,-0.211,24,44,1,1,0.141,0.61,0.304,68
fedup,-0.211,9,17,1,1,0.327,0.5,0.352,26
scratchy,-0.211,14,26,1,1,0.235,0.61,0.436,40
hurricanes,-0.211,39,71,1,1,0.286,0.898,0.784,110
usable,-0.211,9,17,1,1,0.812,0.455,0.611,26
priestly,-0.211,9,17,1,1,0.605,0.284,0.683,26
simplistic,-0.211,44,80,1,1,0.49,0.245,0.391,124
specialty,-0.211,59,107,1,1,0.724,0.479,0.783,166
pushing,-0.211,2825,5086,1,1,0.396,0.644,0.731,7911
mission,-0.212,1257,2264,1,1,0.765,0.633,0.87,3521
threaten,-0.212,245,442,1,1,0.104,0.958,0.59,687
admiration,-0.212,210,379,1,1,0.969,0.583,0.726,589
practically,-0.212,623,1123,1,1,0.622,0.402,0.588,1746
screw,-0.212,669,1206,1,1,0.385,0.46,0.377,1875
deplorable,-0.212,115,208,1,1,0.135,0.657,0.23,323
admired,-0.212,216,390,1,1,0.917,0.56,0.815,606
unite,-0.213,519,936,1,1,0.781,0.375,0.61,1455
countless,-0.213,711,1282,1,1,0.52,0.566,0.534,1993
phone,-0.213,16780,30242,1,1,0.729,0.344,0.418,47022
required,-0.213,576,1039,1,1,0.583,0.509,0.7,1615
sleeper,-0.213,70,127,1,1,0.64,0.154,0.254,197
designed,-0.213,892,1609,1,1,0.745,0.38,0.595,2501
slam,-0.213,162,293,1,1,0.459,0.577,0.48,455
biblical,-0.214,96,174,1,1,0.635,0.304,0.712,270
minuscule,-0.214,45,82,1,1,0.396,0.286,0.214,127
stealth,-0.214,45,82,1,1,0.52,0.27,0.452,127
protecting,-0.214,685,1237,1,1,0.878,0.558,0.832,1922
christ,-0.214,2682,4842,1,1,0.781,0.51,0.75,7524
poisoned,-0.214,112,203,1,1,0.057,0.808,0.402,315
doctor,-0.215,2308,4168,1,1,0.7,0.531,0.861,6476
counts,-0.215,498,900,1,1,0.343,0.373,0.5,1398
experienced,-0.215,2938,5306,1,1,0.771,0.613,0.914,8244
endorse,-0.215,61,111,1,1,0.592,0.392,0.472,172
malevolent,-0.215,30,55,1,1,0.094,0.854,0.613,85
disappointing,-0.215,588,1063,1,1,0.073,0.64,0.2,1651
diet,-0.215,584,1056,1,1,0.429,0.235,0.398,1640
extension,-0.215,139,252,1,1,0.49,0.51,0.529,391
runny,-0.216,25,46,1,1,0.54,0.439,0.325,71
comrade,-0.216,228,413,1,1,0.781,0.412,0.804,641
honey,-0.216,2670,4831,1,1,0.92,0.431,0.51,7501
compile,-0.217,20,37,1,1,0.6,0.413,0.519,57
underpants,-0.217,20,37,1,1,0.448,0.473,0.276,57
neutrality,-0.217,20,37,1,1,0.469,0.205,0.434,57
commemorate,-0.217,20,37,1,1,0.812,0.602,0.636,57
wanting,-0.217,12967,23465,1,1,0.76,0.433,0.593,36432
pissed,-0.217,1607,2909,1,1,0.102,0.888,0.543,4516
undo,-0.217,147,267,1,1,0.365,0.444,0.349,414
blast,-0.218,968,1754,1,1,0.167,0.929,0.777,2722
compensation,-0.218,84,153,1,1,0.775,0.469,0.598,237
finance,-0.218,159,289,1,1,0.753,0.431,0.843,448
convent,-0.218,15,28,1,1,0.48,0.217,0.594,43
bombers,-0.218,15,28,1,1,0.173,0.92,0.787,43
orderly,-0.218,15,28,1,1,0.844,0.24,0.661,43
interdependent,-0.218,15,28,1,1,0.41,0.482,0.598,43
frustrate,-0.218,47,86,1,1,0.1,0.809,0.243,133
contention,-0.218,31,57,1,1,0.375,0.51,0.738,88
yam,-0.219,58,106,1,1,0.5,0.206,0.152,164
horrible,-0.219,4912,8910,1,1,0.071,0.857,0.398,13822
dependant,-0.219,85,155,1,1,0.357,0.404,0.451,240
imperative,-0.219,85,155,1,1,0.625,0.647,0.708,240
ill,-0.219,8801,15967,1,1,0.073,0.41,0.2,24768
traitor,-0.219,451,819,1,1,0.112,0.796,0.491,1270
handicapped,-0.219,69,126,1,1,0.204,0.467,0.18,195
snort,-0.219,69,126,1,1,0.469,0.531,0.413,195
alongside,-0.22,528,959,1,1,0.458,0.333,0.347,1487
extortion,-0.22,26,48,1,1,0.112,0.868,0.63,74
brazen,-0.22,26,48,1,1,0.292,0.64,0.518,74
unjustified,-0.22,26,48,1,1,0.288,0.541,0.314,74
outstretched,-0.22,26,48,1,1,0.448,0.481,0.519,74
manager,-0.22,837,1520,1,1,0.625,0.549,0.897,2357
deem,-0.22,75,137,1,1,0.594,0.529,0.69,212
erasure,-0.22,37,68,1,1,0.281,0.36,0.265,105
gut,-0.22,602,1094,1,1,0.408,0.367,0.364,1696
dint,-0.22,86,157,1,1,0.378,0.48,0.492,243
court,-0.221,1182,2148,1,1,0.479,0.769,0.827,3330
demonstrated,-0.221,70,128,1,1,0.617,0.5,0.649,198
excel,-0.221,103,188,1,1,0.561,0.363,0.466,291
lifted,-0.221,454,826,1,1,0.714,0.441,0.657,1280
changing,-0.221,1976,3593,1,1,0.571,0.569,0.461,5569
measles,-0.222,21,39,1,1,0.092,0.635,0.422,60
menstrual,-0.222,32,59,1,1,0.408,0.519,0.435,91
blockage,-0.222,10,19,1,1,0.25,0.608,0.444,29
redwood,-0.222,10,19,1,1,0.592,0.35,0.443,29
dissuade,-0.222,10,19,1,1,0.482,0.5,0.35,29
tingle,-0.222,32,59,1,1,0.46,0.56,0.264,91
mortuary,-0.222,10,19,1,1,0.133,0.606,0.427,29
fondling,-0.222,10,19,1,1,0.794,0.564,0.5,29
goner,-0.222,32,59,1,1,0.41,0.461,0.274,91
compress,-0.222,10,19,1,1,0.406,0.412,0.46,29
sanctified,-0.222,10,19,1,1,0.792,0.24,0.612,29
loosening,-0.222,10,19,1,1,0.378,0.343,0.295,29
ruffle,-0.222,21,39,1,1,0.443,0.561,0.518,60
cleave,-0.222,10,19,1,1,0.296,0.545,0.389,29
spatula,-0.222,10,19,1,1,0.302,0.198,0.369,29
curtain,-0.222,175,319,1,1,0.698,0.278,0.304,494
substandard,-0.222,10,19,1,1,0.235,0.333,0.15,29
outbreak,-0.222,32,59,1,1,0.26,0.632,0.472,91
paternity,-0.222,10,19,1,1,0.704,0.59,0.806,29
dictate,-0.222,203,370,1,1,0.48,0.423,0.668,573
consult,-0.222,104,190,1,1,0.755,0.37,0.441,294
jump,-0.222,2117,3852,1,1,0.625,0.865,0.611,5969
ted,-0.222,1111,2022,1,1,0.712,0.453,0.336,3133
humanitarian,-0.222,82,150,1,1,0.786,0.317,0.709,232
hard,-0.222,47644,86696,1,1,0.302,0.708,0.616,134340
arise,-0.222,171,312,1,1,0.75,0.582,0.725,483
diplomatic,-0.223,49,90,1,1,0.653,0.363,0.918,139
affordable,-0.223,199,363,1,1,0.84,0.398,0.493,562
battery,-0.223,444,809,1,1,0.48,0.425,0.442,1253
girly,-0.223,255,465,1,1,0.595,0.462,0.371,720
instructor,-0.223,77,141,1,1,0.771,0.49,0.782,218
abolish,-0.223,38,70,1,1,0.448,0.615,0.529,108
invalid,-0.223,144,263,1,1,0.18,0.33,0.255,407
asset,-0.223,144,263,1,1,0.797,0.765,0.788,407
discretion,-0.223,27,50,1,1,0.552,0.32,0.685,77
assembled,-0.223,27,50,1,1,0.663,0.45,0.644,77
bungalow,-0.223,27,50,1,1,0.562,0.352,0.406,77
anesthesia,-0.223,27,50,1,1,0.365,0.216,0.394,77
absorb,-0.224,134,245,1,1,0.469,0.558,0.67,379
coworker,-0.224,798,1455,1,1,0.667,0.49,0.625,2253
powerful,-0.224,3207,5845,1,1,0.865,0.83,0.991,9052
amazingly,-0.224,202,369,1,1,0.918,0.765,0.92,571
police,-0.224,2070,3774,1,1,0.458,0.77,0.83,5844
responsibility,-0.224,1253,2285,1,1,0.76,0.5,0.852,3538
deficit,-0.224,67,123,1,1,0.358,0.5,0.269,190
custodian,-0.224,16,30,1,1,0.594,0.625,0.528,46
headquarters,-0.224,33,61,1,1,0.615,0.271,0.525,94
disprove,-0.224,16,30,1,1,0.375,0.625,0.613,46
resemblance,-0.224,50,92,1,1,0.743,0.216,0.57,142
activation,-0.224,16,30,1,1,0.781,0.8,0.754,46
renovation,-0.224,16,30,1,1,0.816,0.59,0.779,46
cumbersome,-0.224,16,30,1,1,0.259,0.623,0.292,46
spread,-0.224,2335,4259,1,1,0.57,0.583,0.651,6594
ankle,-0.225,158,289,1,1,0.5,0.274,0.234,447
draft,-0.225,347,634,1,1,0.438,0.36,0.351,981
operate,-0.225,176,322,1,1,0.582,0.69,0.691,498
monitor,-0.225,176,322,1,1,0.49,0.298,0.538,498
instill,-0.225,39,72,1,1,0.562,0.49,0.618,111
amend,-0.226,22,41,1,1,0.688,0.406,0.658,63
hostel,-0.226,206,377,1,1,0.479,0.5,0.398,583
portfolio,-0.226,68,125,1,1,0.625,0.28,0.498,193
cancer,-0.226,2840,5188,1,1,0.052,0.694,0.529,8028
lifesaver,-0.226,51,94,1,1,0.908,0.745,0.703,145
ponder,-0.226,213,390,1,1,0.74,0.38,0.689,603
floor,-0.226,3096,5658,1,1,0.43,0.23,0.25,8754
aid,-0.227,573,1048,1,1,0.796,0.491,0.541,1621
import,-0.227,57,105,1,1,0.615,0.48,0.623,162
differently,-0.227,1166,2132,1,1,0.48,0.431,0.506,3298
gigantic,-0.227,121,222,1,1,0.75,0.776,0.921,343
knee,-0.227,400,732,1,1,0.52,0.245,0.396,1132
brunt,-0.227,34,63,1,1,0.204,0.75,0.349,97
autism,-0.227,543,994,1,1,0.235,0.5,0.447,1537
rebuild,-0.228,239,438,1,1,0.656,0.557,0.519,677
enlightening,-0.228,81,149,1,1,0.825,0.729,0.727,230
caste,-0.228,46,85,1,1,0.51,0.333,0.374,131
conservative,-0.228,1048,1919,1,1,0.615,0.316,0.788,2967
disservice,-0.228,58,107,1,1,0.25,0.794,0.48,165
consensual,-0.228,58,107,1,1,0.663,0.417,0.655,165
communism,-0.229,76,140,1,1,0.264,0.57,0.623,216
require,-0.229,634,1162,1,1,0.398,0.439,0.56,1796
babysit,-0.229,160,294,1,1,0.719,0.587,0.398,454
showing,-0.229,3714,6806,1,1,0.622,0.54,0.491,10520
surrounding,-0.229,1282,2350,1,1,0.531,0.422,0.669,3632
speech,-0.229,1163,2132,1,1,0.656,0.47,0.688,3295
plenty,-0.229,2912,5337,1,1,0.827,0.612,0.824,8249
uneasy,-0.229,280,514,1,1,0.115,0.598,0.349,794
minute,-0.23,4190,7681,1,1,0.582,0.279,0.356,11871
opposing,-0.23,125,230,1,1,0.188,0.66,0.518,355
multiply,-0.23,83,153,1,1,0.802,0.625,0.777,236
reinforcements,-0.23,23,43,1,1,0.646,0.719,0.875,66
algebra,-0.23,35,65,1,1,0.44,0.34,0.565,100
saintly,-0.23,11,21,1,1,0.865,0.286,0.591,32
drugstore,-0.23,11,21,1,1,0.49,0.343,0.518,32
oligarchy,-0.23,11,21,1,1,0.327,0.567,0.741,32
misrepresent,-0.23,11,21,1,1,0.198,0.542,0.418,32
junkie,-0.23,101,186,1,1,0.135,0.86,0.363,287
designate,-0.23,11,21,1,1,0.531,0.538,0.683,32
entail,-0.23,17,32,1,1,0.484,0.63,0.645,49
cleansing,-0.23,77,142,1,1,0.729,0.298,0.472,219
bending,-0.23,71,131,1,1,0.448,0.565,0.455,202
interrupted,-0.23,179,329,1,1,0.281,0.559,0.333,508
crust,-0.23,47,87,1,1,0.542,0.337,0.456,134
unguarded,-0.23,11,21,1,1,0.156,0.578,0.205,32
hogwash,-0.23,11,21,1,1,0.42,0.49,0.361,32
icing,-0.23,71,131,1,1,0.688,0.452,0.411,202
provisions,-0.23,17,32,1,1,0.67,0.51,0.642,49
remiss,-0.23,11,21,1,1,0.19,0.65,0.325,32
punish,-0.23,209,384,1,1,0.061,0.808,0.61,593
stunned,-0.23,107,197,1,1,0.306,0.663,0.356,304
cable,-0.23,324,595,1,1,0.583,0.245,0.434,919
fart,-0.23,553,1015,1,1,0.194,0.439,0.264,1568
warren,-0.23,240,441,1,1,0.417,0.57,0.464,681
widespread,-0.231,126,232,1,1,0.633,0.456,0.713,358
legacy,-0.231,495,909,1,1,0.792,0.529,0.827,1404
accomplished,-0.231,483,887,1,1,0.87,0.52,0.798,1370
restore,-0.231,345,634,1,1,0.765,0.49,0.625,979
nod,-0.231,333,612,1,1,0.59,0.367,0.427,945
nudge,-0.231,72,133,1,1,0.448,0.5,0.509,205
fasting,-0.231,145,267,1,1,0.388,0.37,0.394,412
scrutiny,-0.231,66,122,1,1,0.5,0.653,0.658,188
exaggeration,-0.231,60,111,1,1,0.312,0.775,0.582,171
unfair,-0.231,915,1681,1,1,0.173,0.472,0.19,2596
hospital,-0.232,2747,5046,1,1,0.323,0.537,0.598,7793
daredevil,-0.232,48,89,1,1,0.429,0.714,0.653,137
detriment,-0.232,48,89,1,1,0.281,0.538,0.263,137
program,-0.232,950,1746,1,1,0.561,0.323,0.713,2696
proven,-0.232,645,1186,1,1,0.724,0.311,0.611,1831
available,-0.232,3219,5916,1,1,0.844,0.356,0.623,9135
disturbance,-0.232,73,135,1,1,0.146,0.907,0.404,208
intuition,-0.232,135,249,1,1,0.857,0.508,0.602,384
battlefield,-0.233,166,306,1,1,0.133,0.918,0.781,472
sufficient,-0.233,290,534,1,1,0.833,0.33,0.588,824
modified,-0.233,30,56,1,1,0.561,0.458,0.693,86
cornerstone,-0.233,30,56,1,1,0.55,0.388,0.596,86
domesticated,-0.233,30,56,1,1,0.635,0.36,0.294,86
papyrus,-0.233,30,56,1,1,0.459,0.24,0.324,86
stranger,-0.233,3948,7263,1,1,0.33,0.449,0.302,11211
religion,-0.233,1137,2093,1,1,0.646,0.32,0.755,3230
sexuality,-0.234,751,1383,1,1,0.67,0.898,0.657,2134
childbirth,-0.234,43,80,1,1,0.604,0.861,0.673,123
alerts,-0.234,62,115,1,1,0.337,0.804,0.673,177
respiratory,-0.235,18,34,1,1,0.5,0.45,0.552,52
zap,-0.235,18,34,1,1,0.385,0.438,0.371,52
bathtub,-0.235,139,257,1,1,0.625,0.24,0.318,396
demonstration,-0.235,50,93,1,1,0.551,0.676,0.679,143
take,-0.235,59409,109512,1,1,0.828,0.537,0.348,168921
detention,-0.235,114,211,1,1,0.265,0.698,0.562,325
maneuver,-0.235,31,58,1,1,0.615,0.663,0.608,89
armor,-0.235,191,353,1,1,0.469,0.625,0.784,544
certain,-0.236,4902,9041,1,1,0.76,0.358,0.673,13943
spineless,-0.236,121,224,1,1,0.344,0.387,0.321,345
concede,-0.236,44,82,1,1,0.67,0.324,0.473,126
adapt,-0.236,367,678,1,1,0.74,0.355,0.551,1045
unsupported,-0.236,122,226,1,1,0.26,0.45,0.221,348
accursed,-0.237,12,23,1,1,0.135,0.745,0.345,35
underhanded,-0.237,12,23,1,1,0.188,0.415,0.527,35
arsonist,-0.237,12,23,1,1,0.348,0.84,0.5,35
bloodshot,-0.237,12,23,1,1,0.188,0.81,0.482,35
disobedience,-0.237,25,47,1,1,0.051,0.868,0.369,72
affront,-0.237,12,23,1,1,0.327,0.74,0.547,35
splurge,-0.237,25,47,1,1,0.365,0.481,0.542,72
puma,-0.237,12,23,1,1,0.615,0.704,0.561,35
navel,-0.237,12,23,1,1,0.448,0.261,0.276,35
sensibly,-0.237,12,23,1,1,0.786,0.337,0.396,35
equitable,-0.237,12,23,1,1,0.714,0.286,0.75,35
demand,-0.237,708,1308,1,1,0.292,0.673,0.5,2016
internship,-0.237,175,324,1,1,0.59,0.51,0.482,499
arena,-0.237,306,566,1,1,0.51,0.235,0.404,872
opening,-0.237,2110,3898,1,1,0.667,0.51,0.62,6008
million,-0.237,3563,6583,1,1,0.776,0.647,0.812,10146
debit,-0.237,58,108,1,1,0.333,0.4,0.474,166
news,-0.237,5946,10986,1,1,0.633,0.58,0.61,16932
ability,-0.238,1893,3499,1,1,0.875,0.51,0.816,5392
confront,-0.238,295,546,1,1,0.281,0.76,0.746,841
stair,-0.238,32,60,1,1,0.375,0.354,0.345,92
malignant,-0.238,72,134,1,1,0.143,0.824,0.37,206
pajama,-0.239,39,73,1,1,0.908,0.157,0.245,112
taint,-0.239,39,73,1,1,0.141,0.425,0.226,112
strategic,-0.239,79,147,1,1,0.786,0.708,0.861,226
complicate,-0.239,39,73,1,1,0.21,0.657,0.404,112
nosebleed,-0.239,19,36,1,1,0.153,0.776,0.361,55
determine,-0.239,253,469,1,1,0.612,0.368,0.776,722
breakdown,-0.239,1565,2897,1,1,0.365,0.423,0.361,4462
dilemma,-0.239,348,645,1,1,0.153,0.59,0.43,993
honor,-0.24,1021,1891,1,1,0.896,0.587,0.857,2912
repeatedly,-0.24,464,860,1,1,0.479,0.575,0.5,1324
outcry,-0.24,26,49,1,1,0.271,0.773,0.718,75
unacknowledged,-0.24,26,49,1,1,0.24,0.269,0.116,75
circulation,-0.24,26,49,1,1,0.735,0.52,0.657,75
heartily,-0.24,26,49,1,1,0.927,0.531,0.664,75
bother,-0.24,3935,7290,1,1,0.208,0.78,0.37,11225
abhor,-0.24,33,62,1,1,0.125,0.602,0.349,95
pesky,-0.241,40,75,1,1,0.25,0.76,0.431,115
may,-0.241,32966,61125,1,1,0.704,0.273,0.245,94091
practice,-0.241,1776,3294,1,1,0.684,0.582,0.639,5070
doubts,-0.241,576,1069,1,1,0.306,0.448,0.305,1645
agreed,-0.241,1313,2436,1,1,0.797,0.449,0.574,3749
socialist,-0.241,343,637,1,1,0.448,0.4,0.543,980
jar,-0.241,405,752,1,1,0.43,0.346,0.318,1157
illogical,-0.242,68,127,1,1,0.208,0.63,0.251,195
hatch,-0.242,75,140,1,1,0.479,0.653,0.402,215
juggling,-0.242,75,140,1,1,0.562,0.874,0.346,215
instinct,-0.242,269,500,1,1,0.771,0.602,0.642,769
discriminate,-0.242,145,270,1,1,0.125,0.761,0.366,415
war,-0.242,3389,6292,1,1,0.022,0.892,0.727,9681
diabetes,-0.242,208,387,1,1,0.051,0.472,0.279,595
compulsory,-0.243,48,90,1,1,0.343,0.541,0.791,138
restoring,-0.243,48,90,1,1,0.82,0.49,0.783,138
fixable,-0.243,27,51,1,1,0.724,0.47,0.645,78
mouthful,-0.243,20,38,1,1,0.609,0.565,0.389,58
tuition,-0.243,83,155,1,1,0.531,0.372,0.436,238
befuddled,-0.243,13,25,1,1,0.156,0.714,0.269,38
deportation,-0.243,20,38,1,1,0.104,0.786,0.45,58
swearing,-0.243,118,220,1,1,0.333,0.559,0.586,338
bombing,-0.243,55,103,1,1,0.167,0.963,0.732,158
genetics,-0.243,55,103,1,1,0.552,0.46,0.574,158
christian,-0.243,1662,3088,1,1,0.76,0.241,0.591,4750
arrest,-0.243,217,404,1,1,0.146,0.951,0.5,621
point,-0.243,20992,39006,1,1,0.49,0.193,0.431,59998
native,-0.243,380,707,1,1,0.635,0.422,0.71,1087
pants,-0.244,1333,2479,1,1,0.673,0.32,0.333,3812
currency,-0.244,99,185,1,1,0.583,0.418,0.592,284
proverbial,-0.244,42,79,1,1,0.583,0.43,0.697,121
prying,-0.244,42,79,1,1,0.385,0.647,0.547,121
slit,-0.244,85,159,1,1,0.406,0.49,0.366,244
missy,-0.244,85,159,1,1,0.521,0.48,0.333,244
wont,-0.245,7054,13125,1,1,0.24,0.343,0.291,20179
prepared,-0.245,1494,2781,1,1,0.71,0.48,0.733,4275
jot,-0.245,35,66,1,1,0.406,0.323,0.35,101
smaller,-0.245,699,1302,1,1,0.3,0.31,0.179,2001
appointments,-0.245,230,429,1,1,0.745,0.677,0.625,659
defamation,-0.245,28,53,1,1,0.11,0.67,0.481,81
foliage,-0.245,28,53,1,1,0.62,0.373,0.237,81
belongings,-0.246,79,148,1,1,0.592,0.38,0.75,227
petrol,-0.246,50,94,1,1,0.418,0.519,0.577,144
spiked,-0.246,50,94,1,1,0.281,0.613,0.407,144
dreading,-0.246,298,556,1,1,0.125,0.76,0.377,854
din,-0.246,488,910,1,1,0.44,0.417,0.398,1398
uplifting,-0.246,314,586,1,1,0.771,0.548,0.605,900
fair,-0.246,3260,6076,1,1,0.812,0.557,0.643,9336
pant,-0.246,43,81,1,1,0.448,0.463,0.409,124
chancellor,-0.246,21,40,1,1,0.646,0.5,0.887,61
relapse,-0.246,190,355,1,1,0.173,0.46,0.303,545
ticket,-0.246,1530,2853,1,1,0.684,0.387,0.434,4383
carrying,-0.247,796,1485,1,1,0.656,0.557,0.443,2281
rely,-0.247,1683,3139,1,1,0.812,0.429,0.616,4822
postponed,-0.247,36,68,1,1,0.439,0.327,0.402,104
stock,-0.247,526,982,1,1,0.594,0.418,0.407,1508
unique,-0.247,1686,3146,1,1,0.823,0.347,0.661,4832
hike,-0.247,222,415,1,1,0.615,0.442,0.538,637
suicidal,-0.247,2876,5367,1,1,0.021,0.867,0.382,8243
lord,-0.247,7460,13920,1,1,0.618,0.327,0.684,21380
theft,-0.247,96,180,1,1,0.135,0.867,0.394,276
accept,-0.248,6790,12674,1,1,0.847,0.286,0.565,19464
peopled,-0.248,14,27,1,1,0.594,0.45,0.679,41
berth,-0.248,14,27,1,1,0.295,0.337,0.596,41
litigation,-0.248,14,27,1,1,0.388,0.76,0.602,41
mascara,-0.248,44,83,1,1,0.575,0.45,0.269,127
headway,-0.248,14,27,1,1,0.823,0.464,0.745,41
unlock,-0.248,142,266,1,1,0.582,0.442,0.592,408
bra,-0.248,413,772,1,1,0.672,0.529,0.509,1185
teach,-0.248,2461,4597,1,1,0.84,0.51,0.852,7058
continual,-0.249,37,70,1,1,0.5,0.423,0.685,107
interrupts,-0.249,37,70,1,1,0.204,0.545,0.389,107
motor,-0.249,75,141,1,1,0.531,0.551,0.648,216
girlie,-0.249,106,199,1,1,0.604,0.54,0.409,305
alert,-0.249,597,1117,1,1,0.479,0.82,0.648,1714
adage,-0.249,22,42,1,1,0.517,0.415,0.566,64
endanger,-0.249,22,42,1,1,0.115,0.885,0.404,64
overstate,-0.249,22,42,1,1,0.281,0.779,0.635,64
independent,-0.25,3633,6795,1,1,0.885,0.44,0.872,10428
genetic,-0.25,107,201,1,1,0.562,0.288,0.726,308
lukewarm,-0.25,53,100,1,1,0.573,0.3,0.241,153
barricade,-0.25,53,100,1,1,0.323,0.667,0.673,153
timing,-0.25,533,998,1,1,0.521,0.311,0.577,1531
sink,-0.251,1239,2320,1,1,0.375,0.439,0.322,3559
quiver,-0.251,38,72,1,1,0.32,0.452,0.335,110
injection,-0.251,46,87,1,1,0.281,0.741,0.518,133
almond,-0.251,54,102,1,1,0.698,0.183,0.314,156
abound,-0.251,54,102,1,1,0.704,0.49,0.681,156
mesh,-0.251,70,132,1,1,0.429,0.235,0.371,202
worship,-0.252,719,1348,1,1,0.688,0.38,0.573,2067
shower,-0.252,2927,5485,1,1,0.669,0.346,0.336,8412
technique,-0.252,110,207,1,1,0.76,0.414,0.593,317
treadmill,-0.252,63,119,1,1,0.459,0.636,0.436,182
liable,-0.252,31,59,1,1,0.656,0.519,0.821,90
aboriginal,-0.252,15,29,1,1,0.448,0.427,0.542,44
coating,-0.252,23,44,1,1,0.62,0.44,0.596,67
rejoin,-0.252,47,89,1,1,0.655,0.548,0.556,136
brake,-0.252,71,134,1,1,0.312,0.481,0.31,205
infernal,-0.252,23,44,1,1,0.083,0.837,0.571,67
drawers,-0.252,47,89,1,1,0.539,0.26,0.236,136
knowledgeable,-0.252,71,134,1,1,0.865,0.455,0.971,205
regression,-0.252,31,59,1,1,0.312,0.5,0.324,90
dosage,-0.252,31,59,1,1,0.344,0.45,0.49,90
suspicion,-0.253,136,256,1,1,0.204,0.711,0.377,392
refreshed,-0.253,96,181,1,1,0.91,0.377,0.48,277
veggie,-0.253,72,136,1,1,0.602,0.245,0.409,208
compromise,-0.254,586,1101,1,1,0.677,0.52,0.805,1687
overpower,-0.254,40,76,1,1,0.448,0.859,0.783,116
approved,-0.254,155,292,1,1,0.833,0.349,0.698,447
fact,-0.254,16247,30523,1,1,0.683,0.333,0.618,46770
conducive,-0.254,32,61,1,1,0.775,0.479,0.679,93
impractical,-0.254,32,61,1,1,0.16,0.373,0.291,93
trillion,-0.254,90,170,1,1,0.592,0.42,0.623,260
dad,-0.255,10775,20249,1,1,0.857,0.412,0.786,31024
deceitful,-0.255,57,108,1,1,0.071,0.788,0.371,165
insensitive,-0.255,223,420,1,1,0.219,0.471,0.302,643
presidential,-0.255,224,422,1,1,0.612,0.656,0.972,646
granola,-0.255,24,46,1,1,0.625,0.24,0.281,70
obliterated,-0.255,24,46,1,1,0.24,0.469,0.344,70
boldness,-0.255,24,46,1,1,0.806,0.684,0.814,70
tampon,-0.255,24,46,1,1,0.396,0.394,0.345,70
syndicate,-0.255,24,46,1,1,0.439,0.491,0.673,70
leper,-0.255,24,46,1,1,0.075,0.589,0.206,70
soda,-0.256,226,426,1,1,0.688,0.314,0.364,652
awesome,-0.256,4490,8450,1,1,0.98,0.897,0.891,12940
frontal,-0.256,16,31,1,1,0.459,0.434,0.526,47
menial,-0.256,16,31,1,1,0.49,0.42,0.352,47
visibly,-0.256,84,159,1,1,0.724,0.373,0.591,243
precisely,-0.256,220,415,1,1,0.816,0.388,0.714,635
yolk,-0.256,16,31,1,1,0.49,0.306,0.28,47
unconcerned,-0.256,16,31,1,1,0.562,0.283,0.298,47
ongoing,-0.256,323,609,1,1,0.674,0.484,0.556,932
sprint,-0.257,76,144,1,1,0.549,0.649,0.528,220
buffer,-0.257,42,80,1,1,0.52,0.474,0.35,122
covenant,-0.257,42,80,1,1,0.594,0.462,0.667,122
nuke,-0.257,42,80,1,1,0.125,0.905,0.873,122
renew,-0.257,120,227,1,1,0.868,0.481,0.713,347
delayed,-0.257,181,342,1,1,0.188,0.49,0.216,523
ammo,-0.257,51,97,1,1,0.323,0.765,0.621,148
sightseeing,-0.257,25,48,1,1,0.875,0.552,0.697,73
plumbing,-0.258,34,65,1,1,0.469,0.427,0.441,99
cellular,-0.258,34,65,1,1,0.643,0.398,0.517,99
refusal,-0.258,96,182,1,1,0.052,0.61,0.321,278
variation,-0.259,52,99,1,1,0.635,0.561,0.406,151
correct,-0.259,1584,2992,1,1,0.857,0.306,0.723,4576
doubt,-0.259,4236,8000,1,1,0.395,0.351,0.231,12236
withhold,-0.26,26,50,1,1,0.32,0.451,0.444,76
faze,-0.26,71,135,1,1,0.417,0.515,0.382,206
medicinal,-0.26,17,33,1,1,0.667,0.417,0.614,50
wobbly,-0.26,26,50,1,1,0.208,0.759,0.225,76
standby,-0.26,53,101,1,1,0.26,0.224,0.386,154
motto,-0.26,179,339,1,1,0.688,0.317,0.439,518
gospel,-0.26,360,681,1,1,0.74,0.333,0.58,1041
rate,-0.26,1290,2438,1,1,0.521,0.297,0.407,3728
maintenance,-0.26,261,494,1,1,0.592,0.41,0.545,755
hope,-0.26,49640,93803,1,1,0.927,0.317,0.739,143443
fellow,-0.26,3167,5987,1,1,0.745,0.298,0.57,9154
things,-0.261,57436,108587,1,1,0.519,0.25,0.368,166023
insists,-0.261,118,224,1,1,0.49,0.587,0.61,342
belittle,-0.261,137,260,1,1,0.122,0.417,0.25,397
worse,-0.261,11495,21744,1,1,0.062,0.704,0.225,33239
flag,-0.261,692,1310,1,1,0.592,0.378,0.536,2002
conditional,-0.261,36,69,1,1,0.521,0.343,0.556,105
displeasure,-0.261,36,69,1,1,0.115,0.559,0.25,105
meantime,-0.262,380,720,1,1,0.432,0.222,0.3,1100
compelled,-0.262,157,298,1,1,0.333,0.654,0.347,455
bureau,-0.262,27,52,1,1,0.562,0.373,0.618,79
ally,-0.262,431,817,1,1,0.792,0.32,0.688,1248
holler,-0.262,93,177,1,1,0.276,0.825,0.406,270
manifesto,-0.262,93,177,1,1,0.646,0.519,0.676,270
opponent,-0.262,140,266,1,1,0.08,0.741,0.716,406
contradict,-0.262,46,88,1,1,0.16,0.598,0.482,134
message,-0.263,9162,17360,1,1,0.65,0.391,0.415,26522
claustrophobia,-0.263,37,71,1,1,0.125,0.84,0.333,108
keel,-0.263,18,35,1,1,0.344,0.417,0.419,53
trample,-0.263,18,35,1,1,0.235,0.764,0.562,53
holyspirit,-0.263,18,35,1,1,0.74,0.48,0.526,53
standing,-0.263,4434,8403,1,1,0.604,0.317,0.425,12837
observation,-0.263,267,507,1,1,0.633,0.433,0.667,774
flinch,-0.263,47,90,1,1,0.35,0.804,0.555,137
telling,-0.264,9007,17083,1,1,0.719,0.441,0.527,26090
disability,-0.264,619,1175,1,1,0.073,0.482,0.173,1794
episode,-0.264,4274,8109,1,1,0.719,0.367,0.509,12383
healthy,-0.264,4298,8156,1,1,0.938,0.319,0.818,12454
power,-0.264,7133,13537,1,1,0.719,0.67,0.953,20670
ridiculed,-0.264,146,278,1,1,0.112,0.806,0.212,424
ripple,-0.265,58,111,1,1,0.5,0.453,0.37,169
congressman,-0.265,58,111,1,1,0.438,0.471,0.877,169
holocaust,-0.265,88,168,1,1,0.062,0.918,0.618,256
thing,-0.265,53132,100910,1,1,0.449,0.222,0.26,154042
contradictory,-0.266,89,170,1,1,0.365,0.651,0.421,259
throng,-0.266,9,18,1,1,0.48,0.81,0.706,27
apostasy,-0.266,9,18,1,1,0.388,0.52,0.517,27
separatist,-0.266,9,18,1,1,0.245,0.627,0.537,27
stationary,-0.266,39,75,1,1,0.408,0.24,0.484,114
infiltration,-0.266,9,18,1,1,0.265,0.792,0.536,27
artery,-0.266,9,18,1,1,0.396,0.58,0.537,27
supplies,-0.266,199,379,1,1,0.698,0.39,0.595,578
accord,-0.266,49,94,1,1,0.898,0.264,0.382,143
mustard,-0.266,79,151,1,1,0.5,0.346,0.275,230
taker,-0.266,49,94,1,1,0.375,0.521,0.618,143
bloat,-0.266,9,18,1,1,0.229,0.694,0.298,27
frosting,-0.266,29,56,1,1,0.823,0.48,0.424,85
northwestern,-0.266,9,18,1,1,0.479,0.306,0.462,27
aware,-0.266,2807,5335,1,1,0.656,0.34,0.77,8142
nag,-0.266,241,459,1,1,0.271,0.451,0.472,700
forces,-0.266,777,1478,1,1,0.551,0.686,0.886,2255
energy,-0.266,7113,13525,1,1,0.944,0.725,0.868,20638
troubles,-0.266,699,1330,1,1,0.051,0.854,0.269,2029
footing,-0.267,40,77,1,1,0.76,0.346,0.464,117
cooperate,-0.267,61,117,1,1,0.898,0.451,0.582,178
apparel,-0.268,20,39,1,1,0.698,0.435,0.453,59
realization,-0.268,1087,2072,1,1,0.554,0.51,0.836,3159
beginner,-0.269,31,60,1,1,0.49,0.48,0.387,91
possible,-0.269,5577,10635,1,1,0.688,0.316,0.548,16212
dome,-0.269,203,388,1,1,0.62,0.398,0.509,591
surname,-0.269,42,81,1,1,0.67,0.25,0.493,123
comet,-0.27,64,123,1,1,0.704,0.679,0.471,187
manners,-0.27,185,354,1,1,0.816,0.284,0.517,539
staff,-0.27,1575,3007,1,1,0.745,0.274,0.627,4582
genealogy,-0.27,10,20,1,1,0.479,0.37,0.644,30
volatility,-0.27,10,20,1,1,0.281,0.755,0.553,30
barrister,-0.27,10,20,1,1,0.469,0.57,0.792,30
fanaticism,-0.27,10,20,1,1,0.292,0.896,0.566,30
discernment,-0.27,54,104,1,1,0.408,0.471,0.694,158
indecency,-0.27,10,20,1,1,0.135,0.67,0.491,30
arbiter,-0.27,10,20,1,1,0.561,0.537,0.814,30
equilibrium,-0.27,21,41,1,1,0.676,0.235,0.62,62
unaccountable,-0.27,10,20,1,1,0.18,0.6,0.543,30
god,-0.27,53980,103063,1,1,0.758,0.518,0.886,157043
willing,-0.271,4571,8730,1,1,0.833,0.561,0.783,13301
loo,-0.271,88,169,1,1,0.385,0.357,0.283,257
common,-0.271,3911,7472,1,1,0.6,0.127,0.318,11383
wrong,-0.271,23337,44594,1,1,0.042,0.582,0.48,67931
examine,-0.272,112,215,1,1,0.615,0.623,0.786,327
deathbed,-0.272,67,129,1,1,0.051,0.652,0.311,196
nationality,-0.272,56,108,1,1,0.642,0.4,0.772,164
taboo,-0.272,262,502,1,1,0.198,0.794,0.482,764
grocery,-0.272,801,1533,1,1,0.687,0.54,0.446,2334
psychiatrist,-0.272,274,525,1,1,0.489,0.627,0.765,799
negligent,-0.272,22,43,1,1,0.167,0.583,0.259,65
indict,-0.272,22,43,1,1,0.188,0.731,0.458,65
substantive,-0.272,22,43,1,1,0.5,0.35,0.455,65
prevailing,-0.272,22,43,1,1,0.798,0.708,0.864,65
preposterous,-0.272,22,43,1,1,0.167,0.827,0.483,65
theatrical,-0.272,22,43,1,1,0.72,0.69,0.546,65
herbs,-0.272,45,87,1,1,0.62,0.299,0.308,132
sorry,-0.272,33399,63902,1,1,0.406,0.362,0.212,97301
seek,-0.273,4310,8248,1,1,0.622,0.429,0.482,12558
commitment,-0.273,1086,2079,1,1,0.714,0.71,0.843,3165
equity,-0.273,57,110,1,1,0.792,0.304,0.614,167
distressing,-0.273,92,177,1,1,0.075,0.75,0.375,269
hypocrisy,-0.273,255,489,1,1,0.156,0.523,0.37,744
heavenly,-0.273,360,690,1,1,0.844,0.452,0.712,1050
share,-0.273,15882,30402,1,1,0.759,0.548,0.545,46284
prayer,-0.273,1879,3598,1,1,0.745,0.217,0.604,5477
tricky,-0.274,259,497,1,1,0.219,0.651,0.5,756
confessions,-0.274,129,248,1,1,0.325,0.538,0.658,377
nodding,-0.274,177,340,1,1,0.694,0.294,0.426,517
suspected,-0.274,106,204,1,1,0.173,0.755,0.452,310
airspace,-0.274,11,22,1,1,0.562,0.51,0.64,33
originate,-0.274,11,22,1,1,0.702,0.5,0.866,33
undeserved,-0.274,23,45,1,1,0.219,0.552,0.283,68
cystic,-0.274,11,22,1,1,0.314,0.481,0.4,33
zing,-0.274,23,45,1,1,0.579,0.402,0.402,68
concur,-0.274,59,114,1,1,0.459,0.394,0.429,173
inflation,-0.274,47,91,1,1,0.219,0.792,0.508,138
affirmative,-0.274,23,45,1,1,0.854,0.589,0.816,68
ruined,-0.274,1278,2451,1,1,0.135,0.564,0.194,3729
representative,-0.275,168,323,1,1,0.704,0.366,0.694,491
inconsiderate,-0.275,132,254,1,1,0.224,0.519,0.423,386
marble,-0.275,133,256,1,1,0.604,0.212,0.667,389
considerate,-0.275,182,350,1,1,0.781,0.38,0.633,532
forward,-0.276,6273,12043,1,1,0.873,0.412,0.75,18316
persuasion,-0.276,49,95,1,1,0.612,0.67,0.537,144
allergic,-0.276,299,575,1,1,0.135,0.549,0.273,874
function,-0.276,874,1679,1,1,0.694,0.296,0.618,2553
duct,-0.276,24,47,1,1,0.449,0.435,0.43,71
resolved,-0.276,175,337,1,1,0.735,0.357,0.683,512
delivery,-0.276,566,1088,1,1,0.704,0.461,0.786,1654
disposal,-0.276,62,120,1,1,0.135,0.608,0.396,182
authority,-0.277,305,587,1,1,0.592,0.592,0.934,892
container,-0.277,114,220,1,1,0.551,0.396,0.561,334
register,-0.277,243,468,1,1,0.49,0.412,0.654,711
mentality,-0.277,776,1493,1,1,0.711,0.415,0.726,2269
circulate,-0.278,12,24,1,1,0.612,0.388,0.32,36
republic,-0.278,233,449,1,1,0.635,0.34,0.83,682
scorer,-0.278,12,24,1,1,0.73,0.608,0.764,36
cleaner,-0.278,129,249,1,1,0.604,0.556,0.375,378
zucchini,-0.278,12,24,1,1,0.51,0.321,0.25,36
rematch,-0.278,12,24,1,1,0.469,0.798,0.627,36
dispense,-0.278,12,24,1,1,0.561,0.52,0.518,36
bucko,-0.278,12,24,1,1,0.439,0.455,0.465,36
severe,-0.278,1066,2051,1,1,0.164,0.735,0.635,3117
confirm,-0.278,559,1076,1,1,0.802,0.439,0.806,1635
lightning,-0.278,326,628,1,1,0.429,0.683,0.595,954
process,-0.278,4102,7894,1,1,0.51,0.471,0.615,11996
hate,-0.278,60054,115568,1,1,0.031,0.802,0.43,175622
scrambled,-0.278,52,101,1,1,0.451,0.535,0.539,153
decide,-0.278,2866,5517,1,1,0.656,0.54,0.855,8383
strongly,-0.278,584,1125,1,1,0.63,0.817,0.885,1709
astonished,-0.279,39,76,1,1,0.51,0.775,0.574,115
perverse,-0.279,39,76,1,1,0.146,0.808,0.464,115
strict,-0.279,227,438,1,1,0.5,0.646,0.878,665
together,-0.279,33970,65412,1,1,0.874,0.392,0.658,99382
vendor,-0.279,26,51,1,1,0.541,0.541,0.627,77
victory,-0.279,690,1330,1,1,0.938,0.735,0.931,2020
graduate,-0.28,655,1263,1,1,0.898,0.549,0.778,1918
expo,-0.28,40,78,1,1,0.61,0.562,0.5,118
cheering,-0.28,738,1423,1,1,0.815,0.824,0.642,2161
valuable,-0.28,889,1714,1,1,0.899,0.547,0.798,2603
steering,-0.28,54,105,1,1,0.58,0.431,0.66,159
personal,-0.28,6483,12496,1,1,0.75,0.311,0.467,18979
clarification,-0.28,68,132,1,1,0.802,0.461,0.613,200
divided,-0.28,262,506,1,1,0.271,0.623,0.391,768
ottoman,-0.28,13,26,1,1,0.531,0.337,0.444,39
brig,-0.28,13,26,1,1,0.573,0.539,0.5,39
diligence,-0.28,27,53,1,1,0.688,0.423,0.7,80
defer,-0.28,13,26,1,1,0.245,0.459,0.317,39
rehash,-0.28,13,26,1,1,0.405,0.451,0.403,39
appreciative,-0.281,155,300,1,1,0.857,0.38,0.654,455
fury,-0.281,213,412,1,1,0.062,0.875,0.676,625
integrity,-0.281,472,912,1,1,0.865,0.413,0.848,1384
sin,-0.281,1252,2418,1,1,0.177,0.712,0.449,3670
nurse,-0.282,593,1146,1,1,0.635,0.578,0.521,1739
kneel,-0.282,86,167,1,1,0.426,0.417,0.217,253
ref,-0.282,145,281,1,1,0.469,0.38,0.368,426
reasons,-0.283,5233,10114,1,1,0.583,0.46,0.571,15347
eligible,-0.283,88,171,1,1,0.75,0.4,0.518,259
steps,-0.283,1484,2869,1,1,0.511,0.349,0.373,4353
assets,-0.283,118,229,1,1,0.667,0.613,0.765,347
atrophy,-0.283,14,28,1,1,0.177,0.54,0.208,42
watchful,-0.283,29,57,1,1,0.386,0.49,0.675,86
recorder,-0.283,29,57,1,1,0.551,0.374,0.481,86
remedial,-0.283,14,28,1,1,0.369,0.418,0.509,42
consoled,-0.283,44,86,1,1,0.7,0.343,0.452,130
airs,-0.283,44,86,1,1,0.583,0.196,0.37,130
competence,-0.283,29,57,1,1,0.615,0.802,0.823,86
uncooked,-0.283,14,28,1,1,0.312,0.321,0.241,42
kiddo,-0.283,255,494,1,1,0.674,0.393,0.419,749
thrive,-0.283,664,1285,1,1,0.948,0.529,0.772,1949
defense,-0.283,650,1258,1,1,0.652,0.698,0.802,1908
jumpsuit,-0.283,60,117,1,1,0.562,0.365,0.361,177
bothering,-0.284,1056,2044,1,1,0.208,0.764,0.449,3100
flawed,-0.284,261,506,1,1,0.133,0.49,0.194,767
manuscript,-0.284,61,119,1,1,0.51,0.208,0.54,180
preserve,-0.284,123,239,1,1,0.837,0.431,0.755,362
translator,-0.285,62,121,1,1,0.76,0.412,0.473,183
oatmeal,-0.285,63,123,1,1,0.592,0.192,0.241,186
devastate,-0.285,15,30,1,1,0.021,0.796,0.509,45
assembly,-0.285,111,216,1,1,0.698,0.5,0.64,327
advisable,-0.285,15,30,1,1,0.867,0.48,0.51,45
repair,-0.285,240,466,1,1,0.583,0.46,0.589,706
pleased,-0.285,676,1311,1,1,0.939,0.548,0.795,1987
religious,-0.285,825,1600,1,1,0.74,0.238,0.696,2425
prospect,-0.286,210,408,1,1,0.733,0.442,0.698,618
guarantee,-0.286,760,1475,1,1,0.949,0.337,0.805,2235
car,-0.286,7339,14238,1,1,0.776,0.54,0.5,21577
decency,-0.286,233,453,1,1,0.75,0.235,0.634,686
biggie,-0.287,100,195,1,1,0.531,0.481,0.5,295
universe,-0.287,5550,10772,1,1,0.694,0.454,0.839,16322
payroll,-0.287,33,65,1,1,0.521,0.36,0.549,98
summation,-0.287,16,32,1,1,0.766,0.337,0.594,48
dormitory,-0.287,50,98,1,1,0.633,0.204,0.382,148
immediate,-0.287,465,904,1,1,0.656,0.548,0.716,1369
pap,-0.288,51,100,1,1,0.438,0.403,0.302,151
heathen,-0.288,34,67,1,1,0.194,0.529,0.491,101
pry,-0.288,69,135,1,1,0.406,0.482,0.5,204
theater,-0.288,632,1229,1,1,0.76,0.635,0.516,1861
electricity,-0.288,303,590,1,1,0.698,0.81,0.733,893
resolve,-0.288,339,660,1,1,0.71,0.472,0.75,999
iota,-0.289,35,69,1,1,0.344,0.385,0.314,104
launcher,-0.289,17,34,1,1,0.677,0.745,0.808,51
enormity,-0.289,17,34,1,1,0.594,0.648,0.848,51
weakly,-0.289,35,69,1,1,0.27,0.255,0.111,104
gun,-0.289,1422,2766,1,1,0.147,0.92,0.713,4188
prepare,-0.289,973,1893,1,1,0.656,0.542,0.603,2866
salute,-0.289,307,598,1,1,0.833,0.542,0.681,905
knife,-0.289,636,1238,1,1,0.344,0.717,0.573,1874
torn,-0.289,822,1600,1,1,0.153,0.51,0.283,2422
deli,-0.289,36,71,1,1,0.561,0.448,0.447,107
finale,-0.29,280,546,1,1,0.406,0.33,0.468,826
graphics,-0.29,74,145,1,1,0.542,0.431,0.509,219
threat,-0.29,700,1364,1,1,0.135,0.865,0.667,2064
neat,-0.29,284,554,1,1,0.878,0.235,0.491,838
bombed,-0.29,37,73,1,1,0.051,0.851,0.627,110
inclination,-0.29,37,73,1,1,0.378,0.49,0.538,110
competent,-0.29,94,184,1,1,0.865,0.56,0.904,278
plural,-0.29,76,149,1,1,0.56,0.432,0.564,225
disgraceful,-0.291,176,344,1,1,0.082,0.702,0.24,520
thread,-0.291,4468,8712,1,1,0.646,0.184,0.209,13180
transmit,-0.291,19,38,1,1,0.836,0.581,0.673,57
needed,-0.292,11434,22299,1,1,0.677,0.342,0.679,33733
firmly,-0.292,220,430,1,1,0.786,0.51,0.777,650
rationalize,-0.292,60,118,1,1,0.633,0.4,0.746,178
campaigning,-0.292,103,202,1,1,0.531,0.663,0.741,305
reservation,-0.293,62,122,1,1,0.688,0.343,0.561,184
abort,-0.293,104,204,1,1,0.153,0.686,0.429,308
vertigo,-0.293,62,122,1,1,0.292,0.655,0.445,184
manufacture,-0.293,20,40,1,1,0.868,0.703,0.78,60
urinal,-0.293,20,40,1,1,0.214,0.51,0.306,60
provocation,-0.293,20,40,1,1,0.21,0.893,0.705,60
detail,-0.293,399,780,1,1,0.514,0.406,0.528,1179
fraud,-0.293,450,880,1,1,0.111,0.688,0.407,1330
splitting,-0.293,107,210,1,1,0.188,0.598,0.375,317
doc,-0.293,519,1015,1,1,0.458,0.317,0.392,1534
bible,-0.294,1151,2250,1,1,0.719,0.225,0.726,3401
purse,-0.294,152,298,1,1,0.656,0.176,0.306,450
easy,-0.294,10532,20586,1,1,0.865,0.194,0.373,31118
prosper,-0.294,197,386,1,1,0.935,0.633,0.857,583
flaring,-0.294,21,42,1,1,0.625,0.771,0.509,63
boxers,-0.294,88,173,1,1,0.375,0.88,0.654,261
lending,-0.294,66,130,1,1,0.51,0.585,0.462,196
relate,-0.295,7538,14745,1,1,0.653,0.5,0.623,22283
lift,-0.295,1492,2920,1,1,0.704,0.518,0.656,4412
postpone,-0.295,45,89,1,1,0.316,0.408,0.451,134
delegate,-0.295,22,44,1,1,0.612,0.491,0.658,66
agree,-0.295,6712,13139,1,1,0.906,0.26,0.545,19851
faculty,-0.296,118,232,1,1,0.615,0.412,0.732,350
mathematical,-0.296,23,46,1,1,0.62,0.5,0.548,69
culpable,-0.296,23,46,1,1,0.14,0.7,0.319,69
lesson,-0.296,1505,2950,1,1,0.704,0.577,0.593,4455
baptism,-0.297,24,48,1,1,0.844,0.384,0.566,72
information,-0.297,1364,2675,1,1,0.765,0.37,0.711,4039
accustomed,-0.297,382,750,1,1,0.542,0.365,0.441,1132
indecision,-0.297,25,50,1,1,0.184,0.48,0.196,75
accommodate,-0.297,103,203,1,1,0.844,0.375,0.566,306
malarkey,-0.297,25,50,1,1,0.396,0.5,0.465,75
reaction,-0.298,1291,2534,1,1,0.47,0.811,0.706,3825
biased,-0.298,292,574,1,1,0.271,0.302,0.368,866
wearing,-0.298,2134,4190,1,1,0.646,0.52,0.461,6324
crash,-0.298,684,1344,1,1,0.194,0.906,0.355,2028
guilty,-0.298,2111,4146,1,1,0.135,0.77,0.352,6257
dismay,-0.299,55,109,1,1,0.314,0.681,0.459,164
teaching,-0.299,1158,2276,1,1,0.822,0.444,0.736,3434
civility,-0.299,56,111,1,1,0.76,0.306,0.679,167
listener,-0.299,398,783,1,1,0.667,0.375,0.403,1181
unethical,-0.299,56,111,1,1,0.104,0.433,0.269,167
storage,-0.299,142,280,1,1,0.698,0.406,0.564,422
nuts,-0.299,779,1532,1,1,0.594,0.25,0.291,2311
quake,-0.299,28,56,1,1,0.11,0.824,0.672,84
kidnapped,-0.3,263,518,1,1,0.044,0.923,0.455,781
congressional,-0.3,58,115,1,1,0.552,0.491,0.848,173
oppress,-0.3,29,58,1,1,0.186,0.654,0.555,87
pope,-0.3,150,296,1,1,0.6,0.375,0.636,446
unplugged,-0.301,94,186,1,1,0.367,0.375,0.318,280
don,-0.301,151836,298879,1,1,0.646,0.454,0.702,450715
camping,-0.301,285,562,1,1,0.653,0.529,0.48,847
contractor,-0.301,31,62,1,1,0.592,0.479,0.727,93
drain,-0.301,448,883,1,1,0.277,0.47,0.222,1331
intervention,-0.301,192,379,1,1,0.388,0.696,0.689,571
agenda,-0.301,679,1338,1,1,0.531,0.296,0.553,2017
fearing,-0.301,324,639,1,1,0.125,0.566,0.256,963
balance,-0.301,1282,2526,1,1,0.684,0.265,0.735,3808
daughter,-0.302,4569,9003,1,1,0.908,0.415,0.455,13572
spokesperson,-0.302,33,66,1,1,0.573,0.453,0.615,99
aligned,-0.302,101,200,1,1,0.583,0.275,0.553,301
swat,-0.302,34,68,1,1,0.38,0.694,0.571,102
eyeliner,-0.303,35,70,1,1,0.688,0.349,0.347,105
dismissal,-0.303,35,70,1,1,0.153,0.723,0.271,105
dispatch,-0.303,73,145,1,1,0.317,0.417,0.555,218
escalator,-0.303,36,72,1,1,0.5,0.53,0.518,108
territorial,-0.303,36,72,1,1,0.405,0.6,0.766,108
category,-0.303,373,737,1,1,0.571,0.264,0.521,1110
lend,-0.304,475,939,1,1,0.52,0.461,0.508,1414
forced,-0.304,2553,5043,1,1,0.18,0.721,0.458,7596
roller,-0.304,359,710,1,1,0.521,0.394,0.345,1069
disheartening,-0.304,160,317,1,1,0.01,0.353,0.224,477
transportation,-0.305,164,325,1,1,0.667,0.56,0.472,489
ridiculous,-0.305,1444,2854,1,1,0.159,0.594,0.245,4298
disruption,-0.305,43,86,1,1,0.235,0.735,0.436,129
predator,-0.305,307,608,1,1,0.143,0.76,0.777,915
whit,-0.306,136,270,1,1,0.562,0.393,0.595,406
technical,-0.306,137,272,1,1,0.51,0.49,0.736,409
revelation,-0.306,190,377,1,1,0.879,0.5,0.865,567
electrical,-0.306,47,94,1,1,0.531,0.62,0.688,141
used,-0.307,29963,59316,1,1,0.354,0.306,0.287,89279
condemn,-0.307,149,296,1,1,0.102,0.793,0.625,445
unborn,-0.307,101,201,1,1,0.312,0.3,0.216,302
appreciate,-0.309,7678,15230,1,1,0.885,0.422,0.741,22908
operations,-0.309,62,124,1,1,0.48,0.549,0.798,186
roman,-0.309,261,519,1,1,0.615,0.475,0.639,780
font,-0.31,72,144,1,1,0.615,0.336,0.576,216
arm,-0.31,1404,2790,1,1,0.552,0.285,0.469,4194
mercy,-0.311,1033,2054,1,1,0.719,0.229,0.5,3087
stay,-0.311,35841,71248,1,1,0.604,0.275,0.516,107089
roughly,-0.311,173,345,1,1,0.448,0.539,0.463,518
amazing,-0.311,13234,26320,1,1,0.906,0.837,0.849,39554
enjoy,-0.311,19121,38039,1,1,0.959,0.725,0.75,57160
meditation,-0.312,497,990,1,1,0.786,0.12,0.478,1487
conditioning,-0.312,100,200,1,1,0.44,0.468,0.617,300
father,-0.312,6038,12020,1,1,0.812,0.333,0.824,18058
temp,-0.312,108,216,1,1,0.49,0.44,0.314,324
norm,-0.313,425,848,1,1,0.5,0.245,0.527,1273
sickening,-0.313,301,601,1,1,0.074,0.618,0.259,902
believer,-0.314,314,627,1,1,0.725,0.445,0.564,941
tremendously,-0.314,159,318,1,1,0.719,0.722,0.661,477
beneficial,-0.314,324,647,1,1,0.82,0.579,0.703,971
withdraw,-0.314,168,336,1,1,0.26,0.425,0.336,504
problem,-0.314,11822,23585,1,1,0.062,0.644,0.415,35407
house,-0.314,29791,59442,1,1,0.587,0.135,0.533,89233
med,-0.315,270,540,1,1,0.375,0.429,0.606,810
calming,-0.316,459,918,1,1,0.885,0.105,0.36,1377
comfort,-0.316,10122,20237,1,1,0.863,0.231,0.67,30359
swampy,-0.317,8,17,1,1,0.306,0.39,0.412,25
restitution,-0.317,8,17,1,1,0.583,0.542,0.643,25
unscathed,-0.317,23,47,1,1,0.625,0.308,0.611,70
advancement,-0.317,34,69,1,1,0.776,0.65,0.839,103
aviation,-0.317,18,37,1,1,0.708,0.646,0.741,55
dispatcher,-0.317,11,23,1,1,0.365,0.704,0.652,34
telltale,-0.317,12,25,1,1,0.24,0.663,0.426,37
bulimic,-0.317,10,21,1,1,0.092,0.57,0.373,31
barometer,-0.317,11,23,1,1,0.388,0.273,0.545,34
confer,-0.317,9,19,1,1,0.573,0.482,0.583,28
armored,-0.317,12,25,1,1,0.469,0.509,0.861,37
haye,-0.317,10,21,1,1,0.615,0.451,0.336,31
waterworks,-0.317,14,29,1,1,0.51,0.49,0.561,43
probation,-0.317,36,73,1,1,0.206,0.635,0.44,109
foothold,-0.317,10,21,1,1,0.673,0.336,0.582,31
medic,-0.317,38,77,1,1,0.5,0.472,0.585,115
deter,-0.317,43,87,1,1,0.344,0.537,0.567,130
thud,-0.317,20,41,1,1,0.255,0.686,0.62,61
machete,-0.317,15,31,1,1,0.26,0.69,0.474,46
astonishment,-0.317,9,19,1,1,0.68,0.718,0.519,28
aggravates,-0.317,13,27,1,1,0.108,0.778,0.357,40
renal,-0.317,8,17,1,1,0.3,0.48,0.415,25
corollary,-0.317,9,19,1,1,0.458,0.469,0.366,28
autopsy,-0.317,18,37,1,1,0.252,0.65,0.538,55
dubious,-0.317,41,83,1,1,0.414,0.48,0.198,124
retaliate,-0.317,23,47,1,1,0.111,0.812,0.595,70
tyrannical,-0.317,18,37,1,1,0.167,0.86,0.731,55
unresponsive,-0.317,21,43,1,1,0.108,0.282,0.244,64
utterance,-0.317,10,21,1,1,0.542,0.64,0.704,31
concubine,-0.317,15,31,1,1,0.388,0.594,0.476,46
vial,-0.317,11,23,1,1,0.594,0.346,0.445,34
stools,-0.317,13,27,1,1,0.459,0.382,0.327,40
clipping,-0.317,13,27,1,1,0.46,0.5,0.405,40
jeopardize,-0.317,21,43,1,1,0.26,0.877,0.582,64
lynching,-0.317,29,59,1,1,0.135,0.92,0.548,88
flagship,-0.317,10,21,1,1,0.592,0.587,0.703,31
wherefore,-0.317,10,21,1,1,0.561,0.357,0.402,31
warrant,-0.317,56,113,1,1,0.653,0.398,0.802,169
sedative,-0.317,10,21,1,1,0.314,0.273,0.352,31
indignity,-0.317,12,25,1,1,0.167,0.5,0.306,37
municipal,-0.317,21,43,1,1,0.625,0.39,0.758,64
severity,-0.317,53,107,1,1,0.26,0.712,0.661,160
polio,-0.317,11,23,1,1,0.296,0.452,0.409,34
measurable,-0.317,15,31,1,1,0.604,0.41,0.602,46
affirm,-0.317,71,143,1,1,0.745,0.509,0.731,214
diplomat,-0.317,25,51,1,1,0.563,0.262,0.868,76
lightheaded,-0.317,12,25,1,1,0.347,0.62,0.255,37
conception,-0.317,50,101,1,1,0.694,0.49,0.614,151
complying,-0.317,8,17,1,1,0.729,0.423,0.59,25
requisite,-0.317,9,19,1,1,0.448,0.363,0.609,28
padded,-0.317,64,129,1,1,0.606,0.212,0.371,193
magnetism,-0.317,9,19,1,1,0.63,0.529,0.741,28
terminate,-0.317,20,41,1,1,0.171,0.41,0.441,61
identification,-0.317,30,61,1,1,0.714,0.451,0.692,91
anointing,-0.317,26,53,1,1,0.653,0.35,0.547,79
omnipresent,-0.317,30,61,1,1,0.688,0.452,0.825,91
kilo,-0.317,16,33,1,1,0.438,0.358,0.461,49
infirmary,-0.317,9,19,1,1,0.5,0.438,0.517,28
breach,-0.317,47,95,1,1,0.177,0.745,0.423,142
premarital,-0.317,12,25,1,1,0.49,0.598,0.5,37
molasses,-0.317,9,19,1,1,0.49,0.269,0.286,28
remover,-0.317,10,21,1,1,0.337,0.443,0.526,31
pharmacist,-0.317,28,57,1,1,0.592,0.382,0.648,85
disagreeing,-0.317,61,123,1,1,0.255,0.643,0.35,184
bulky,-0.317,12,25,1,1,0.427,0.591,0.75,37
preference,-0.317,301,603,1,1,0.792,0.5,0.72,904
needful,-0.317,25,51,1,1,0.582,0.46,0.614,76
presentable,-0.317,20,41,1,1,0.836,0.311,0.643,61
evasive,-0.317,12,25,1,1,0.117,0.596,0.425,37
nudist,-0.317,29,59,1,1,0.44,0.796,0.483,88
restoration,-0.317,50,101,1,1,0.755,0.426,0.734,151
articulation,-0.317,10,21,1,1,0.479,0.48,0.591,31
growling,-0.317,57,115,1,1,0.119,0.887,0.475,172
gnat,-0.317,9,19,1,1,0.357,0.345,0.2,28
diarrhoea,-0.317,14,29,1,1,0.038,0.692,0.25,43
monogamous,-0.317,51,103,1,1,0.51,0.335,0.402,154
zephyr,-0.317,15,31,1,1,0.479,0.408,0.411,46
coercive,-0.317,12,25,1,1,0.479,0.67,0.506,37
bilateral,-0.317,9,19,1,1,0.633,0.343,0.491,28
apprehensive,-0.317,40,81,1,1,0.406,0.592,0.431,121
nip,-0.317,79,159,1,1,0.281,0.7,0.264,238
neuter,-0.317,11,23,1,1,0.621,0.163,0.302,34
syllabus,-0.317,16,33,1,1,0.736,0.37,0.643,49
numerical,-0.317,8,17,1,1,0.479,0.322,0.517,25
repeal,-0.317,24,49,1,1,0.26,0.48,0.482,73
despicable,-0.317,254,509,1,1,0.146,0.71,0.255,763
kingpin,-0.317,8,17,1,1,0.357,0.626,0.642,25
immeasurably,-0.317,22,45,1,1,0.51,0.64,0.68,67
toughen,-0.317,32,65,1,1,0.458,0.683,0.711,97
manufacturing,-0.317,42,85,1,1,0.653,0.613,0.804,127
raise,-0.318,1872,3750,1,1,0.885,0.685,0.765,5622
accent,-0.319,242,486,1,1,0.598,0.357,0.509,728
family,-0.319,44216,88651,1,1,0.968,0.383,0.643,132867
unpredictable,-0.32,170,342,1,1,0.429,0.769,0.515,512
statement,-0.32,1196,2401,1,1,0.688,0.608,0.825,3597
thought,-0.32,36496,73257,1,1,0.78,0.315,0.571,109753
reset,-0.32,273,549,1,1,0.49,0.45,0.574,822
surviving,-0.321,520,1045,1,1,0.646,0.836,0.721,1565
unmatched,-0.321,119,240,1,1,0.776,0.536,0.771,359
rule,-0.321,1431,2876,1,1,0.567,0.427,0.593,4307
demonstrate,-0.321,108,218,1,1,0.771,0.552,0.839,326
define,-0.321,859,1727,1,1,0.688,0.415,0.632,2586
including,-0.322,2731,5489,1,1,0.7,0.378,0.518,8220
vet,-0.322,520,1046,1,1,0.531,0.4,0.644,1566
secure,-0.322,688,1384,1,1,0.844,0.38,0.914,2072
therapist,-0.322,1586,3190,1,1,0.468,0.43,0.679,4776
shook,-0.322,648,1304,1,1,0.163,0.759,0.509,1952
crucial,-0.323,312,629,1,1,0.541,0.657,0.777,941
inspirational,-0.324,368,742,1,1,0.927,0.72,0.81,1110
chin,-0.324,870,1753,1,1,0.571,0.31,0.269,2623
counsel,-0.324,139,281,1,1,0.594,0.519,0.73,420
printer,-0.324,68,138,1,1,0.479,0.345,0.471,206
acceptable,-0.324,482,972,1,1,0.812,0.286,0.583,1454
accounting,-0.324,66,134,1,1,0.552,0.39,0.677,200
inhuman,-0.325,63,128,1,1,0.107,0.66,0.492,191
compare,-0.325,831,1676,1,1,0.552,0.408,0.524,2507
disregarded,-0.325,59,120,1,1,0.26,0.458,0.283,179
breathe,-0.326,3480,7022,1,1,0.833,0.373,0.518,10502
heater,-0.326,113,229,1,1,0.5,0.573,0.538,342
grateful,-0.326,5282,10659,1,1,0.958,0.353,0.56,15941
turnout,-0.326,55,112,1,1,0.641,0.692,0.898,167
options,-0.326,1203,2429,1,1,0.622,0.327,0.473,3632
invaluable,-0.326,107,217,1,1,0.74,0.5,0.745,324
normalcy,-0.327,50,102,1,1,0.805,0.151,0.62,152
horrendous,-0.327,203,411,1,1,0.073,0.755,0.365,614
assassination,-0.327,50,102,1,1,0.083,0.941,0.525,152
forgive,-0.327,2284,4615,1,1,0.781,0.408,0.562,6899
confrontation,-0.327,97,197,1,1,0.177,0.87,0.658,294
allegiance,-0.327,46,94,1,1,0.917,0.398,0.75,140
pipeline,-0.327,46,94,1,1,0.479,0.337,0.411,140
scan,-0.328,91,185,1,1,0.479,0.423,0.47,276
concern,-0.328,1052,2128,1,1,0.25,0.734,0.463,3180
tunnel,-0.328,581,1176,1,1,0.312,0.49,0.412,1757
gooood,-0.328,43,88,1,1,0.857,0.652,0.547,131
representation,-0.329,504,1021,1,1,0.677,0.542,0.75,1525
fossil,-0.329,41,84,1,1,0.48,0.292,0.38,125
kindness,-0.329,2367,4792,1,1,0.938,0.35,0.508,7159
difficult,-0.329,6820,13812,1,1,0.235,0.7,0.508,20632
sec,-0.329,517,1048,1,1,0.49,0.385,0.38,1565
savings,-0.329,237,481,1,1,0.776,0.431,0.608,718
determination,-0.329,237,481,1,1,0.776,0.725,0.795,718
denounce,-0.33,38,78,1,1,0.083,0.78,0.426,116
explode,-0.33,377,765,1,1,0.277,0.885,0.773,1142
bodyguard,-0.33,74,151,1,1,0.51,0.71,0.754,225
priceless,-0.33,291,591,1,1,0.745,0.696,0.779,882
parent,-0.331,1961,3978,1,1,0.812,0.357,0.86,5939
irritated,-0.331,532,1080,1,1,0.21,0.816,0.281,1612
errand,-0.331,33,68,1,1,0.385,0.519,0.482,101
concentration,-0.331,168,342,1,1,0.735,0.5,0.722,510
nightmares,-0.332,965,1960,1,1,0.082,0.942,0.448,2925
believe,-0.332,24546,49840,1,1,0.781,0.37,0.682,74386
fate,-0.332,1566,3181,1,1,0.571,0.479,0.712,4747
sag,-0.332,96,196,1,1,0.153,0.578,0.445,292
vehicle,-0.332,225,458,1,1,0.641,0.565,0.5,683
alike,-0.332,416,846,1,1,0.653,0.173,0.444,1262
toddler,-0.333,280,570,1,1,0.812,0.469,0.368,850
mess,-0.333,4460,9064,1,1,0.143,0.843,0.273,13524
cussed,-0.333,30,62,1,1,0.156,0.625,0.454,92
force,-0.333,3303,6716,1,1,0.612,0.75,0.905,10019
scramble,-0.333,29,60,1,1,0.469,0.744,0.5,89
hoax,-0.333,89,182,1,1,0.146,0.696,0.303,271
hiking,-0.333,209,426,1,1,0.82,0.843,0.67,635
disappoint,-0.334,438,892,1,1,0.15,0.633,0.288,1330
pasta,-0.334,377,768,1,1,0.615,0.306,0.375,1145
fungus,-0.334,28,58,1,1,0.388,0.337,0.173,86
respectful,-0.334,289,589,1,1,0.951,0.386,0.814,878
pricey,-0.334,28,58,1,1,0.34,0.567,0.43,86
disapproval,-0.334,28,58,1,1,0.085,0.551,0.367,86
coordination,-0.335,27,56,1,1,0.677,0.454,0.789,83
bureaucracy,-0.335,27,56,1,1,0.38,0.578,0.74,83
wavering,-0.335,27,56,1,1,0.375,0.43,0.384,83
caveat,-0.335,27,56,1,1,0.344,0.629,0.484,83
believing,-0.335,1434,2921,1,1,0.87,0.418,0.833,4355
planned,-0.335,1031,2101,1,1,0.74,0.385,0.729,3132
provincial,-0.335,26,54,1,1,0.645,0.341,0.481,80
simplify,-0.335,26,54,1,1,0.565,0.347,0.602,80
odds,-0.335,431,879,1,1,0.5,0.472,0.68,1310
grandfather,-0.335,345,704,1,1,0.827,0.279,0.586,1049
planner,-0.336,52,107,1,1,0.76,0.469,0.868,159
lung,-0.336,128,262,1,1,0.51,0.292,0.629,390
management,-0.336,437,892,1,1,0.792,0.491,0.806,1329
foremost,-0.336,100,205,1,1,0.735,0.593,0.907,305
ibuprofen,-0.337,24,50,1,1,0.448,0.427,0.504,74
faucet,-0.337,24,50,1,1,0.427,0.278,0.356,74
straighten,-0.337,49,101,1,1,0.677,0.5,0.685,150
miracles,-0.337,199,407,1,1,0.922,0.735,0.692,606
unannounced,-0.337,48,99,1,1,0.24,0.588,0.291,147
tactical,-0.337,48,99,1,1,0.594,0.481,0.684,147
inhumane,-0.337,97,199,1,1,0.104,0.587,0.402,296
thanking,-0.337,218,446,1,1,0.917,0.538,0.658,664
furniture,-0.337,314,642,1,1,0.688,0.26,0.264,956
criminal,-0.337,918,1875,1,1,0.021,0.83,0.529,2793
export,-0.337,23,48,1,1,0.567,0.661,0.755,71
indecisive,-0.337,119,244,1,1,0.271,0.42,0.19,363
advise,-0.337,406,830,1,1,0.76,0.393,0.705,1236
accident,-0.338,708,1447,1,1,0.125,0.908,0.336,2155
luxury,-0.338,482,986,1,1,0.932,0.673,0.75,1468
astronomical,-0.338,22,46,1,1,0.6,0.632,0.726,68
alleged,-0.339,110,226,1,1,0.365,0.522,0.52,336
deadline,-0.339,132,271,1,1,0.214,0.615,0.46,403
incapable,-0.339,551,1128,1,1,0.156,0.529,0.155,1679
receptive,-0.339,43,89,1,1,0.729,0.519,0.639,132
want,-0.339,182748,373806,1,1,0.671,0.642,0.598,556554
dependent,-0.339,744,1523,1,1,0.354,0.455,0.404,2267
software,-0.34,173,355,1,1,0.561,0.28,0.57,528
lax,-0.34,42,87,1,1,0.43,0.401,0.3,129
depend,-0.34,1273,2607,1,1,0.388,0.429,0.358,3880
execute,-0.34,62,128,1,1,0.327,0.708,0.769,190
exhale,-0.341,164,337,1,1,0.542,0.49,0.411,501
unrest,-0.341,40,83,1,1,0.102,0.577,0.231,123
garlic,-0.341,120,247,1,1,0.46,0.323,0.277,367
expel,-0.342,19,40,1,1,0.281,0.725,0.452,59
preschool,-0.342,39,81,1,1,0.604,0.382,0.393,120
microwave,-0.342,215,442,1,1,0.542,0.497,0.443,657
mindful,-0.342,215,442,1,1,0.765,0.45,0.725,657
playbook,-0.342,38,79,1,1,0.673,0.582,0.5,117
negotiate,-0.343,95,196,1,1,0.612,0.708,0.769,291
cabinet,-0.343,266,547,1,1,0.552,0.306,0.465,813
riots,-0.343,37,77,1,1,0.099,0.882,0.564,114
pendulum,-0.343,37,77,1,1,0.542,0.368,0.434,114
haywire,-0.343,18,38,1,1,0.358,0.545,0.43,56
inconceivable,-0.343,18,38,1,1,0.198,0.552,0.561,56
anxiety,-0.343,17544,36035,1,1,0.146,0.865,0.342,53579
wages,-0.344,146,301,1,1,0.776,0.44,0.62,447
boil,-0.344,126,260,1,1,0.417,0.684,0.433,386
ecological,-0.344,17,36,1,1,0.885,0.29,0.607,53
overt,-0.344,35,73,1,1,0.708,0.326,0.607,108
entrust,-0.344,17,36,1,1,0.693,0.31,0.63,53
greatful,-0.344,160,330,1,1,0.923,0.571,0.676,490
represented,-0.344,231,476,1,1,0.724,0.444,0.688,707
collectively,-0.345,177,365,1,1,0.817,0.573,0.533,542
tot,-0.345,123,254,1,1,0.602,0.431,0.311,377
renter,-0.346,16,34,1,1,0.59,0.301,0.371,50
fenced,-0.346,16,34,1,1,0.323,0.43,0.429,50
disorganized,-0.346,16,34,1,1,0.052,0.507,0.184,50
debatable,-0.346,33,69,1,1,0.181,0.61,0.474,102
gummy,-0.346,83,172,1,1,0.521,0.302,0.291,255
charge,-0.346,838,1727,1,1,0.51,0.633,0.785,2565
continue,-0.346,5384,11090,1,1,0.63,0.427,0.612,16474
remind,-0.347,6790,13991,1,1,0.721,0.415,0.563,20781
resonate,-0.347,262,541,1,1,0.582,0.61,0.644,803
betting,-0.347,146,302,1,1,0.237,0.804,0.411,448
cookbook,-0.348,15,32,1,1,0.602,0.346,0.398,47
tracer,-0.348,15,32,1,1,0.573,0.327,0.645,47
disobey,-0.348,15,32,1,1,0.143,0.556,0.491,47
totality,-0.348,15,32,1,1,0.688,0.443,0.717,47
kickoff,-0.348,15,32,1,1,0.583,0.6,0.629,47
senator,-0.348,396,818,1,1,0.391,0.422,0.821,1214
classroom,-0.348,458,946,1,1,0.539,0.292,0.363,1404
credibility,-0.348,173,358,1,1,0.875,0.427,0.809,531
thankful,-0.348,3940,8132,1,1,0.969,0.344,0.714,12072
conditioned,-0.349,136,282,1,1,0.49,0.417,0.616,418
armpit,-0.35,44,92,1,1,0.283,0.439,0.25,136
latent,-0.35,14,30,1,1,0.469,0.5,0.653,44
snot,-0.35,44,92,1,1,0.214,0.34,0.269,136
blameless,-0.35,14,30,1,1,0.759,0.196,0.343,44
necessities,-0.35,59,123,1,1,0.52,0.63,0.463,182
automobile,-0.35,14,30,1,1,0.753,0.625,0.534,44
quandary,-0.35,14,30,1,1,0.208,0.575,0.422,44
civilized,-0.35,59,123,1,1,0.792,0.231,0.796,182
unquestionably,-0.35,14,30,1,1,0.5,0.63,0.75,44
hiccup,-0.35,43,90,1,1,0.271,0.549,0.24,133
optics,-0.35,43,90,1,1,0.562,0.286,0.58,133
irked,-0.351,28,59,1,1,0.164,0.791,0.353,87
accountability,-0.351,202,419,1,1,0.755,0.537,0.833,621
flu,-0.351,318,659,1,1,0.23,0.547,0.25,977
poll,-0.351,461,955,1,1,0.552,0.5,0.554,1416
supremacy,-0.351,99,206,1,1,0.794,0.706,0.943,305
wimp,-0.351,56,117,1,1,0.184,0.49,0.125,173
fully,-0.351,2829,5858,1,1,0.763,0.45,0.779,8687
appendix,-0.352,13,28,1,1,0.365,0.387,0.425,41
leeway,-0.352,13,28,1,1,0.562,0.577,0.569,41
hilt,-0.352,13,28,1,1,0.396,0.65,0.537,41
etiquette,-0.352,41,86,1,1,0.604,0.35,0.421,127
reorganize,-0.352,13,28,1,1,0.667,0.59,0.722,41
legislator,-0.352,13,28,1,1,0.49,0.58,0.877,41
contingent,-0.352,27,57,1,1,0.47,0.531,0.659,84
contempt,-0.352,206,428,1,1,0.206,0.635,0.396,634
horror,-0.353,2159,4476,1,1,0.115,0.85,0.438,6635
sadly,-0.353,3145,6523,1,1,0.047,0.255,0.216,9668
assess,-0.353,80,167,1,1,0.698,0.5,0.623,247
ammunition,-0.353,26,55,1,1,0.338,0.635,0.667,81
barf,-0.353,26,55,1,1,0.34,0.491,0.394,81
journalism,-0.353,201,418,1,1,0.622,0.5,0.684,619
breast,-0.354,278,578,1,1,0.753,0.429,0.5,856
destroy,-0.354,1674,3476,1,1,0.046,0.935,0.635,5150
idiocy,-0.354,91,190,1,1,0.112,0.635,0.137,281
duplicate,-0.355,25,53,1,1,0.521,0.49,0.338,78
acceleration,-0.355,12,26,1,1,0.704,0.905,0.843,38
biweekly,-0.355,12,26,1,1,0.581,0.337,0.455,38
prohibition,-0.355,12,26,1,1,0.204,0.684,0.568,38
imaginable,-0.355,77,161,1,1,0.613,0.529,0.596,238
realty,-0.355,12,26,1,1,0.633,0.471,0.648,38
intrude,-0.355,51,107,1,1,0.058,0.735,0.48,158
aversion,-0.355,50,105,1,1,0.074,0.663,0.525,155
identical,-0.355,101,211,1,1,0.635,0.38,0.527,312
concerned,-0.356,1349,2807,1,1,0.292,0.698,0.35,4156
helm,-0.357,48,101,1,1,0.511,0.45,0.615,149
manage,-0.357,1671,3480,1,1,0.56,0.53,0.719,5151
supervisor,-0.357,121,253,1,1,0.615,0.479,0.933,374
input,-0.357,182,380,1,1,0.643,0.337,0.527,562
controlling,-0.357,351,732,1,1,0.49,0.441,0.885,1083
documentation,-0.358,35,74,1,1,0.719,0.29,0.667,109
estimation,-0.358,23,49,1,1,0.74,0.48,0.589,72
concluding,-0.358,23,49,1,1,0.531,0.382,0.603,72
doings,-0.358,59,124,1,1,0.604,0.491,0.705,183
housekeeping,-0.358,23,49,1,1,0.604,0.5,0.445,72
granddaughter,-0.358,95,199,1,1,0.823,0.445,0.389,294
sceptical,-0.358,23,49,1,1,0.214,0.387,0.466,72
words,-0.358,14284,29769,1,1,0.71,0.216,0.473,44053
bullshit,-0.359,3723,7765,1,1,0.042,0.676,0.183,11488
systematic,-0.359,34,72,1,1,0.617,0.444,0.594,106
homicide,-0.359,34,72,1,1,0.01,0.973,0.518,106
treasured,-0.359,91,191,1,1,0.849,0.471,0.73,282
skim,-0.359,22,47,1,1,0.418,0.328,0.322,69
political,-0.36,2051,4283,1,1,0.347,0.73,0.875,6334
intolerant,-0.36,90,189,1,1,0.135,0.676,0.509,279
doubting,-0.36,214,448,1,1,0.224,0.56,0.189,662
complaint,-0.36,246,515,1,1,0.143,0.606,0.281,761
fear,-0.361,17834,37281,1,1,0.073,0.84,0.293,55115
knick,-0.361,10,22,1,1,0.48,0.509,0.42,32
barbaric,-0.361,54,114,1,1,0.235,0.798,0.738,168
gurney,-0.361,10,22,1,1,0.408,0.304,0.352,32
expenditure,-0.361,10,22,1,1,0.25,0.608,0.603,32
croak,-0.361,21,45,1,1,0.337,0.346,0.298,66
surveillance,-0.361,76,160,1,1,0.365,0.72,0.718,236
plan,-0.362,4292,8978,1,1,0.646,0.54,0.733,13270
redo,-0.362,64,135,1,1,0.481,0.5,0.535,199
robbery,-0.362,53,112,1,1,0.133,0.843,0.435,165
deal,-0.362,11808,24712,1,1,0.719,0.599,0.543,36520
scapegoat,-0.362,42,89,1,1,0.184,0.685,0.481,131
barred,-0.363,31,66,1,1,0.143,0.741,0.535,97
flaky,-0.363,31,66,1,1,0.363,0.509,0.279,97
herbal,-0.363,31,66,1,1,0.592,0.255,0.39,97
purge,-0.363,115,242,1,1,0.125,0.566,0.327,357
basics,-0.364,113,238,1,1,0.688,0.311,0.491,351
sanity,-0.365,728,1529,1,1,0.667,0.333,0.655,2257
relaxing,-0.365,900,1890,1,1,0.854,0.157,0.475,2790
parliament,-0.365,333,700,1,1,0.573,0.54,0.858,1033
wearer,-0.366,9,20,1,1,0.471,0.347,0.527,29
shipment,-0.366,19,41,1,1,0.582,0.44,0.452,60
fixtures,-0.366,9,20,1,1,0.643,0.33,0.37,29
chopping,-0.366,49,104,1,1,0.56,0.625,0.362,153
persecute,-0.366,19,41,1,1,0.281,0.873,0.509,60
bathrobe,-0.366,19,41,1,1,0.531,0.442,0.394,60
organization,-0.366,357,751,1,1,0.81,0.535,0.851,1108
grandmother,-0.366,551,1159,1,1,0.792,0.283,0.426,1710
venue,-0.367,282,594,1,1,0.727,0.316,0.395,876
abused,-0.367,1219,2565,1,1,0.021,0.874,0.235,3784
candid,-0.367,86,182,1,1,0.667,0.349,0.458,268
chandler,-0.368,114,241,1,1,0.51,0.452,0.454,355
lungs,-0.368,592,1247,1,1,0.531,0.352,0.555,1839
loaf,-0.368,104,220,1,1,0.755,0.25,0.277,324
breakthrough,-0.368,104,220,1,1,0.68,0.525,0.718,324
subtitle,-0.368,18,39,1,1,0.445,0.202,0.347,57
socket,-0.368,18,39,1,1,0.583,0.469,0.377,57
understanding,-0.368,2757,5806,1,1,0.865,0.304,0.689,8563
pep,-0.368,141,298,1,1,0.51,0.51,0.364,439
sickle,-0.369,27,58,1,1,0.427,0.585,0.37,85
elation,-0.369,27,58,1,1,0.74,0.853,0.623,85
consensus,-0.369,92,195,1,1,0.627,0.358,0.625,287
nudity,-0.37,45,96,1,1,0.438,0.853,0.415,141
capability,-0.37,72,153,1,1,0.833,0.571,0.73,225
injury,-0.37,354,748,1,1,0.049,0.769,0.287,1102
honored,-0.371,234,495,1,1,0.938,0.447,0.732,729
magna,-0.371,8,18,1,1,0.605,0.49,0.652,26
concurrent,-0.371,8,18,1,1,0.573,0.547,0.741,26
mural,-0.371,17,37,1,1,0.551,0.265,0.454,54
vasectomy,-0.371,8,18,1,1,0.208,0.663,0.431,26
sonar,-0.371,8,18,1,1,0.541,0.48,0.414,26
hangman,-0.371,8,18,1,1,0.153,0.877,0.555,26
contending,-0.371,8,18,1,1,0.49,0.698,0.716,26
mausoleum,-0.371,8,18,1,1,0.344,0.281,0.594,26
planning,-0.371,1484,3135,1,1,0.894,0.462,0.705,4619
schizophrenia,-0.371,133,282,1,1,0.092,0.88,0.435,415
guards,-0.372,185,392,1,1,0.448,0.663,0.72,577
loudly,-0.372,552,1168,1,1,0.541,0.755,0.667,1720
declaration,-0.373,51,109,1,1,0.551,0.59,0.714,160
scripture,-0.373,172,365,1,1,0.745,0.27,0.63,537
open,-0.373,16247,34377,1,1,0.62,0.48,0.569,50624
passport,-0.373,137,291,1,1,0.653,0.457,0.682,428
cost,-0.373,1611,3411,1,1,0.365,0.42,0.439,5022
damage,-0.374,906,1919,1,1,0.059,0.726,0.403,2825
disk,-0.374,33,71,1,1,0.573,0.423,0.412,104
negotiable,-0.374,16,35,1,1,0.688,0.585,0.731,51
emphatic,-0.374,16,35,1,1,0.615,0.707,0.732,51
priority,-0.375,730,1548,1,1,0.878,0.562,0.864,2278
unreliable,-0.375,74,158,1,1,0.108,0.48,0.24,232
uprising,-0.375,24,52,1,1,0.561,0.777,0.704,76
decorate,-0.375,174,370,1,1,0.954,0.37,0.404,544
end,-0.376,42382,89898,1,1,0.198,0.349,0.298,132280
deliberate,-0.376,98,209,1,1,0.551,0.654,0.682,307
molest,-0.376,32,69,1,1,0.133,0.816,0.319,101
staircase,-0.376,73,156,1,1,0.469,0.347,0.44,229
registration,-0.376,73,156,1,1,0.622,0.396,0.574,229
brother,-0.376,9177,19472,1,1,0.823,0.361,0.546,28649
timer,-0.376,97,207,1,1,0.469,0.433,0.5,304
barefoot,-0.376,48,103,1,1,0.445,0.373,0.241,151
office,-0.376,4781,10149,1,1,0.427,0.302,0.509,14930
trouble,-0.377,2640,5606,1,1,0.135,0.811,0.452,8246
upstairs,-0.377,581,1235,1,1,0.663,0.408,0.645,1816
numbers,-0.377,1596,3391,1,1,0.406,0.241,0.44,4987
apologetic,-0.377,31,67,1,1,0.479,0.461,0.571,98
persisting,-0.377,15,33,1,1,0.697,0.677,0.745,48
implanted,-0.377,15,33,1,1,0.347,0.5,0.679,48
handbag,-0.377,31,67,1,1,0.562,0.24,0.336,98
laboratory,-0.377,23,50,1,1,0.571,0.49,0.537,73
divulge,-0.377,15,33,1,1,0.531,0.718,0.467,48
till,-0.378,9513,20223,1,1,0.49,0.327,0.319,29736
means,-0.378,14095,29964,1,1,0.615,0.373,0.46,44059
adjustment,-0.378,118,252,1,1,0.59,0.52,0.661,370
gulf,-0.378,70,150,1,1,0.52,0.365,0.398,220
pronounced,-0.379,93,199,1,1,0.67,0.551,0.694,292
civil,-0.379,421,897,1,1,0.521,0.281,0.517,1318
bedding,-0.379,38,82,1,1,0.704,0.276,0.377,120
mocked,-0.38,199,425,1,1,0.225,0.746,0.204,624
immorality,-0.38,22,48,1,1,0.188,0.689,0.315,70
outlast,-0.38,22,48,1,1,0.62,0.786,0.685,70
schizophrenic,-0.38,121,259,1,1,0.102,0.958,0.433,380
opener,-0.381,128,274,1,1,0.584,0.526,0.377,402
hibernate,-0.381,52,112,1,1,0.5,0.317,0.431,164
procrastinate,-0.381,67,144,1,1,0.276,0.353,0.315,211
rhetoric,-0.381,255,545,1,1,0.417,0.429,0.504,800
inspection,-0.381,29,63,1,1,0.459,0.63,0.718,92
handkerchief,-0.381,14,31,1,1,0.51,0.192,0.219,45
invader,-0.381,14,31,1,1,0.2,0.827,0.618,45
scold,-0.381,59,127,1,1,0.194,0.755,0.626,186
unison,-0.382,51,110,1,1,0.51,0.439,0.583,161
motivate,-0.382,370,791,1,1,0.812,0.776,0.873,1161
unwind,-0.382,132,283,1,1,0.837,0.181,0.394,415
telephone,-0.382,338,723,1,1,0.694,0.52,0.425,1061
calculation,-0.383,21,46,1,1,0.646,0.453,0.606,67
fitted,-0.383,65,140,1,1,0.507,0.404,0.673,205
leap,-0.383,253,542,1,1,0.75,0.663,0.667,795
ancestry,-0.384,28,61,1,1,0.708,0.519,0.717,89
undress,-0.384,28,61,1,1,0.438,0.9,0.336,89
pronunciation,-0.384,35,76,1,1,0.531,0.431,0.588,111
tenure,-0.384,35,76,1,1,0.615,0.472,0.611,111
disaster,-0.384,553,1184,1,1,0.082,0.892,0.433,1737
draining,-0.384,838,1794,1,1,0.337,0.396,0.304,2632
invalidate,-0.384,92,198,1,1,0.315,0.48,0.397,290
approximately,-0.385,162,348,1,1,0.622,0.396,0.538,510
foreign,-0.385,1293,2770,1,1,0.573,0.681,0.385,4063
timetable,-0.386,27,59,1,1,0.561,0.189,0.491,86
rigging,-0.386,13,29,1,1,0.51,0.518,0.44,42
unwillingness,-0.386,27,59,1,1,0.204,0.311,0.113,86
issue,-0.387,4511,9675,1,1,0.316,0.819,0.351,14186
irritating,-0.387,317,681,1,1,0.104,0.912,0.393,998
able,-0.387,13693,29369,1,1,0.786,0.5,0.81,43062
courts,-0.387,137,295,1,1,0.367,0.71,0.816,432
moods,-0.387,799,1715,1,1,0.578,0.633,0.491,2514
forefront,-0.387,61,132,1,1,0.573,0.559,0.811,193
intervene,-0.387,88,190,1,1,0.52,0.677,0.768,278
soc,-0.387,40,87,1,1,0.427,0.431,0.38,127
unforgivable,-0.388,60,130,1,1,0.276,0.743,0.49,190
convoluted,-0.388,26,57,1,1,0.323,0.614,0.433,83
fears,-0.389,2350,5051,1,1,0.061,0.821,0.306,7401
custody,-0.389,153,330,1,1,0.494,0.472,0.675,483
therapy,-0.389,2277,4896,1,1,0.49,0.353,0.607,7173
spider,-0.389,626,1347,1,1,0.229,0.569,0.43,1973
culprit,-0.389,59,128,1,1,0.062,0.676,0.333,187
qualifying,-0.389,19,42,1,1,0.788,0.577,0.789,61
resource,-0.389,205,442,1,1,0.74,0.357,0.749,647
loved,-0.389,24403,52482,1,1,0.927,0.452,0.582,76885
totally,-0.39,6339,13635,1,1,0.82,0.422,0.702,19974
disruptive,-0.39,32,70,1,1,0.255,0.755,0.575,102
warfare,-0.391,84,182,1,1,0.062,0.885,0.845,266
shortness,-0.391,12,27,1,1,0.459,0.28,0.272,39
mucus,-0.391,12,27,1,1,0.143,0.309,0.228,39
instinctive,-0.391,12,27,1,1,0.752,0.575,0.694,39
proverb,-0.391,51,111,1,1,0.714,0.26,0.518,162
commerce,-0.391,25,55,1,1,0.646,0.5,0.788,80
speaking,-0.391,4066,8759,1,1,0.753,0.59,0.575,12825
outrageous,-0.391,174,376,1,1,0.153,0.945,0.713,550
surgery,-0.392,849,1831,1,1,0.286,0.769,0.6,2680
membership,-0.392,230,497,1,1,0.698,0.411,0.778,727
throne,-0.392,714,1541,1,1,0.724,0.606,0.887,2255
packaging,-0.392,50,109,1,1,0.604,0.393,0.549,159
patience,-0.392,1208,2607,1,1,0.771,0.125,0.387,3815
tough,-0.393,6270,13531,1,1,0.344,0.588,0.742,19801
outcome,-0.393,454,981,1,1,0.615,0.472,0.685,1435
country,-0.393,8940,19296,1,1,0.698,0.394,0.693,28236
encourage,-0.393,1338,2890,1,1,0.896,0.58,0.704,4228
birthing,-0.394,24,53,1,1,0.796,0.877,0.519,77
meddling,-0.394,30,66,1,1,0.245,0.6,0.461,96
restrain,-0.395,36,79,1,1,0.134,0.696,0.434,115
provider,-0.395,153,332,1,1,0.751,0.494,0.75,485
customer,-0.395,620,1342,1,1,0.562,0.43,0.673,1962
trump,-0.395,9363,20253,1,1,0.64,0.716,0.898,29616
error,-0.395,367,795,1,1,0.094,0.559,0.198,1162
wrongly,-0.396,96,209,1,1,0.054,0.55,0.202,305
hear,-0.397,21262,46061,1,1,0.76,0.429,0.444,67323
excepting,-0.397,29,64,1,1,0.408,0.413,0.526,93
manufacturer,-0.397,11,25,1,1,0.688,0.537,0.83,36
stumped,-0.397,23,51,1,1,0.344,0.604,0.392,74
legislate,-0.397,11,25,1,1,0.571,0.582,0.736,36
flabbergasted,-0.397,17,38,1,1,0.312,0.802,0.342,55
bearish,-0.397,11,25,1,1,0.521,0.549,0.324,36
fryer,-0.397,11,25,1,1,0.573,0.459,0.431,36
removal,-0.397,71,155,1,1,0.245,0.54,0.368,226
bribery,-0.397,17,38,1,1,0.135,0.775,0.585,55
assemble,-0.397,71,155,1,1,0.542,0.57,0.75,226
blunder,-0.397,17,38,1,1,0.135,0.635,0.145,55
personnel,-0.397,59,129,1,1,0.729,0.344,0.587,188
hoarse,-0.397,23,51,1,1,0.281,0.402,0.315,74
lifeboat,-0.397,11,25,1,1,0.724,0.425,0.533,36
will,-0.397,177293,384232,1,1,0.698,0.408,0.735,561525
accusing,-0.397,124,270,1,1,0.156,0.745,0.324,394
brutality,-0.398,58,127,1,1,0.122,0.832,0.571,185
rest,-0.399,15151,32893,1,1,0.907,0.167,0.3,48044
bourgeois,-0.399,34,75,1,1,0.439,0.593,0.682,109
outlive,-0.399,63,138,1,1,0.565,0.769,0.724,201
opposition,-0.4,323,703,1,1,0.135,0.729,0.592,1026
permitted,-0.4,51,112,1,1,0.865,0.41,0.613,163
kneeling,-0.4,45,99,1,1,0.245,0.435,0.144,144
brackets,-0.4,22,49,1,1,0.573,0.281,0.435,71
freely,-0.4,464,1010,1,1,0.875,0.456,0.716,1474
viable,-0.4,108,236,1,1,0.656,0.32,0.667,344
trite,-0.401,39,86,1,1,0.458,0.418,0.29,125
staunch,-0.401,39,86,1,1,0.48,0.363,0.833,125
dress,-0.401,1546,3364,1,1,0.76,0.3,0.345,4910
vegetarian,-0.401,96,210,1,1,0.562,0.255,0.407,306
momentum,-0.401,113,247,1,1,0.663,0.75,0.688,360
potty,-0.401,73,160,1,1,0.367,0.373,0.317,233
insist,-0.401,288,628,1,1,0.635,0.651,0.688,916
loathe,-0.401,169,369,1,1,0.094,0.73,0.429,538
suspicious,-0.401,265,578,1,1,0.153,0.745,0.431,843
unsolved,-0.402,61,134,1,1,0.146,0.39,0.235,195
regulation,-0.402,44,97,1,1,0.542,0.425,0.667,141
babysitter,-0.402,89,195,1,1,0.656,0.415,0.408,284
perplexed,-0.402,44,97,1,1,0.312,0.705,0.318,141
calm,-0.402,2843,6193,1,1,0.875,0.1,0.282,9036
shamed,-0.402,218,476,1,1,0.135,0.567,0.218,694
fiscal,-0.402,27,60,1,1,0.5,0.582,0.845,87
pocket,-0.402,1191,2596,1,1,0.458,0.275,0.34,3787
blood,-0.403,3195,6965,1,1,0.219,0.684,0.585,10160
salsa,-0.403,88,193,1,1,0.742,0.5,0.37,281
clothes,-0.403,1876,4091,1,1,0.833,0.27,0.414,5967
cheater,-0.403,182,398,1,1,0.104,0.92,0.333,580
inspiration,-0.403,1562,3407,1,1,0.938,0.6,0.779,4969
olive,-0.403,226,494,1,1,0.571,0.231,0.406,720
understandable,-0.404,451,985,1,1,0.776,0.363,0.566,1436
espionage,-0.404,10,23,1,1,0.312,0.75,0.62,33
wholesale,-0.404,10,23,1,1,0.76,0.551,0.619,33
reputable,-0.404,21,47,1,1,0.781,0.462,0.919,68
containment,-0.404,10,23,1,1,0.411,0.491,0.618,33
glucose,-0.404,10,23,1,1,0.562,0.316,0.444,33
scone,-0.404,32,71,1,1,0.418,0.287,0.229,103
committee,-0.404,196,429,1,1,0.592,0.392,0.721,625
sure,-0.404,32507,70960,1,1,0.724,0.27,0.793,103467
cooperation,-0.404,70,154,1,1,0.847,0.473,0.686,224
trauma,-0.404,1741,3802,1,1,0.112,0.792,0.453,5543
bud,-0.405,861,1881,1,1,0.46,0.402,0.333,2742
mantra,-0.405,168,368,1,1,0.396,0.249,0.357,536
yelling,-0.405,765,1672,1,1,0.323,0.939,0.565,2437
circumstance,-0.405,259,567,1,1,0.52,0.565,0.596,826
employ,-0.406,69,152,1,1,0.729,0.481,0.702,221
sweetheart,-0.406,998,2183,1,1,0.959,0.423,0.509,3181
guidance,-0.406,616,1348,1,1,0.729,0.471,0.718,1964
negotiator,-0.406,15,34,1,1,0.635,0.471,0.817,49
cosmetic,-0.406,15,34,1,1,0.625,0.304,0.308,49
affiliation,-0.406,47,104,1,1,0.615,0.594,0.5,151
unstoppable,-0.406,111,244,1,1,0.625,0.887,0.862,355
rationale,-0.406,31,69,1,1,0.656,0.4,0.815,100
decorum,-0.406,15,34,1,1,0.802,0.327,0.462,49
tolerance,-0.406,255,559,1,1,0.875,0.206,0.649,814
healing,-0.407,2707,5926,1,1,0.75,0.452,0.585,8633
restful,-0.408,41,91,1,1,0.781,0.116,0.413,132
respect,-0.408,5280,11568,1,1,0.927,0.344,0.758,16848
quantum,-0.408,67,148,1,1,0.704,0.5,0.6,215
unified,-0.408,46,102,1,1,0.729,0.439,0.764,148
pledged,-0.408,46,102,1,1,0.719,0.63,0.658,148
sexual,-0.408,3148,6900,1,1,0.584,0.959,0.64,10048
expertise,-0.408,72,159,1,1,0.792,0.589,0.925,231
nil,-0.409,25,56,1,1,0.286,0.143,0.157,81
inexcusable,-0.409,25,56,1,1,0.271,0.582,0.546,81
enroll,-0.409,25,56,1,1,0.696,0.53,0.611,81
certainty,-0.409,155,341,1,1,0.781,0.4,0.769,496
positive,-0.409,5602,12284,1,1,0.959,0.51,0.855,17886
infuriated,-0.409,30,67,1,1,0.073,0.93,0.51,97
wear,-0.409,2488,5459,1,1,0.312,0.37,0.255,7947
utmost,-0.409,97,214,1,1,0.719,0.74,0.858,311
manageable,-0.41,107,236,1,1,0.75,0.361,0.655,343
navigate,-0.411,299,658,1,1,0.74,0.555,0.675,957
instructions,-0.411,115,254,1,1,0.582,0.302,0.556,369
punished,-0.411,236,520,1,1,0.177,0.735,0.481,756
dislike,-0.412,1053,2317,1,1,0.156,0.406,0.321,3370
shoddy,-0.412,19,43,1,1,0.082,0.463,0.179,62
subsidize,-0.412,9,21,1,1,0.604,0.615,0.589,30
owing,-0.412,34,76,1,1,0.396,0.307,0.381,110
nab,-0.412,24,54,1,1,0.469,0.544,0.407,78
modem,-0.412,14,32,1,1,0.573,0.355,0.5,46
dispenser,-0.412,19,43,1,1,0.583,0.392,0.47,62
gallbladder,-0.412,9,21,1,1,0.354,0.471,0.472,30
monastic,-0.412,9,21,1,1,0.438,0.314,0.676,30
reconstruct,-0.412,9,21,1,1,0.74,0.618,0.718,30
courteous,-0.412,19,43,1,1,0.937,0.396,0.529,62
redesign,-0.412,19,43,1,1,0.622,0.46,0.396,62
relegation,-0.412,9,21,1,1,0.375,0.5,0.434,30
treachery,-0.412,34,76,1,1,0.104,0.852,0.448,110
sanctity,-0.412,19,43,1,1,0.771,0.33,0.628,62
cancellation,-0.412,34,76,1,1,0.224,0.431,0.389,110
puzzling,-0.412,14,32,1,1,0.296,0.644,0.353,46
inhaler,-0.412,19,43,1,1,0.408,0.5,0.349,62
rethink,-0.412,174,384,1,1,0.48,0.423,0.583,558
birthplace,-0.412,9,21,1,1,0.781,0.29,0.491,30
franchise,-0.412,149,329,1,1,0.663,0.4,0.56,478
misspell,-0.412,14,32,1,1,0.292,0.423,0.281,46
variety,-0.412,433,954,1,1,0.714,0.472,0.598,1387
vomit,-0.413,188,415,1,1,0.073,0.569,0.188,603
questioning,-0.413,664,1463,1,1,0.438,0.696,0.509,2127
rug,-0.413,118,261,1,1,0.52,0.24,0.245,379
rep,-0.414,358,790,1,1,0.52,0.51,0.64,1148
evidence,-0.414,1096,2417,1,1,0.5,0.5,0.778,3513
straw,-0.414,165,365,1,1,0.48,0.29,0.163,530
tactics,-0.414,199,440,1,1,0.583,0.676,0.774,639
advancing,-0.415,33,74,1,1,0.929,0.608,0.812,107
paperwork,-0.415,101,224,1,1,0.448,0.355,0.422,325
colleague,-0.415,402,888,1,1,0.74,0.413,0.6,1290
granddad,-0.415,28,63,1,1,0.74,0.248,0.461,91
unequivocally,-0.415,28,63,1,1,0.521,0.668,0.554,91
raising,-0.415,873,1928,1,1,0.735,0.519,0.643,2801
clique,-0.416,240,531,1,1,0.427,0.43,0.391,771
mesmerized,-0.416,47,105,1,1,0.52,0.552,0.421,152
fascism,-0.416,114,253,1,1,0.104,0.74,0.695,367
disingenuous,-0.416,66,147,1,1,0.194,0.509,0.204,213
worrying,-0.416,1189,2628,1,1,0.047,0.75,0.296,3817
fuming,-0.417,61,136,1,1,0.24,0.66,0.481,197
nauseous,-0.417,137,304,1,1,0.135,0.78,0.284,441
relive,-0.417,151,335,1,1,0.75,0.65,0.693,486
gluten,-0.417,37,83,1,1,0.385,0.308,0.388,120
collusion,-0.417,122,271,1,1,0.365,0.51,0.4,393
steadfast,-0.417,51,114,1,1,0.771,0.433,0.8,165
grid,-0.418,117,260,1,1,0.562,0.426,0.443,377
understand,-0.418,25573,56568,1,1,0.76,0.374,0.643,82141
urgency,-0.418,60,134,1,1,0.429,0.908,0.543,194
uranium,-0.419,13,30,1,1,0.375,0.58,0.49,43
bloodshed,-0.419,13,30,1,1,0.048,0.942,0.525,43
retain,-0.419,69,154,1,1,0.367,0.451,0.63,223
proficient,-0.419,13,30,1,1,0.854,0.461,0.817,43
sweating,-0.419,167,371,1,1,0.292,0.667,0.265,538
commandment,-0.419,13,30,1,1,0.656,0.49,0.876,43
awesomeness,-0.419,50,112,1,1,0.917,0.647,0.927,162
noise,-0.419,2013,4462,1,1,0.26,0.883,0.388,6475
reasoning,-0.42,229,509,1,1,0.729,0.365,0.729,738
skeptic,-0.42,22,50,1,1,0.135,0.44,0.5,72
intrusion,-0.42,22,50,1,1,0.293,0.641,0.67,72
afresh,-0.42,22,50,1,1,0.643,0.521,0.48,72
irreversible,-0.42,22,50,1,1,0.17,0.541,0.667,72
conclusion,-0.42,1705,3783,1,1,0.615,0.377,0.659,5488
specialist,-0.42,109,243,1,1,0.76,0.562,0.877,352
rough,-0.421,3348,7429,1,1,0.406,0.794,0.632,10777
dismantle,-0.421,31,70,1,1,0.347,0.644,0.462,101
budget,-0.421,350,778,1,1,0.643,0.396,0.731,1128
unaccompanied,-0.421,40,90,1,1,0.292,0.376,0.297,130
uplift,-0.421,163,363,1,1,0.656,0.779,0.771,526
government,-0.421,2258,5014,1,1,0.427,0.53,0.85,7272
infinity,-0.421,326,725,1,1,0.516,0.459,0.805,1051
grated,-0.422,8,19,1,1,0.357,0.462,0.361,27
extraction,-0.422,17,39,1,1,0.418,0.74,0.526,56
ajar,-0.422,17,39,1,1,0.46,0.413,0.446,56
reformation,-0.422,8,19,1,1,0.809,0.5,0.558,27
permit,-0.422,80,179,1,1,0.733,0.349,0.518,259
playhouse,-0.422,8,19,1,1,0.719,0.729,0.426,27
crock,-0.422,35,79,1,1,0.385,0.412,0.421,114
polling,-0.423,93,208,1,1,0.448,0.598,0.602,301
terms,-0.423,1825,4059,1,1,0.49,0.362,0.645,5884
unprotected,-0.423,66,148,1,1,0.15,0.582,0.197,214
spinal,-0.423,48,108,1,1,0.312,0.491,0.296,156
humbled,-0.423,128,286,1,1,0.28,0.618,0.198,414
tolerate,-0.423,661,1472,1,1,0.724,0.43,0.588,2133
legislative,-0.424,30,68,1,1,0.633,0.365,0.8,98
stutter,-0.424,61,137,1,1,0.25,0.469,0.258,198
learned,-0.425,5993,13350,1,1,0.704,0.462,0.543,19343
reliance,-0.425,78,175,1,1,0.844,0.431,0.853,253
inconvenient,-0.425,95,213,1,1,0.224,0.61,0.375,308
suspicions,-0.425,60,135,1,1,0.208,0.745,0.5,195
paycheck,-0.426,199,445,1,1,0.896,0.63,0.652,644
option,-0.426,2381,5312,1,1,0.512,0.427,0.359,7693
firewood,-0.426,12,28,1,1,0.52,0.348,0.263,40
sectarian,-0.426,12,28,1,1,0.26,0.606,0.517,40
juncture,-0.426,12,28,1,1,0.365,0.582,0.491,40
economy,-0.426,478,1068,1,1,0.583,0.434,0.771,1546
paving,-0.427,42,95,1,1,0.408,0.469,0.545,137
braces,-0.427,59,133,1,1,0.5,0.337,0.568,192
chore,-0.427,123,276,1,1,0.406,0.462,0.5,399
traitorous,-0.428,50,113,1,1,0.073,0.745,0.412,163
rejuvenated,-0.428,16,37,1,1,0.809,0.673,0.7,53
setback,-0.428,50,113,1,1,0.198,0.451,0.25,163
gatorade,-0.428,33,75,1,1,0.719,0.529,0.519,108
statute,-0.428,16,37,1,1,0.592,0.33,0.673,53
kaiser,-0.428,33,75,1,1,0.47,0.509,0.69,108
forgiven,-0.428,215,482,1,1,0.75,0.302,0.51,697
fiber,-0.429,75,169,1,1,0.719,0.284,0.39,244
innocuous,-0.429,20,46,1,1,0.51,0.321,0.172,66
delay,-0.43,179,402,1,1,0.204,0.51,0.162,581
minimize,-0.43,74,167,1,1,0.36,0.236,0.311,241
minimum,-0.431,488,1095,1,1,0.38,0.198,0.194,1583
mandatory,-0.431,115,259,1,1,0.271,0.667,0.777,374
binder,-0.431,28,64,1,1,0.438,0.25,0.308,92
decision,-0.431,2552,5725,1,1,0.646,0.51,0.839,8277
mathematics,-0.432,36,82,1,1,0.438,0.435,0.664,118
tumor,-0.432,77,174,1,1,0.102,0.664,0.324,251
alliance,-0.432,179,403,1,1,0.696,0.473,0.769,582
difficulties,-0.432,464,1043,1,1,0.082,0.784,0.357,1507
room,-0.433,29206,65596,1,1,0.729,0.283,0.445,94802
carry,-0.433,2942,6612,1,1,0.635,0.38,0.5,9554
methodology,-0.435,15,35,1,1,0.664,0.327,0.745,50
elimination,-0.435,23,53,1,1,0.052,0.667,0.431,76
simples,-0.435,11,26,1,1,0.724,0.24,0.263,37
inefficient,-0.435,19,44,1,1,0.19,0.46,0.173,63
swivel,-0.435,11,26,1,1,0.562,0.48,0.5,37
variable,-0.435,27,62,1,1,0.62,0.407,0.4,89
irresponsible,-0.435,159,359,1,1,0.177,0.68,0.241,518
interim,-0.435,31,71,1,1,0.604,0.4,0.524,102
primitive,-0.435,43,98,1,1,0.323,0.388,0.361,141
inconsistent,-0.436,110,249,1,1,0.271,0.431,0.295,359
allowed,-0.436,3642,8206,1,1,0.73,0.36,0.655,11848
massacre,-0.436,78,177,1,1,0.031,0.887,0.64,255
impossible,-0.437,2020,4557,1,1,0.153,0.51,0.407,6577
mosque,-0.437,81,184,1,1,0.542,0.352,0.528,265
cutter,-0.438,34,78,1,1,0.427,0.731,0.583,112
scream,-0.438,2401,5421,1,1,0.188,0.863,0.594,7822
care,-0.438,38649,87284,1,1,0.729,0.37,0.5,125933
snappy,-0.439,26,60,1,1,0.573,0.592,0.418,86
meltdown,-0.439,215,487,1,1,0.629,0.657,0.602,702
unity,-0.439,345,781,1,1,0.837,0.288,0.658,1126
dishonest,-0.439,122,277,1,1,0.191,0.491,0.163,399
undermined,-0.439,22,51,1,1,0.365,0.409,0.394,73
renewal,-0.44,41,94,1,1,0.77,0.71,0.672,135
despise,-0.44,415,940,1,1,0.167,0.745,0.296,1355
sanction,-0.44,18,42,1,1,0.201,0.75,0.517,60
conduct,-0.44,113,257,1,1,0.453,0.51,0.75,370
apt,-0.441,572,1296,1,1,0.582,0.418,0.382,1868
preview,-0.441,169,384,1,1,0.656,0.337,0.491,553
audit,-0.441,33,76,1,1,0.375,0.562,0.735,109
defect,-0.441,33,76,1,1,0.135,0.561,0.185,109
likewise,-0.441,169,384,1,1,0.651,0.217,0.312,553
appliances,-0.441,33,76,1,1,0.594,0.394,0.567,109
endgame,-0.442,537,1218,1,1,0.449,0.538,0.526,1755
diarrhea,-0.442,78,178,1,1,0.092,0.684,0.143,256
finalized,-0.442,14,33,1,1,0.245,0.21,0.608,47
spousal,-0.442,14,33,1,1,0.656,0.582,0.632,47
unconstitutional,-0.442,14,33,1,1,0.23,0.588,0.491,47
almighty,-0.442,410,931,1,1,0.938,0.874,0.958,1341
injustice,-0.442,294,668,1,1,0.082,0.755,0.444,962
relief,-0.443,1526,3463,1,1,0.844,0.278,0.481,4989
insure,-0.443,25,58,1,1,0.7,0.415,0.698,83
blackface,-0.443,25,58,1,1,0.302,0.49,0.441,83
doze,-0.443,25,58,1,1,0.592,0.2,0.405,83
outspoken,-0.444,73,167,1,1,0.582,0.413,0.667,240
kettle,-0.444,113,258,1,1,0.357,0.497,0.333,371
surround,-0.444,1701,3866,1,1,0.542,0.623,0.627,5567
diocese,-0.445,10,24,1,1,0.51,0.288,0.575,34
citation,-0.445,10,24,1,1,0.57,0.549,0.508,34
flooring,-0.445,10,24,1,1,0.562,0.235,0.346,34
papaya,-0.445,10,24,1,1,0.63,0.306,0.3,34
loudspeaker,-0.445,10,24,1,1,0.49,0.735,0.689,34
yehey,-0.445,10,24,1,1,0.49,0.53,0.298,34
cautious,-0.446,231,527,1,1,0.47,0.445,0.517,758
wade,-0.446,176,402,1,1,0.51,0.656,0.472,578
agape,-0.447,17,40,1,1,0.612,0.529,0.464,57
bandwidth,-0.447,17,40,1,1,0.714,0.337,0.548,57
physician,-0.447,71,163,1,1,0.583,0.49,0.843,234
echelon,-0.447,17,40,1,1,0.49,0.404,0.425,57
waiver,-0.447,17,40,1,1,0.396,0.63,0.373,57
inverted,-0.447,17,40,1,1,0.31,0.471,0.357,57
radiation,-0.447,60,138,1,1,0.167,0.741,0.536,198
innermost,-0.447,42,97,1,1,0.583,0.5,0.51,139
tactic,-0.448,117,268,1,1,0.531,0.434,0.798,385
negotiation,-0.448,31,72,1,1,0.49,0.615,0.728,103
assertive,-0.449,38,88,1,1,0.719,0.412,0.77,126
parcel,-0.449,59,136,1,1,0.66,0.324,0.411,195
inappropriate,-0.449,260,595,1,1,0.135,0.542,0.353,855
heal,-0.45,3130,7150,1,1,0.765,0.245,0.556,10280
offender,-0.45,80,184,1,1,0.104,0.851,0.537,264
emergency,-0.45,645,1475,1,1,0.2,0.9,0.571,2120
help,-0.45,57805,132078,1,1,0.673,0.471,0.46,189883
certificate,-0.45,62,143,1,1,0.786,0.377,0.746,205
scuba,-0.45,13,31,1,1,0.542,0.494,0.456,44
amendment,-0.45,111,255,1,1,0.531,0.459,0.606,366
exorcism,-0.45,13,31,1,1,0.163,0.98,0.557,44
rabble,-0.45,13,31,1,1,0.184,0.602,0.292,44
intractable,-0.45,13,31,1,1,0.154,0.694,0.302,44
reserves,-0.45,27,63,1,1,0.653,0.363,0.52,90
irrespective,-0.45,62,143,1,1,0.497,0.538,0.745,205
acoustics,-0.45,13,31,1,1,0.611,0.33,0.509,44
decorative,-0.45,13,31,1,1,0.908,0.46,0.381,44
ardent,-0.45,20,47,1,1,0.694,0.873,0.722,67
sinus,-0.45,27,63,1,1,0.531,0.563,0.34,90
constrained,-0.45,13,31,1,1,0.135,0.537,0.357,44
capacity,-0.451,501,1147,1,1,0.719,0.411,0.806,1648
indigenous,-0.451,121,278,1,1,0.5,0.509,0.552,399
dryer,-0.451,121,278,1,1,0.479,0.343,0.277,399
unreasonable,-0.451,107,246,1,1,0.115,0.702,0.264,353
legally,-0.451,239,548,1,1,0.771,0.482,0.842,787
unprepared,-0.451,58,134,1,1,0.204,0.45,0.152,192
mourn,-0.452,342,784,1,1,0.056,0.583,0.15,1126
clear,-0.452,3486,7981,1,1,0.857,0.327,0.573,11467
intending,-0.452,30,70,1,1,0.51,0.567,0.597,100
opt,-0.452,92,212,1,1,0.51,0.471,0.345,304
accomplice,-0.453,23,54,1,1,0.408,0.58,0.51,77
attorney,-0.453,136,313,1,1,0.6,0.594,0.754,449
cabin,-0.453,468,1074,1,1,0.643,0.292,0.43,1542
stall,-0.453,170,391,1,1,0.37,0.245,0.292,561
supportive,-0.454,1399,3210,1,1,0.875,0.42,0.635,4609
volume,-0.454,558,1282,1,1,0.552,0.49,0.546,1840
temper,-0.455,239,550,1,1,0.633,0.623,0.818,789
circumstances,-0.455,944,2169,1,1,0.562,0.527,0.464,3113
housekeeper,-0.455,26,61,1,1,0.694,0.279,0.52,87
tsunami,-0.455,63,146,1,1,0.042,0.944,0.684,209
transparent,-0.455,221,509,1,1,0.542,0.33,0.667,730
climate,-0.456,597,1373,1,1,0.635,0.24,0.483,1970
furnish,-0.457,9,22,1,1,0.755,0.487,0.49,31
invalidation,-0.457,9,22,1,1,0.181,0.49,0.278,31
invulnerable,-0.457,9,22,1,1,0.552,0.683,0.745,31
adhere,-0.457,29,68,1,1,0.633,0.339,0.554,97
plurality,-0.457,9,22,1,1,0.683,0.473,0.587,31
answerable,-0.457,9,22,1,1,0.708,0.481,0.75,31
vaccination,-0.457,9,22,1,1,0.53,0.578,0.621,31
yaaaay,-0.457,39,91,1,1,0.625,0.677,0.326,130
castration,-0.457,9,22,1,1,0.198,0.735,0.381,31
cellulite,-0.457,9,22,1,1,0.2,0.384,0.256,31
carte,-0.457,9,22,1,1,0.592,0.32,0.274,31
jury,-0.457,92,213,1,1,0.479,0.607,0.789,305
alarming,-0.458,124,287,1,1,0.204,0.89,0.585,411
inhumanity,-0.458,22,52,1,1,0.143,0.54,0.405,74
wary,-0.458,137,317,1,1,0.51,0.343,0.535,454
sect,-0.458,45,105,1,1,0.265,0.667,0.526,150
priest,-0.459,366,845,1,1,0.561,0.324,0.648,1211
suspend,-0.459,35,82,1,1,0.24,0.32,0.368,117
donor,-0.459,71,165,1,1,0.714,0.49,0.653,236
suppression,-0.459,48,112,1,1,0.267,0.541,0.537,160
proof,-0.459,1243,2868,1,1,0.438,0.509,0.619,4111
visa,-0.459,110,255,1,1,0.735,0.367,0.66,365
pee,-0.46,484,1118,1,1,0.449,0.529,0.391,1602
quagmire,-0.46,12,29,1,1,0.318,0.48,0.413,41
bankruptcy,-0.46,64,149,1,1,0.01,0.696,0.209,213
household,-0.46,535,1236,1,1,0.781,0.23,0.667,1771
revise,-0.461,41,96,1,1,0.5,0.469,0.509,137
targeted,-0.461,292,676,1,1,0.573,0.537,0.573,968
clarity,-0.461,395,914,1,1,0.796,0.31,0.631,1309
immigration,-0.461,237,549,1,1,0.39,0.667,0.454,786
defended,-0.461,89,207,1,1,0.663,0.451,0.582,296
precinct,-0.462,15,36,1,1,0.375,0.431,0.527,51
threatened,-0.462,415,961,1,1,0.052,0.928,0.354,1376
faulty,-0.462,47,110,1,1,0.184,0.52,0.378,157
buyer,-0.462,31,73,1,1,0.613,0.519,0.649,104
wiring,-0.462,15,36,1,1,0.49,0.367,0.431,51
trial,-0.462,446,1033,1,1,0.438,0.663,0.612,1479
progress,-0.463,1156,2676,1,1,0.88,0.642,0.877,3832
disrupting,-0.463,34,80,1,1,0.186,0.557,0.339,114
federal,-0.463,336,779,1,1,0.53,0.459,0.859,1115
province,-0.463,129,300,1,1,0.714,0.255,0.471,429
incontinence,-0.463,18,43,1,1,0.15,0.598,0.272,61
courage,-0.464,3050,7068,1,1,0.83,0.728,0.849,10118
strengthen,-0.464,276,641,1,1,0.802,0.796,0.971,917
paramedic,-0.465,24,57,1,1,0.673,0.464,0.636,81
insistence,-0.465,24,57,1,1,0.418,0.704,0.645,81
attack,-0.465,2982,6920,1,1,0.286,0.948,0.67,9902
lawless,-0.466,27,64,1,1,0.219,0.69,0.42,91
impartial,-0.466,27,64,1,1,0.531,0.406,0.685,91
denied,-0.467,348,810,1,1,0.188,0.604,0.333,1158
hostage,-0.467,184,429,1,1,0.163,0.923,0.325,613
unload,-0.468,51,120,1,1,0.656,0.639,0.573,171
burden,-0.468,2298,5349,1,1,0.367,0.583,0.697,7647
refreshing,-0.469,643,1498,1,1,0.936,0.52,0.571,2141
reflect,-0.469,1232,2871,1,1,0.698,0.342,0.472,4103
lowest,-0.469,822,1916,1,1,0.312,0.304,0.129,2738
windy,-0.469,263,614,1,1,0.33,0.541,0.528,877
cheerleader,-0.469,90,211,1,1,0.923,0.746,0.657,301
overload,-0.47,102,239,1,1,0.381,0.69,0.652,341
shocked,-0.471,795,1856,1,1,0.292,0.773,0.375,2651
bungee,-0.471,8,20,1,1,0.637,0.545,0.327,28
checkup,-0.471,17,41,1,1,0.5,0.435,0.491,58
teflon,-0.471,11,27,1,1,0.354,0.245,0.434,38
eruption,-0.471,8,20,1,1,0.156,0.913,0.733,28
swastika,-0.471,8,20,1,1,0.316,0.472,0.491,28
unwillingly,-0.471,17,41,1,1,0.204,0.548,0.182,58
softener,-0.471,8,20,1,1,0.745,0.3,0.373,28
stylist,-0.471,32,76,1,1,0.76,0.445,0.5,108
specs,-0.471,26,62,1,1,0.54,0.398,0.618,88
onus,-0.471,17,41,1,1,0.562,0.52,0.769,58
commando,-0.471,17,41,1,1,0.323,0.71,0.817,58
rein,-0.471,26,62,1,1,0.5,0.357,0.438,88
processor,-0.471,11,27,1,1,0.685,0.46,0.673,38
operational,-0.471,11,27,1,1,0.562,0.57,0.679,38
untenable,-0.471,14,34,1,1,0.143,0.637,0.425,48
celery,-0.471,29,69,1,1,0.396,0.147,0.223,98
kosher,-0.471,11,27,1,1,0.469,0.443,0.312,38
backfire,-0.471,50,118,1,1,0.265,0.612,0.491,168
retaining,-0.471,14,34,1,1,0.417,0.559,0.632,48
exasperation,-0.471,14,34,1,1,0.214,0.833,0.483,48
waltz,-0.471,128,300,1,1,0.769,0.41,0.315,428
rehearse,-0.471,20,48,1,1,0.588,0.622,0.5,68
decompose,-0.471,8,20,1,1,0.194,0.596,0.241,28
gratified,-0.471,8,20,1,1,0.781,0.519,0.702,28
trained,-0.471,457,1068,1,1,0.771,0.538,0.645,1525
assistance,-0.472,378,884,1,1,0.656,0.519,0.633,1262
id,-0.472,3456,8074,1,1,0.449,0.344,0.391,11530
encouraged,-0.472,492,1151,1,1,0.953,0.702,0.657,1643
relieving,-0.472,192,450,1,1,0.74,0.255,0.455,642
disheartened,-0.473,70,165,1,1,0.153,0.343,0.238,235
shaking,-0.473,824,1928,1,1,0.275,0.849,0.255,2752
voiceless,-0.473,67,158,1,1,0.271,0.235,0.131,225
stitch,-0.474,158,371,1,1,0.306,0.538,0.357,529
mike,-0.474,1220,2856,1,1,0.542,0.365,0.423,4076
step,-0.474,4960,11609,1,1,0.531,0.321,0.347,16569
invasion,-0.474,131,308,1,1,0.271,0.843,0.808,439
embarrass,-0.475,136,320,1,1,0.082,0.667,0.364,456
cautiously,-0.475,31,74,1,1,0.51,0.388,0.525,105
uncomfortable,-0.475,2172,5092,1,1,0.188,0.61,0.214,7264
taxpayer,-0.476,60,142,1,1,0.592,0.528,0.647,202
presumption,-0.476,28,67,1,1,0.375,0.596,0.518,95
victim,-0.476,1678,3936,1,1,0.115,0.676,0.202,5614
subjected,-0.477,100,236,1,1,0.286,0.52,0.221,336
respected,-0.477,445,1046,1,1,0.908,0.441,0.853,1491
grasshopper,-0.477,22,53,1,1,0.5,0.462,0.287,75
centipede,-0.477,22,53,1,1,0.296,0.399,0.361,75
policy,-0.478,725,1705,1,1,0.324,0.735,0.833,2430
legislature,-0.478,19,46,1,1,0.54,0.435,0.698,65
politic,-0.478,19,46,1,1,0.365,0.581,0.798,65
thorough,-0.479,53,126,1,1,0.467,0.35,0.558,179
public,-0.479,4874,11466,1,1,0.592,0.51,0.664,16340
yesss,-0.48,381,898,1,1,0.719,0.657,0.451,1279
illegitimate,-0.48,47,112,1,1,0.184,0.644,0.302,159
nightmare,-0.481,1382,3257,1,1,0.005,0.81,0.436,4639
harm,-0.481,1286,3031,1,1,0.073,0.679,0.423,4317
sisterhood,-0.481,100,237,1,1,0.837,0.415,0.696,337
loud,-0.481,4340,10231,1,1,0.573,0.65,0.87,14571
nauseating,-0.481,41,98,1,1,0.021,0.64,0.25,139
mystified,-0.481,13,32,1,1,0.344,0.6,0.509,45
terrorism,-0.481,175,414,1,1,0.06,0.971,0.673,589
intolerance,-0.482,77,183,1,1,0.052,0.704,0.52,260
retaliation,-0.483,35,84,1,1,0.156,0.812,0.491,119
vendetta,-0.483,35,84,1,1,0.198,0.784,0.583,119
interrupting,-0.483,82,195,1,1,0.146,0.593,0.509,277
pact,-0.483,93,221,1,1,0.442,0.444,0.593,314
undermine,-0.483,68,162,1,1,0.316,0.491,0.413,230
verbatim,-0.484,21,51,1,1,0.562,0.255,0.574,72
roadblock,-0.484,10,25,1,1,0.337,0.669,0.49,35
consummate,-0.484,10,25,1,1,0.551,0.54,0.558,35
hinder,-0.484,98,233,1,1,0.276,0.537,0.47,331
renovated,-0.484,10,25,1,1,0.783,0.406,0.657,35
stake,-0.484,125,297,1,1,0.406,0.608,0.46,422
worries,-0.485,1592,3769,1,1,0.094,0.679,0.363,5361
compliance,-0.485,29,70,1,1,0.75,0.462,0.75,99
protocol,-0.485,59,141,1,1,0.178,0.5,0.786,200
happen,-0.485,8006,18952,1,1,0.677,0.67,0.551,26958
respecting,-0.485,146,347,1,1,0.837,0.321,0.72,493
stalls,-0.485,48,115,1,1,0.582,0.378,0.451,163
marry,-0.486,3157,7476,1,1,0.896,0.765,0.673,10633
confirmed,-0.486,518,1228,1,1,0.76,0.49,0.764,1746
disapprove,-0.486,18,44,1,1,0.16,0.594,0.445,62
jigsaw,-0.486,56,134,1,1,0.594,0.582,0.519,190
supervise,-0.486,18,44,1,1,0.698,0.555,0.889,62
airline,-0.486,56,134,1,1,0.65,0.482,0.688,190
censorship,-0.486,72,172,1,1,0.219,0.698,0.421,244
refrigerator,-0.486,72,172,1,1,0.677,0.26,0.391,244
absentee,-0.487,26,63,1,1,0.235,0.33,0.279,89
stressing,-0.488,546,1297,1,1,0.163,0.866,0.462,1843
infant,-0.488,133,317,1,1,0.802,0.431,0.328,450
ilk,-0.488,74,177,1,1,0.438,0.451,0.455,251
door,-0.488,6150,14599,1,1,0.549,0.189,0.421,20749
judge,-0.488,2837,6738,1,1,0.51,0.604,0.857,9575
sideshow,-0.489,7,18,1,1,0.458,0.594,0.658,25
infancy,-0.489,15,37,1,1,0.75,0.399,0.37,52
angling,-0.489,7,18,1,1,0.625,0.408,0.5,25
perplexing,-0.489,15,37,1,1,0.316,0.53,0.362,52
diagnostic,-0.489,15,37,1,1,0.417,0.483,0.635,52
daresay,-0.489,7,18,1,1,0.54,0.451,0.49,25
jib,-0.489,7,18,1,1,0.406,0.42,0.413,25
telepathic,-0.489,15,37,1,1,0.602,0.49,0.642,52
behave,-0.49,419,998,1,1,0.677,0.363,0.747,1417
empathize,-0.491,278,663,1,1,0.802,0.591,0.66,941
resigned,-0.491,212,506,1,1,0.24,0.17,0.268,718
coy,-0.491,20,49,1,1,0.347,0.33,0.213,69
visitation,-0.492,33,80,1,1,0.729,0.346,0.534,113
rubble,-0.492,33,80,1,1,0.308,0.509,0.289,113
cannabis,-0.492,80,192,1,1,0.271,0.5,0.564,272
lodging,-0.493,12,30,1,1,0.713,0.286,0.527,42
disordered,-0.493,38,92,1,1,0.21,0.714,0.288,130
employer,-0.494,102,245,1,1,0.663,0.518,0.767,347
queasy,-0.494,17,42,1,1,0.25,0.587,0.225,59
acne,-0.495,163,391,1,1,0.167,0.474,0.308,554
clapper,-0.496,22,54,1,1,0.5,0.229,0.42,76
chrome,-0.496,78,188,1,1,0.582,0.373,0.421,266
terminology,-0.496,27,66,1,1,0.612,0.284,0.566,93
command,-0.497,260,624,1,1,0.427,0.79,0.849,884
cancel,-0.497,642,1539,1,1,0.214,0.306,0.368,2181
positivity,-0.497,862,2066,1,1,0.959,0.549,0.87,2928
refusing,-0.498,299,718,1,1,0.143,0.67,0.203,1017
pharmacy,-0.498,82,198,1,1,0.531,0.337,0.542,280
handle,-0.498,4899,11750,1,1,0.698,0.571,0.558,16649
shutdown,-0.499,350,841,1,1,0.173,0.367,0.418,1191
trending,-0.499,287,690,1,1,0.75,0.472,0.6,977
movement,-0.499,1100,2641,1,1,0.656,0.654,0.658,3741
thermometer,-0.499,9,23,1,1,0.4,0.327,0.473,32
coax,-0.499,14,35,1,1,0.367,0.4,0.447,49
cursory,-0.499,9,23,1,1,0.423,0.451,0.431,32
populous,-0.499,9,23,1,1,0.52,0.63,0.725,32
embassy,-0.499,59,143,1,1,0.622,0.333,0.758,202
disobedient,-0.499,9,23,1,1,0.276,0.706,0.353,32
suspense,-0.499,64,155,1,1,0.286,0.775,0.402,219
clinic,-0.499,224,539,1,1,0.469,0.439,0.6,763
neurological,-0.499,29,71,1,1,0.5,0.54,0.558,100
undetected,-0.499,9,23,1,1,0.224,0.304,0.268,32
permission,-0.499,379,911,1,1,0.612,0.311,0.58,1290
investigative,-0.499,29,71,1,1,0.562,0.6,0.704,100
supplemental,-0.499,9,23,1,1,0.604,0.404,0.555,32
legitimacy,-0.499,29,71,1,1,0.823,0.42,0.855,100
resisting,-0.5,116,280,1,1,0.408,0.776,0.789,396
needles,-0.501,113,273,1,1,0.25,0.602,0.348,386
bugged,-0.501,46,112,1,1,0.561,0.439,0.5,158
legal,-0.501,666,1603,1,1,0.653,0.387,0.887,2269
organize,-0.501,162,391,1,1,0.802,0.655,0.781,553
unfit,-0.502,100,242,1,1,0.25,0.368,0.185,342
reasonable,-0.502,382,921,1,1,0.902,0.337,0.726,1303
handwriting,-0.502,53,129,1,1,0.615,0.378,0.381,182
carnage,-0.502,26,64,1,1,0.406,0.6,0.558,90
uncommon,-0.502,129,312,1,1,0.459,0.429,0.373,441
file,-0.502,232,560,1,1,0.48,0.316,0.463,792
disbelief,-0.503,136,329,1,1,0.188,0.409,0.373,465
hearing,-0.503,3631,8752,1,1,0.669,0.49,0.595,12383
irrational,-0.503,338,816,1,1,0.125,0.648,0.394,1154
agoraphobia,-0.504,67,163,1,1,0.127,0.712,0.438,230
campaigner,-0.504,16,40,1,1,0.592,0.698,0.821,56
nasal,-0.504,16,40,1,1,0.479,0.34,0.33,56
oppressor,-0.504,16,40,1,1,0.16,0.776,0.629,56
revelations,-0.504,50,122,1,1,0.729,0.655,0.6,172
afloat,-0.504,118,286,1,1,0.602,0.427,0.444,404
stresses,-0.504,222,537,1,1,0.115,0.817,0.396,759
be,-0.505,752734,1816839,1,1,0.67,0.24,0.554,2569573
facet,-0.505,40,98,1,1,0.667,0.324,0.382,138
inconvenience,-0.506,141,342,1,1,0.063,0.667,0.291,483
succeed,-0.506,667,1613,1,1,0.926,0.755,0.926,2280
lurch,-0.506,11,28,1,1,0.404,0.694,0.363,39
tenant,-0.506,35,86,1,1,0.385,0.36,0.398,121
abomination,-0.506,71,173,1,1,0.078,0.755,0.518,244
catholic,-0.506,493,1193,1,1,0.646,0.24,0.575,1686
dine,-0.507,140,340,1,1,0.821,0.519,0.478,480
decor,-0.507,61,149,1,1,0.734,0.311,0.573,210
reform,-0.508,125,304,1,1,0.531,0.49,0.797,429
abuse,-0.508,2901,7024,1,1,0.071,0.873,0.469,9925
blacklist,-0.508,18,45,1,1,0.133,0.75,0.396,63
restorative,-0.509,25,62,1,1,0.633,0.51,0.703,87
reproductive,-0.509,51,125,1,1,0.77,0.604,0.856,176
panicked,-0.509,162,394,1,1,0.1,0.949,0.26,556
apartment,-0.509,5514,13365,1,1,0.719,0.393,0.58,18879
freezer,-0.509,150,365,1,1,0.396,0.406,0.407,515
curate,-0.509,32,79,1,1,0.726,0.418,0.526,111
implement,-0.509,65,159,1,1,0.72,0.573,0.792,224
appalling,-0.509,152,370,1,1,0.16,0.827,0.415,522
blatant,-0.51,133,324,1,1,0.327,0.677,0.675,457
coaster,-0.51,250,608,1,1,0.612,0.788,0.627,858
occurrence,-0.51,74,181,1,1,0.573,0.69,0.541,255
interrogation,-0.511,20,50,1,1,0.302,0.827,0.657,70
intake,-0.511,62,152,1,1,0.604,0.527,0.442,214
alarmed,-0.511,48,118,1,1,0.188,0.822,0.492,166
discriminating,-0.511,20,50,1,1,0.16,0.783,0.462,70
opinion,-0.511,3563,8655,1,1,0.594,0.482,0.638,12218
peace,-0.511,12038,29243,1,1,0.939,0.156,0.613,41281
citizen,-0.512,389,947,1,1,0.631,0.25,0.586,1336
deserve,-0.512,13479,32766,1,1,0.802,0.436,0.613,46245
appointment,-0.512,430,1047,1,1,0.688,0.594,0.547,1477
zone,-0.512,1929,4692,1,1,0.531,0.349,0.382,6621
yell,-0.512,656,1597,1,1,0.24,0.798,0.558,2253
dossier,-0.514,22,55,1,1,0.357,0.38,0.544,77
agreement,-0.514,244,596,1,1,0.76,0.44,0.736,840
abdomen,-0.515,15,38,1,1,0.469,0.462,0.471,53
septic,-0.515,15,38,1,1,0.281,0.462,0.425,53
screwed,-0.515,471,1150,1,1,0.302,0.52,0.464,1621
indignation,-0.516,24,60,1,1,0.173,0.778,0.431,84
digestive,-0.516,24,60,1,1,0.542,0.413,0.434,84
glitch,-0.516,83,204,1,1,0.444,0.448,0.269,287
know,-0.516,223511,545591,1,1,0.765,0.361,0.704,769102
stabbed,-0.517,222,544,1,1,0.031,0.875,0.431,766
inflection,-0.517,8,21,1,1,0.385,0.635,0.377,29
securities,-0.517,8,21,1,1,0.75,0.304,0.852,29
regenerate,-0.517,17,43,1,1,0.782,0.607,0.767,60
indecent,-0.517,17,43,1,1,0.083,0.683,0.24,60
advised,-0.517,107,263,1,1,0.823,0.33,0.509,370
sprain,-0.517,8,21,1,1,0.063,0.58,0.384,29
yayyyy,-0.517,35,87,1,1,0.677,0.613,0.363,122
bedside,-0.517,71,175,1,1,0.604,0.167,0.375,246
precedent,-0.517,35,87,1,1,0.574,0.392,0.721,122
aggravation,-0.517,17,43,1,1,0.071,0.784,0.613,60
excision,-0.517,8,21,1,1,0.26,0.48,0.519,29
encouragement,-0.518,689,1686,1,1,0.865,0.7,0.759,2375
encouraging,-0.518,690,1689,1,1,0.823,0.583,0.755,2379
plumber,-0.518,46,114,1,1,0.327,0.51,0.448,160
margin,-0.519,37,92,1,1,0.5,0.219,0.331,129
responsible,-0.519,1046,2562,1,1,0.837,0.527,0.833,3608
protection,-0.519,579,1419,1,1,0.863,0.53,0.664,1998
apostle,-0.519,28,70,1,1,0.646,0.347,0.732,98
prostate,-0.519,28,70,1,1,0.323,0.51,0.438,98
wellness,-0.519,166,408,1,1,0.969,0.441,0.73,574
coordinate,-0.52,30,75,1,1,0.698,0.429,0.694,105
midterm,-0.521,63,156,1,1,0.427,0.337,0.425,219
ringing,-0.521,319,784,1,1,0.724,0.598,0.693,1103
crisis,-0.521,1836,4507,1,1,0.208,0.811,0.431,6343
oversee,-0.522,10,26,1,1,0.541,0.649,0.778,36
freakout,-0.522,10,26,1,1,0.25,0.696,0.397,36
paranoid,-0.522,923,2269,1,1,0.122,0.918,0.364,3192
ear,-0.523,1847,4540,1,1,0.469,0.216,0.231,6387
taught,-0.523,3052,7502,1,1,0.814,0.481,0.642,10554
blessings,-0.523,958,2356,1,1,0.929,0.361,0.623,3314
artillery,-0.524,12,31,1,1,0.35,0.912,0.794,43
rioting,-0.524,12,31,1,1,0.156,0.949,0.56,43
garment,-0.524,12,31,1,1,0.531,0.333,0.38,43
prenatal,-0.524,12,31,1,1,0.74,0.422,0.445,43
sycamore,-0.524,12,31,1,1,0.5,0.401,0.527,43
commonwealth,-0.524,38,95,1,1,0.63,0.406,0.702,133
showy,-0.524,12,31,1,1,0.698,0.657,0.661,43
supporting,-0.525,2224,5480,1,1,0.634,0.49,0.764,7704
curriculum,-0.525,40,100,1,1,0.708,0.306,0.62,140
nerves,-0.526,460,1135,1,1,0.333,0.783,0.264,1595
fairness,-0.526,117,290,1,1,0.74,0.317,0.552,407
scowl,-0.527,14,36,1,1,0.302,0.6,0.413,50
townhouse,-0.527,29,73,1,1,0.622,0.4,0.443,102
aluminum,-0.527,14,36,1,1,0.449,0.28,0.434,50
fridge,-0.527,676,1669,1,1,0.571,0.292,0.402,2345
utility,-0.528,48,120,1,1,0.622,0.4,0.704,168
asinine,-0.528,33,83,1,1,0.429,0.472,0.433,116
immovable,-0.528,16,41,1,1,0.48,0.31,0.571,57
deduction,-0.528,16,41,1,1,0.438,0.462,0.527,57
misuse,-0.528,50,125,1,1,0.083,0.56,0.196,175
happening,-0.529,3514,8687,1,1,0.646,0.529,0.555,12201
porridge,-0.529,18,46,1,1,0.573,0.229,0.274,64
colon,-0.529,37,93,1,1,0.449,0.394,0.384,130
ultimatum,-0.529,18,46,1,1,0.219,0.855,0.837,64
majority,-0.53,1991,4929,1,1,0.684,0.56,0.93,6920
escalating,-0.53,20,51,1,1,0.646,0.724,0.518,71
abduction,-0.53,20,51,1,1,0.062,0.99,0.673,71
clean,-0.531,2418,5991,1,1,0.827,0.17,0.5,8409
comply,-0.531,43,108,1,1,0.806,0.37,0.638,151
control,-0.531,5178,12832,1,1,0.729,0.352,0.808,18010
unhelpful,-0.531,45,113,1,1,0.104,0.32,0.118,158
evangelical,-0.532,99,247,1,1,0.602,0.389,0.602,346
felony,-0.532,24,61,1,1,0.206,0.808,0.472,85
cyclone,-0.533,28,71,1,1,0.416,0.796,0.673,99
pneumonia,-0.534,32,81,1,1,0.208,0.608,0.324,113
surgical,-0.535,36,91,1,1,0.327,0.696,0.723,127
abusive,-0.535,1113,2769,1,1,0.125,0.903,0.567,3882
believed,-0.535,1047,2605,1,1,0.5,0.562,0.547,3652
corrupt,-0.535,638,1589,1,1,0.02,0.806,0.5,2227
shoulder,-0.535,2177,5419,1,1,0.562,0.286,0.406,7596
memorize,-0.536,46,116,1,1,0.52,0.451,0.716,162
arch,-0.536,107,268,1,1,0.5,0.354,0.468,375
organized,-0.537,198,495,1,1,0.816,0.337,0.746,693
scissors,-0.537,66,166,1,1,0.458,0.462,0.302,232
safety,-0.537,1348,3362,1,1,0.708,0.491,0.868,4710
craziness,-0.538,167,418,1,1,0.238,0.908,0.255,585
outgoing,-0.538,341,852,1,1,0.65,0.472,0.538,1193
tax,-0.539,829,2072,1,1,0.26,0.481,0.534,2901
medical,-0.54,963,2408,1,1,0.583,0.373,0.616,3371
salmonella,-0.54,7,19,1,1,0.167,0.608,0.312,26
victorious,-0.54,93,234,1,1,0.884,0.886,0.946,327
reticent,-0.54,7,19,1,1,0.396,0.519,0.5,26
pegs,-0.54,9,24,1,1,0.408,0.286,0.386,33
safeguard,-0.54,25,64,1,1,0.786,0.624,0.7,89
heave,-0.54,15,39,1,1,0.716,0.588,0.664,54
shaken,-0.54,121,304,1,1,0.344,0.657,0.333,425
contingency,-0.54,13,34,1,1,0.396,0.5,0.67,47
compartment,-0.54,19,49,1,1,0.5,0.389,0.607,68
wasteful,-0.54,35,89,1,1,0.173,0.73,0.409,124
housewarming,-0.54,9,24,1,1,0.857,0.71,0.727,33
evict,-0.54,13,34,1,1,0.042,0.632,0.377,47
aghast,-0.54,13,34,1,1,0.133,0.865,0.464,47
keyed,-0.54,9,24,1,1,0.469,0.497,0.521,33
exonerate,-0.54,9,24,1,1,0.592,0.5,0.538,33
authorized,-0.54,11,29,1,1,0.76,0.458,0.815,40
cardiologist,-0.54,7,19,1,1,0.458,0.63,0.814,26
positioning,-0.54,17,44,1,1,0.615,0.49,0.795,61
growls,-0.54,31,79,1,1,0.125,0.675,0.442,110
arthritis,-0.54,85,214,1,1,0.11,0.518,0.345,299
stretcher,-0.54,7,19,1,1,0.438,0.196,0.295,26
amen,-0.541,1373,3437,1,1,0.781,0.182,0.542,4810
disgust,-0.542,316,793,1,1,0.052,0.775,0.317,1109
embarrassed,-0.542,969,2429,1,1,0.184,0.56,0.246,3398
canceling,-0.542,78,197,1,1,0.229,0.47,0.349,275
downside,-0.543,330,829,1,1,0.19,0.4,0.246,1159
utilize,-0.544,54,137,1,1,0.694,0.445,0.545,191
outrage,-0.545,261,657,1,1,0.06,0.689,0.542,918
headphones,-0.545,763,1918,1,1,0.6,0.357,0.336,2681
yay,-0.545,2107,5297,1,1,0.694,0.575,0.345,7404
synagogue,-0.545,36,92,1,1,0.531,0.3,0.544,128
socialism,-0.545,180,454,1,1,0.51,0.5,0.56,634
consultation,-0.546,65,165,1,1,0.66,0.463,0.625,230
shambles,-0.547,113,286,1,1,0.271,0.696,0.287,399
skeptical,-0.547,84,213,1,1,0.207,0.5,0.452,297
violence,-0.548,1328,3348,1,1,0.061,0.933,0.719,4676
corresponding,-0.549,22,57,1,1,0.74,0.423,0.618,79
conjuring,-0.549,41,105,1,1,0.224,0.653,0.694,146
inform,-0.55,184,466,1,1,0.723,0.582,0.679,650
refuse,-0.55,2328,5879,1,1,0.18,0.52,0.331,8207
department,-0.55,532,1345,1,1,0.708,0.358,0.642,1877
unfortunately,-0.55,2449,6188,1,1,0.104,0.494,0.281,8637
reiterate,-0.552,50,128,1,1,0.422,0.451,0.655,178
conserve,-0.552,16,42,1,1,0.69,0.347,0.573,58
administer,-0.552,16,42,1,1,0.635,0.425,0.86,58
peril,-0.552,50,128,1,1,0.052,0.91,0.518,178
belittled,-0.552,48,123,1,1,0.177,0.392,0.226,171
archbishop,-0.553,14,37,1,1,0.622,0.28,0.776,51
yaay,-0.553,29,75,1,1,0.604,0.575,0.327,104
veterinary,-0.553,14,37,1,1,0.656,0.45,0.603,51
governmental,-0.555,12,32,1,1,0.521,0.541,0.906,44
bystander,-0.555,38,98,1,1,0.48,0.462,0.491,136
assist,-0.555,242,616,1,1,0.833,0.435,0.629,858
discourage,-0.556,73,187,1,1,0.184,0.443,0.267,260
teamwork,-0.558,78,200,1,1,0.918,0.49,0.773,278
promise,-0.558,9678,24633,1,1,0.823,0.5,0.704,34311
speechless,-0.558,287,732,1,1,0.459,0.32,0.315,1019
adversary,-0.558,21,55,1,1,0.349,0.777,0.457,76
seared,-0.558,10,27,1,1,0.229,0.41,0.398,37
judicial,-0.558,43,111,1,1,0.378,0.667,0.833,154
evaluate,-0.559,101,259,1,1,0.663,0.64,0.649,360
contracted,-0.56,19,50,1,1,0.344,0.557,0.449,69
security,-0.56,1333,3403,1,1,0.837,0.36,0.821,4736
forbid,-0.562,219,561,1,1,0.115,0.686,0.598,780
faith,-0.562,4493,11483,1,1,0.833,0.22,0.763,15976
sidebar,-0.562,8,22,1,1,0.469,0.364,0.405,30
energize,-0.562,17,45,1,1,0.792,0.81,0.875,62
pantry,-0.562,62,160,1,1,0.622,0.294,0.312,222
extermination,-0.562,8,22,1,1,0.19,0.86,0.616,30
extradition,-0.562,8,22,1,1,0.229,0.627,0.554,30
overpaid,-0.562,17,45,1,1,0.429,0.67,0.585,62
muddle,-0.562,17,45,1,1,0.184,0.71,0.336,62
negligible,-0.562,8,22,1,1,0.177,0.292,0.232,30
loath,-0.562,35,91,1,1,0.135,0.714,0.445,126
vat,-0.563,33,86,1,1,0.333,0.491,0.509,119
nomination,-0.563,101,260,1,1,0.663,0.637,0.696,361
complacent,-0.564,74,191,1,1,0.625,0.452,0.518,265
midwife,-0.564,24,63,1,1,0.531,0.57,0.453,87
lock,-0.564,1012,2594,1,1,0.271,0.585,0.6,3606
persevere,-0.565,118,304,1,1,0.802,0.583,0.937,422
valium,-0.566,22,58,1,1,0.419,0.398,0.443,80
terrifying,-0.566,1221,3134,1,1,0.031,0.836,0.602,4355
enforce,-0.567,50,130,1,1,0.583,0.644,0.836,180
hospice,-0.567,108,279,1,1,0.337,0.443,0.535,387
health,-0.567,13042,33504,1,1,0.935,0.427,0.551,46546
displeased,-0.568,13,35,1,1,0.135,0.69,0.4,48
superstitious,-0.568,20,53,1,1,0.281,0.545,0.514,73
implicated,-0.568,13,35,1,1,0.354,0.673,0.438,48
traumatic,-0.568,366,943,1,1,0.062,0.885,0.427,1309
penniless,-0.57,112,290,1,1,0.062,0.316,0.083,402
processing,-0.57,178,460,1,1,0.726,0.774,0.711,638
apartments,-0.57,244,630,1,1,0.704,0.337,0.443,874
calculus,-0.57,25,66,1,1,0.36,0.36,0.562,91
joys,-0.57,290,749,1,1,0.981,0.643,0.651,1039
spray,-0.571,218,564,1,1,0.438,0.41,0.333,782
changer,-0.572,61,159,1,1,0.583,0.519,0.567,220
bulk,-0.572,73,190,1,1,0.469,0.413,0.509,263
tomatoes,-0.572,97,252,1,1,0.615,0.24,0.272,349
ambulance,-0.572,102,265,1,1,0.5,0.75,0.609,367
rejuvenate,-0.573,23,61,1,1,0.776,0.588,0.767,84
barbarism,-0.573,11,30,1,1,0.19,0.815,0.614,41
demoralized,-0.573,11,30,1,1,0.082,0.59,0.149,41
lobbyist,-0.573,11,30,1,1,0.385,0.527,0.565,41
snippy,-0.573,11,30,1,1,0.418,0.491,0.481,41
sir,-0.573,2836,7329,1,1,0.622,0.306,0.778,10165
defined,-0.574,421,1090,1,1,0.67,0.214,0.646,1511
perpetrator,-0.574,40,105,1,1,0.229,0.765,0.538,145
politician,-0.574,245,635,1,1,0.323,0.551,0.863,880
assimilate,-0.574,28,74,1,1,0.559,0.391,0.683,102
border,-0.574,706,1828,1,1,0.406,0.382,0.424,2534
mouse,-0.574,452,1171,1,1,0.427,0.441,0.206,1623
startled,-0.575,55,144,1,1,0.333,0.865,0.526,199
trough,-0.575,187,486,1,1,0.5,0.308,0.34,673
publicly,-0.577,526,1366,1,1,0.74,0.481,0.632,1892
supporters,-0.577,924,2399,1,1,0.763,0.539,0.558,3323
doable,-0.578,51,134,1,1,0.76,0.404,0.675,185
inspire,-0.579,792,2060,1,1,0.918,0.627,0.759,2852
protest,-0.579,344,896,1,1,0.14,0.889,0.596,1240
instructed,-0.579,34,90,1,1,0.74,0.388,0.722,124
cowardice,-0.579,69,181,1,1,0.133,0.621,0.167,250
bode,-0.579,14,38,1,1,0.344,0.406,0.411,52
feasible,-0.579,44,116,1,1,0.694,0.388,0.611,160
mange,-0.579,9,25,1,1,0.311,0.558,0.348,34
storm,-0.581,1744,4546,1,1,0.188,0.94,0.543,6290
blender,-0.582,27,72,1,1,0.602,0.534,0.351,99
meter,-0.582,101,265,1,1,0.438,0.3,0.463,366
judging,-0.582,849,2216,1,1,0.24,0.625,0.693,3065
allergy,-0.583,68,179,1,1,0.296,0.606,0.389,247
disdain,-0.583,114,299,1,1,0.153,0.446,0.441,413
atrocious,-0.583,58,153,1,1,0.073,0.811,0.445,211
subpoena,-0.583,17,46,1,1,0.281,0.634,0.555,63
informed,-0.584,322,843,1,1,0.543,0.298,0.617,1165
hugs,-0.585,5224,13662,1,1,0.98,0.422,0.6,18886
healthcare,-0.585,397,1040,1,1,0.78,0.392,0.63,1437
documents,-0.585,85,224,1,1,0.53,0.25,0.587,309
bless,-0.586,3966,10381,1,1,0.929,0.269,0.588,14347
relax,-0.586,1423,3727,1,1,0.927,0.25,0.375,5150
throw,-0.586,3949,10342,1,1,0.344,0.77,0.623,14291
emery,-0.586,20,54,1,1,0.469,0.583,0.472,74
swim,-0.587,647,1697,1,1,0.688,0.461,0.529,2344
interfere,-0.588,89,235,1,1,0.323,0.714,0.471,324
whitewash,-0.589,7,20,1,1,0.429,0.402,0.276,27
blighted,-0.589,7,20,1,1,0.146,0.615,0.296,27
intercept,-0.589,7,20,1,1,0.221,0.66,0.676,27
rabbi,-0.59,50,133,1,1,0.459,0.362,0.723,183
clutter,-0.59,42,112,1,1,0.135,0.598,0.4,154
typhoon,-0.591,26,70,1,1,0.323,0.796,0.697,96
coercion,-0.591,18,49,1,1,0.33,0.708,0.577,67
perjury,-0.591,18,49,1,1,0.229,0.686,0.409,67
anytime,-0.591,2978,7839,1,1,0.625,0.461,0.436,10817
cockroach,-0.592,97,257,1,1,0.188,0.667,0.196,354
sovereign,-0.592,59,157,1,1,0.698,0.5,0.885,216
livid,-0.592,59,157,1,1,0.469,0.788,0.49,216
odious,-0.593,21,57,1,1,0.235,0.708,0.235,78
boycott,-0.593,120,318,1,1,0.112,0.69,0.505,438
illness,-0.594,3884,10250,1,1,0.098,0.717,0.211,14134
invasive,-0.594,49,131,1,1,0.194,0.73,0.598,180
caving,-0.594,74,197,1,1,0.378,0.491,0.551,271
protected,-0.595,432,1143,1,1,0.854,0.378,0.709,1575
roommate,-0.596,2586,6836,1,1,0.75,0.481,0.48,9422
dietary,-0.596,13,36,1,1,0.551,0.22,0.261,49
elective,-0.596,13,36,1,1,0.612,0.38,0.623,49
denomination,-0.596,13,36,1,1,0.49,0.363,0.429,49
speak,-0.596,8515,22508,1,1,0.765,0.472,0.5,31023
impeach,-0.596,100,266,1,1,0.208,0.776,0.664,366
styling,-0.597,16,44,1,1,0.823,0.378,0.652,60
disgusted,-0.598,438,1162,1,1,0.051,0.773,0.274,1600
juggle,-0.598,39,105,1,1,0.594,0.76,0.426,144
disconcerting,-0.599,22,60,1,1,0.106,0.549,0.269,82
hurdle,-0.599,45,121,1,1,0.198,0.682,0.434,166
decisive,-0.6,25,68,1,1,0.74,0.509,0.935,93
sensor,-0.6,25,68,1,1,0.571,0.377,0.542,93
conqueror,-0.6,25,68,1,1,0.604,0.809,0.93,93
lid,-0.601,81,217,1,1,0.49,0.189,0.255,298
scare,-0.601,1147,3051,1,1,0.122,0.91,0.264,4198
willingness,-0.602,143,382,1,1,0.786,0.5,0.729,525
yessss,-0.602,214,571,1,1,0.719,0.796,0.415,785
armed,-0.602,214,571,1,1,0.188,0.75,0.808,785
adhering,-0.604,8,23,1,1,0.612,0.561,0.537,31
toothpaste,-0.604,41,111,1,1,0.51,0.29,0.371,152
infestation,-0.604,11,31,1,1,0.256,0.776,0.527,42
creamer,-0.604,11,31,1,1,0.594,0.192,0.269,42
occupancy,-0.604,14,39,1,1,0.625,0.471,0.721,53
revenue,-0.604,65,175,1,1,0.873,0.51,0.854,240
sodium,-0.604,8,23,1,1,0.49,0.34,0.291,31
triad,-0.604,11,31,1,1,0.469,0.413,0.528,42
preferential,-0.604,8,23,1,1,0.74,0.481,0.764,31
approving,-0.604,14,39,1,1,0.917,0.583,0.773,53
differential,-0.604,8,23,1,1,0.52,0.378,0.535,31
catwalk,-0.604,8,23,1,1,0.698,0.436,0.464,31
sanitation,-0.604,8,23,1,1,0.742,0.312,0.5,31
misrepresented,-0.604,11,31,1,1,0.042,0.519,0.466,42
crumble,-0.606,169,453,1,1,0.333,0.48,0.423,622
groan,-0.607,51,138,1,1,0.396,0.75,0.351,189
curfew,-0.607,51,138,1,1,0.219,0.618,0.623,189
coup,-0.607,97,261,1,1,0.275,0.815,0.607,358
defend,-0.607,849,2272,1,1,0.698,0.722,0.67,3121
matter,-0.608,19296,51613,1,1,0.487,0.353,0.562,70909
learning,-0.608,4262,11408,1,1,0.833,0.588,0.574,15670
refund,-0.609,120,323,1,1,0.541,0.528,0.43,443
president,-0.609,3754,10055,1,1,0.677,0.622,0.973,13809
infertility,-0.61,115,310,1,1,0.17,0.664,0.328,425
viewpoint,-0.61,68,184,1,1,0.673,0.306,0.644,252
nix,-0.61,21,58,1,1,0.33,0.38,0.404,79
restrictive,-0.61,21,58,1,1,0.215,0.596,0.5,79
dentist,-0.61,147,396,1,1,0.479,0.62,0.642,543
unknown,-0.611,1690,4537,1,1,0.357,0.45,0.204,6227
horrific,-0.611,309,831,1,1,0.094,0.846,0.481,1140
madhouse,-0.612,15,42,1,1,0.156,0.736,0.44,57
possibility,-0.612,550,1480,1,1,0.816,0.481,0.596,2030
recover,-0.613,551,1483,1,1,0.918,0.51,0.647,2034
batter,-0.614,38,104,1,1,0.561,0.245,0.373,142
shaky,-0.615,97,263,1,1,0.26,0.734,0.223,360
sunrise,-0.615,509,1373,1,1,0.823,0.347,0.64,1882
hurried,-0.615,35,96,1,1,0.314,0.806,0.393,131
constituents,-0.616,108,293,1,1,0.573,0.414,0.833,401
kitchen,-0.617,1491,4026,1,1,0.7,0.234,0.398,5517
hassle,-0.617,122,331,1,1,0.177,0.74,0.489,453
baffle,-0.617,9,26,1,1,0.344,0.442,0.482,35
bearings,-0.617,9,26,1,1,0.418,0.49,0.426,35
callback,-0.617,9,26,1,1,0.524,0.529,0.434,35
ensure,-0.619,507,1373,1,1,0.737,0.406,0.759,1880
sensory,-0.619,101,275,1,1,0.583,0.48,0.442,376
vent,-0.621,2323,6297,1,1,0.479,0.519,0.529,8620
annoys,-0.622,267,726,1,1,0.146,0.778,0.435,993
protect,-0.622,2715,7370,1,1,0.823,0.714,0.791,10085
precedence,-0.622,13,37,1,1,0.594,0.52,0.598,50
tutu,-0.622,20,56,1,1,0.583,0.276,0.233,76
stillborn,-0.622,13,37,1,1,0.271,0.519,0.337,50
regulatory,-0.622,13,37,1,1,0.531,0.448,0.528,50
fearless,-0.622,248,675,1,1,0.81,0.806,0.76,923
professional,-0.623,1261,3427,1,1,0.833,0.447,0.943,4688
milestone,-0.624,77,211,1,1,0.719,0.373,0.558,288
skepticism,-0.624,24,67,1,1,0.229,0.48,0.582,91
remember,-0.624,31981,86996,1,1,0.776,0.422,0.454,118977
republican,-0.624,807,2197,1,1,0.398,0.551,0.664,3004
consent,-0.625,236,644,1,1,0.75,0.5,0.62,880
presidency,-0.626,187,511,1,1,0.776,0.686,0.918,698
boarder,-0.626,28,78,1,1,0.604,0.44,0.475,106
finch,-0.626,28,78,1,1,0.438,0.444,0.358,106
goodness,-0.626,1203,3279,1,1,0.969,0.321,0.715,4482
bran,-0.626,61,168,1,1,0.688,0.433,0.483,229
madder,-0.627,10,29,1,1,0.323,0.853,0.267,39
hesitant,-0.628,144,395,1,1,0.333,0.542,0.321,539
fight,-0.629,11569,31612,1,1,0.531,0.868,0.809,43181
reminder,-0.629,3563,9738,1,1,0.552,0.423,0.589,13301
accountable,-0.629,296,811,1,1,0.709,0.282,0.777,1107
flashlight,-0.63,63,174,1,1,0.653,0.414,0.356,237
irks,-0.63,48,133,1,1,0.276,0.781,0.339,181
dealings,-0.63,37,103,1,1,0.6,0.491,0.48,140
hyperbole,-0.63,37,103,1,1,0.469,0.521,0.542,140
parallel,-0.631,258,708,1,1,0.568,0.284,0.465,966
prosecute,-0.632,26,73,1,1,0.479,0.587,0.769,99
brethren,-0.632,88,243,1,1,0.917,0.38,0.641,331
conditioner,-0.632,30,84,1,1,0.781,0.36,0.538,114
surroundings,-0.633,442,1214,1,1,0.6,0.346,0.492,1656
accuser,-0.633,34,95,1,1,0.122,0.779,0.615,129
tenancy,-0.635,7,21,1,1,0.5,0.458,0.605,28
execution,-0.635,67,186,1,1,0.16,0.811,0.713,253
coarse,-0.635,31,87,1,1,0.333,0.481,0.481,118
parity,-0.635,11,32,1,1,0.582,0.406,0.407,43
partisanship,-0.635,11,32,1,1,0.438,0.566,0.551,43
lawlessness,-0.635,11,32,1,1,0.156,0.804,0.509,43
paprika,-0.635,7,21,1,1,0.417,0.25,0.264,28
pollen,-0.635,23,65,1,1,0.622,0.212,0.292,88
taper,-0.635,11,32,1,1,0.541,0.41,0.415,43
walkout,-0.635,7,21,1,1,0.292,0.853,0.427,28
professionalism,-0.635,35,98,1,1,0.781,0.541,0.944,133
illegally,-0.636,76,211,1,1,0.133,0.788,0.402,287
enraged,-0.636,76,211,1,1,0.083,0.962,0.636,287
resilient,-0.637,146,404,1,1,0.542,0.54,0.801,550
reconsider,-0.637,93,258,1,1,0.448,0.442,0.582,351
democrat,-0.637,576,1589,1,1,0.582,0.4,0.755,2165
stepfather,-0.638,36,101,1,1,0.396,0.491,0.611,137
illusion,-0.639,930,2570,1,1,0.562,0.49,0.387,3500
guiding,-0.64,276,764,1,1,0.667,0.52,0.714,1040
facing,-0.64,2062,5698,1,1,0.604,0.406,0.55,7760
intuitive,-0.64,54,151,1,1,0.771,0.573,0.69,205
aloha,-0.641,33,93,1,1,0.698,0.44,0.441,126
scrambling,-0.641,33,93,1,1,0.421,0.81,0.731,126
creaking,-0.641,29,82,1,1,0.302,0.743,0.415,111
aide,-0.642,42,118,1,1,0.724,0.342,0.434,160
worthy,-0.642,1569,4344,1,1,0.812,0.34,0.796,5913
treatment,-0.642,944,2615,1,1,0.663,0.386,0.62,3559
proud,-0.643,6426,17811,1,1,0.906,0.7,0.873,24237
stance,-0.643,249,692,1,1,0.604,0.333,0.609,941
periodic,-0.643,21,60,1,1,0.677,0.324,0.508,81
suicide,-0.644,4953,13743,1,1,0.03,0.873,0.429,18696
incident,-0.645,271,754,1,1,0.084,0.662,0.482,1025
educate,-0.645,299,832,1,1,0.76,0.38,0.728,1131
viability,-0.645,8,24,1,1,0.776,0.5,0.684,32
paddle,-0.645,35,99,1,1,0.561,0.375,0.393,134
subsidy,-0.645,8,24,1,1,0.573,0.462,0.517,32
document,-0.647,109,305,1,1,0.594,0.24,0.667,414
oversight,-0.647,36,102,1,1,0.385,0.618,0.723,138
admire,-0.648,855,2383,1,1,0.867,0.692,0.704,3238
civics,-0.648,13,38,1,1,0.7,0.279,0.72,51
abnormal,-0.649,160,448,1,1,0.137,0.604,0.309,608
hypnotized,-0.651,38,108,1,1,0.449,0.434,0.38,146
refused,-0.652,479,1341,1,1,0.163,0.475,0.188,1820
thunderstorm,-0.652,88,248,1,1,0.135,0.86,0.784,336
insulation,-0.653,9,27,1,1,0.245,0.327,0.264,36
blockade,-0.653,14,41,1,1,0.38,0.519,0.51,55
chalet,-0.653,9,27,1,1,0.653,0.349,0.278,36
washing,-0.654,392,1100,1,1,0.643,0.396,0.402,1492
important,-0.656,11325,31785,1,1,0.827,0.63,0.836,43110
aggravated,-0.656,77,218,1,1,0.079,0.76,0.43,295
belief,-0.657,755,2123,1,1,0.896,0.375,0.656,2878
godbless,-0.657,57,162,1,1,0.823,0.395,0.588,219
regulated,-0.658,15,44,1,1,0.531,0.269,0.483,59
overturn,-0.658,15,44,1,1,0.24,0.765,0.396,59
law,-0.659,1696,4777,1,1,0.74,0.59,0.815,6473
rapist,-0.659,265,748,1,1,0.062,0.906,0.571,1013
advocate,-0.659,374,1055,1,1,0.551,0.53,0.818,1429
untrustworthy,-0.659,48,137,1,1,0.097,0.449,0.287,185
bedroom,-0.659,1860,5241,1,1,0.744,0.296,0.491,7101
censure,-0.66,10,30,1,1,0.219,0.653,0.417,40
unacceptable,-0.66,198,560,1,1,0.133,0.479,0.33,758
hardware,-0.661,38,109,1,1,0.594,0.289,0.686,147
warranted,-0.661,27,78,1,1,0.714,0.367,0.69,105
worldwide,-0.661,347,981,1,1,0.79,0.462,0.851,1328
detector,-0.662,39,112,1,1,0.459,0.63,0.724,151
electrician,-0.663,22,64,1,1,0.449,0.59,0.62,86
hives,-0.663,22,64,1,1,0.417,0.473,0.591,86
baffled,-0.664,81,231,1,1,0.151,0.6,0.339,312
accomplish,-0.664,355,1007,1,1,0.929,0.673,0.816,1362
aggressor,-0.665,11,33,1,1,0.146,0.948,0.823,44
unmanageable,-0.665,11,33,1,1,0.177,0.666,0.482,44
felicity,-0.665,71,203,1,1,0.913,0.704,0.793,274
warranty,-0.665,17,50,1,1,0.667,0.47,0.568,67
unrepentant,-0.665,11,33,1,1,0.24,0.445,0.413,44
kickboxing,-0.665,11,33,1,1,0.427,0.882,0.651,44
legislation,-0.666,72,206,1,1,0.531,0.418,0.808,278
predicament,-0.666,103,294,1,1,0.365,0.48,0.541,397
coalition,-0.667,67,192,1,1,0.49,0.73,0.673,259
criticized,-0.669,108,309,1,1,0.24,0.6,0.311,417
ketchup,-0.669,102,292,1,1,0.653,0.338,0.282,394
minority,-0.669,515,1467,1,1,0.31,0.332,0.211,1982
inspect,-0.67,12,36,1,1,0.479,0.603,0.793,48
earnings,-0.67,25,73,1,1,0.938,0.65,0.875,98
sanctioned,-0.67,12,36,1,1,0.323,0.696,0.391,48
irate,-0.67,12,36,1,1,0.188,0.852,0.474,48
sweetie,-0.67,1082,3083,1,1,0.99,0.549,0.56,4165
unsuccessful,-0.67,203,580,1,1,0.14,0.318,0.106,783
reach,-0.671,10660,30375,1,1,0.719,0.625,0.69,41035
dingy,-0.671,39,113,1,1,0.156,0.483,0.343,152
admirable,-0.672,94,270,1,1,0.929,0.6,0.87,364
justice,-0.672,1331,3799,1,1,0.76,0.538,0.787,5130
unbiased,-0.672,33,96,1,1,0.625,0.378,0.618,129
dealing,-0.672,3658,10441,1,1,0.724,0.415,0.598,14099
complicity,-0.673,20,59,1,1,0.323,0.684,0.67,79
vacate,-0.673,13,39,1,1,0.357,0.49,0.397,52
unassisted,-0.673,6,19,1,1,0.302,0.32,0.211,25
hernia,-0.673,6,19,1,1,0.146,0.486,0.223,25
abnormality,-0.673,6,19,1,1,0.092,0.655,0.383,25
persist,-0.674,106,305,1,1,0.765,0.644,0.727,411
worry,-0.676,12066,34550,1,1,0.245,0.776,0.267,46616
cooperating,-0.676,21,62,1,1,0.76,0.39,0.693,83
obstruct,-0.676,21,62,1,1,0.115,0.66,0.458,83
thank,-0.676,39595,113432,1,1,0.958,0.353,0.526,153027
partisan,-0.676,73,211,1,1,0.615,0.549,0.669,284
judged,-0.677,655,1879,1,1,0.281,0.686,0.722,2534
laundry,-0.677,625,1794,1,1,0.644,0.292,0.377,2419
supported,-0.678,1023,2937,1,1,0.853,0.408,0.613,3960
income,-0.679,497,1430,1,1,0.75,0.51,0.728,1927
misinterpretation,-0.68,7,22,1,1,0.112,0.556,0.36,29
guardianship,-0.68,7,22,1,1,0.592,0.37,0.681,29
taxed,-0.68,23,68,1,1,0.255,0.456,0.5,91
tropic,-0.68,7,22,1,1,0.74,0.529,0.536,29
overhear,-0.68,15,45,1,1,0.65,0.365,0.58,60
comatose,-0.68,15,45,1,1,0.143,0.438,0.433,60
mismanagement,-0.68,7,22,1,1,0.094,0.52,0.295,29
aloud,-0.681,237,684,1,1,0.458,0.713,0.75,921
knowing,-0.683,11434,32987,1,1,0.833,0.353,0.658,44421
firearms,-0.683,34,100,1,1,0.22,0.943,0.821,134
irritate,-0.684,106,308,1,1,0.167,0.89,0.368,414
disinformation,-0.685,26,77,1,1,0.23,0.577,0.26,103
trifle,-0.685,17,51,1,1,0.271,0.296,0.221,68
knowledge,-0.686,1698,4914,1,1,0.847,0.43,0.896,6612
cleaning,-0.686,888,2572,1,1,0.595,0.396,0.427,3460
strength,-0.686,5005,14489,1,1,0.802,0.682,0.858,19494
doctrine,-0.687,38,112,1,1,0.5,0.394,0.769,150
hereditary,-0.688,49,144,1,1,0.531,0.6,0.737,193
grievous,-0.688,9,28,1,1,0.146,0.64,0.179,37
smoothly,-0.688,59,173,1,1,0.821,0.134,0.488,232
applesauce,-0.688,9,28,1,1,0.75,0.167,0.291,37
foreclosure,-0.688,9,28,1,1,0.167,0.651,0.5,37
afford,-0.691,1867,5431,1,1,0.571,0.58,0.575,7298
senate,-0.691,326,950,1,1,0.49,0.349,0.836,1276
capable,-0.692,1055,3074,1,1,0.765,0.587,0.547,4129
clergy,-0.693,57,168,1,1,0.531,0.312,0.575,225
bruising,-0.694,11,34,1,1,0.084,0.52,0.422,45
dentists,-0.694,23,69,1,1,0.364,0.6,0.582,92
veteran,-0.694,311,909,1,1,0.56,0.431,0.759,1220
leftovers,-0.694,132,387,1,1,0.219,0.35,0.116,519
judgment,-0.694,338,988,1,1,0.396,0.6,0.816,1326
cathartic,-0.696,138,405,1,1,0.45,0.51,0.604,543
lunacy,-0.696,38,113,1,1,0.132,0.847,0.33,151
unanimous,-0.696,12,37,1,1,0.656,0.38,0.682,49
instruct,-0.696,12,37,1,1,0.729,0.49,0.833,49
ordeal,-0.698,81,239,1,1,0.344,0.539,0.529,320
backward,-0.698,81,239,1,1,0.309,0.367,0.25,320
overslept,-0.698,13,40,1,1,0.408,0.315,0.3,53
trepidation,-0.698,13,40,1,1,0.582,0.594,0.464,53
transcript,-0.7,14,43,1,1,0.639,0.398,0.528,57
homeowner,-0.7,14,43,1,1,0.635,0.397,0.962,57
overactive,-0.7,14,43,1,1,0.667,0.885,0.592,57
payer,-0.701,30,90,1,1,0.313,0.63,0.638,120
adjust,-0.701,340,1000,1,1,0.647,0.327,0.638,1340
incredulous,-0.701,15,46,1,1,0.286,0.51,0.269,61
impure,-0.701,15,46,1,1,0.26,0.56,0.208,61
battle,-0.702,3920,11530,1,1,0.365,0.945,0.868,15450
migraine,-0.703,170,502,1,1,0.135,0.783,0.318,672
forensic,-0.703,34,102,1,1,0.439,0.627,0.436,136
situation,-0.704,5644,16620,1,1,0.531,0.387,0.6,22264
complication,-0.704,17,52,1,1,0.365,0.726,0.33,69
confirmation,-0.704,203,600,1,1,0.812,0.48,0.692,803
battled,-0.705,132,391,1,1,0.292,0.794,0.575,523
attempted,-0.707,319,944,1,1,0.594,0.58,0.567,1263
civilians,-0.707,42,126,1,1,0.49,0.448,0.525,168
panicky,-0.708,45,135,1,1,0.284,0.962,0.393,180
semicolon,-0.708,22,67,1,1,0.378,0.255,0.318,89
privately,-0.708,138,410,1,1,0.458,0.562,0.541,548
incompetence,-0.708,70,209,1,1,0.077,0.551,0.208,279
vow,-0.708,120,357,1,1,0.56,0.51,0.664,477
defy,-0.708,72,215,1,1,0.353,0.884,0.657,287
dribble,-0.709,48,144,1,1,0.417,0.551,0.465,192
brotherly,-0.709,24,73,1,1,0.865,0.306,0.596,97
kirk,-0.709,182,541,1,1,0.51,0.39,0.388,723
laundering,-0.711,28,85,1,1,0.439,0.327,0.444,113
banking,-0.711,60,180,1,1,0.51,0.327,0.5,240
sufferer,-0.715,89,267,1,1,0.156,0.69,0.278,356
equality,-0.716,253,756,1,1,0.898,0.305,0.716,1009
abhorrent,-0.716,55,166,1,1,0.229,0.75,0.474,221
comfortable,-0.716,6870,20493,1,1,0.927,0.163,0.473,27363
born,-0.717,6208,18534,1,1,0.865,0.509,0.591,24742
intrusive,-0.718,147,441,1,1,0.461,0.607,0.538,588
openly,-0.718,701,2096,1,1,0.603,0.388,0.553,2797
scary,-0.719,6417,19198,1,1,0.062,0.952,0.528,25615
cooking,-0.72,1117,3347,1,1,0.694,0.51,0.434,4464
united,-0.721,1084,3249,1,1,0.781,0.431,0.783,4333
loan,-0.721,244,733,1,1,0.552,0.48,0.352,977
consolation,-0.721,308,925,1,1,0.408,0.25,0.304,1233
govern,-0.722,57,173,1,1,0.573,0.702,0.98,230
solicitor,-0.722,7,23,1,1,0.6,0.479,0.802,30
oodles,-0.722,8,26,1,1,0.49,0.374,0.446,34
reliability,-0.722,10,32,1,1,0.917,0.38,0.696,42
aneurysm,-0.722,15,47,1,1,0.115,0.69,0.536,62
subjugation,-0.722,8,26,1,1,0.28,0.61,0.377,34
advantageous,-0.722,7,23,1,1,0.837,0.64,0.789,30
premeditated,-0.722,9,29,1,1,0.354,0.49,0.62,38
aromatherapy,-0.722,6,20,1,1,0.847,0.22,0.473,26
lever,-0.722,19,59,1,1,0.4,0.343,0.402,78
graciously,-0.722,17,53,1,1,0.948,0.353,0.68,70
indoctrination,-0.722,38,116,1,1,0.327,0.657,0.698,154
dissimilar,-0.722,7,23,1,1,0.276,0.461,0.472,30
hardwood,-0.722,9,29,1,1,0.417,0.363,0.518,38
valve,-0.722,19,59,1,1,0.323,0.363,0.471,78
patriotic,-0.722,82,248,1,1,0.875,0.509,0.933,330
incandescent,-0.722,10,32,1,1,0.354,0.612,0.621,42
rewire,-0.722,8,26,1,1,0.365,0.462,0.406,34
atrocity,-0.722,28,86,1,1,0.115,0.844,0.593,114
testimonial,-0.722,6,20,1,1,0.541,0.538,0.75,26
desperado,-0.722,42,128,1,1,0.26,0.745,0.361,170
overestimated,-0.722,7,23,1,1,0.344,0.646,0.527,30
exclaim,-0.722,11,35,1,1,0.635,0.711,0.639,46
secularism,-0.722,11,35,1,1,0.367,0.44,0.559,46
disapproving,-0.722,8,26,1,1,0.245,0.625,0.452,34
afraid,-0.723,16377,49170,1,1,0.01,0.775,0.245,65547
stand,-0.724,10715,32216,1,1,0.6,0.324,0.509,42931
experiences,-0.725,2460,7403,1,1,0.793,0.647,0.795,9863
advocacy,-0.726,93,282,1,1,0.5,0.646,0.731,375
disadvantage,-0.727,76,231,1,1,0.15,0.377,0.282,307
violate,-0.727,64,195,1,1,0.061,0.97,0.519,259
adversity,-0.728,122,370,1,1,0.276,0.76,0.538,492
aft,-0.728,60,183,1,1,0.48,0.417,0.518,243
property,-0.729,303,917,1,1,0.74,0.221,0.805,1220
tangled,-0.729,192,582,1,1,0.26,0.539,0.316,774
horrifying,-0.729,184,558,1,1,0.01,0.76,0.352,742
truce,-0.732,32,99,1,1,0.688,0.441,0.453,131
grumble,-0.734,28,87,1,1,0.101,0.75,0.333,115
therapeutic,-0.734,420,1277,1,1,0.625,0.275,0.68,1697
linear,-0.735,52,160,1,1,0.646,0.25,0.472,212
fainting,-0.735,25,78,1,1,0.333,0.51,0.214,103
meditating,-0.735,75,230,1,1,0.718,0.185,0.399,305
tariff,-0.737,21,66,1,1,0.459,0.402,0.491,87
batty,-0.738,20,63,1,1,0.375,0.619,0.274,83
furious,-0.74,190,582,1,1,0.062,0.953,0.598,772
nought,-0.741,17,54,1,1,0.312,0.098,0.116,71
commendable,-0.741,17,54,1,1,0.786,0.57,0.555,71
purify,-0.742,16,51,1,1,0.823,0.304,0.746,67
oppose,-0.742,101,311,1,1,0.431,0.8,0.473,412
convinced,-0.742,2034,6228,1,1,0.75,0.5,0.63,8262
disclose,-0.742,48,149,1,1,0.49,0.57,0.545,197
disclosed,-0.743,15,48,1,1,0.271,0.575,0.546,63
administrative,-0.743,15,48,1,1,0.542,0.415,0.579,63
patriotism,-0.744,60,186,1,1,0.708,0.635,0.848,246
condo,-0.744,226,695,1,1,0.439,0.288,0.607,921
protestant,-0.744,14,45,1,1,0.33,0.73,0.546,59
tornado,-0.745,88,272,1,1,0.26,0.896,0.784,360
coverage,-0.745,235,723,1,1,0.767,0.413,0.629,958
mental,-0.745,13752,42193,1,1,0.49,0.49,0.585,55945
expiration,-0.745,42,131,1,1,0.265,0.539,0.463,173
pause,-0.746,451,1387,1,1,0.429,0.188,0.264,1838
nepotism,-0.746,13,42,1,1,0.349,0.584,0.517,55
tribunal,-0.746,13,42,1,1,0.41,0.67,0.797,55
citizenship,-0.746,81,251,1,1,0.786,0.404,0.723,332
resistance,-0.747,325,1001,1,1,0.427,0.694,0.796,1326
farce,-0.748,51,159,1,1,0.265,0.667,0.246,210
rigged,-0.748,50,156,1,1,0.188,0.51,0.412,206
fighting,-0.75,6311,19465,1,1,0.292,0.885,0.783,25776
medication,-0.751,492,1521,1,1,0.615,0.439,0.5,2013
yayyy,-0.752,55,172,1,1,0.602,0.7,0.381,227
veer,-0.752,10,33,1,1,0.469,0.43,0.338,43
appliance,-0.752,10,33,1,1,0.582,0.453,0.538,43
pronounce,-0.753,75,234,1,1,0.653,0.52,0.563,309
diagnosis,-0.754,342,1061,1,1,0.571,0.5,0.819,1403
yayy,-0.754,50,157,1,1,0.64,0.587,0.355,207
buffering,-0.755,9,30,1,1,0.479,0.468,0.381,39
unthinkable,-0.755,39,123,1,1,0.365,0.48,0.481,162
frustrates,-0.756,48,151,1,1,0.146,0.653,0.34,199
reaffirm,-0.757,18,58,1,1,0.75,0.559,0.654,76
recession,-0.757,27,86,1,1,0.368,0.398,0.373,113
receipts,-0.758,64,201,1,1,0.32,0.333,0.381,265
defrost,-0.759,8,27,1,1,0.427,0.317,0.389,35
inaction,-0.76,34,108,1,1,0.323,0.225,0.325,142
obstacle,-0.76,104,326,1,1,0.204,0.708,0.336,430
oust,-0.761,16,52,1,1,0.296,0.716,0.444,68
detection,-0.761,16,52,1,1,0.708,0.567,0.538,68
learn,-0.762,11888,37095,1,1,0.833,0.643,0.829,48983
uphold,-0.762,82,258,1,1,0.698,0.321,0.561,340
assurance,-0.763,145,455,1,1,0.675,0.442,0.704,600
anointed,-0.763,23,74,1,1,0.5,0.368,0.579,97
stipend,-0.763,7,24,1,1,0.604,0.546,0.614,31
implore,-0.763,31,99,1,1,0.396,0.65,0.377,130
finalize,-0.763,7,24,1,1,0.556,0.55,0.578,31
egregious,-0.763,23,74,1,1,0.15,0.716,0.442,97
lactose,-0.764,30,96,1,1,0.479,0.29,0.433,126
salary,-0.766,162,510,1,1,0.786,0.48,0.652,672
infanticide,-0.767,21,68,1,1,0.167,0.856,0.443,89
stairs,-0.768,408,1283,1,1,0.51,0.439,0.342,1691
canned,-0.768,49,156,1,1,0.398,0.357,0.298,205
clandestine,-0.769,6,21,1,1,0.425,0.677,0.469,27
asthma,-0.769,69,219,1,1,0.198,0.549,0.227,288
educator,-0.769,34,109,1,1,0.827,0.317,0.845,143
appetizing,-0.769,6,21,1,1,0.806,0.657,0.688,27
thundering,-0.769,27,87,1,1,0.337,0.778,0.7,114
ozone,-0.769,6,21,1,1,0.56,0.345,0.518,27
stainless,-0.769,6,21,1,1,0.594,0.329,0.618,27
penitent,-0.769,6,21,1,1,0.542,0.53,0.508,27
rent,-0.769,1103,3469,1,1,0.344,0.429,0.446,4572
bipolar,-0.77,472,1488,1,1,0.208,0.685,0.426,1960
applaud,-0.772,163,516,1,1,0.865,0.824,0.464,679
cereal,-0.772,227,718,1,1,0.612,0.206,0.316,945
subordinate,-0.772,12,40,1,1,0.276,0.392,0.121,52
oven,-0.773,146,463,1,1,0.583,0.425,0.606,609
cologne,-0.774,198,628,1,1,0.677,0.413,0.552,826
sandstorm,-0.776,17,56,1,1,0.324,0.821,0.629,73
lineage,-0.777,76,243,1,1,0.633,0.465,0.721,319
credible,-0.777,105,335,1,1,0.917,0.441,0.75,440
visualize,-0.778,34,110,1,1,0.635,0.431,0.537,144
distaste,-0.778,28,91,1,1,0.184,0.625,0.37,119
backbone,-0.778,86,275,1,1,0.538,0.464,0.62,361
privacy,-0.778,641,2036,1,1,0.52,0.42,0.598,2677
ashamed,-0.779,1796,5702,1,1,0.156,0.588,0.228,7498
insurance,-0.779,404,1285,1,1,0.714,0.308,0.825,1689
stabilize,-0.779,16,53,1,1,0.839,0.427,0.722,69
obstruction,-0.779,50,161,1,1,0.125,0.742,0.491,211
unplug,-0.781,49,158,1,1,0.239,0.441,0.404,207
bottling,-0.783,84,270,1,1,0.365,0.333,0.37,354
casket,-0.783,121,388,1,1,0.125,0.49,0.346,509
trimester,-0.784,20,66,1,1,0.783,0.336,0.538,86
nervous,-0.784,1717,5481,1,1,0.235,0.82,0.213,7198
brave,-0.785,3023,9656,1,1,0.837,0.75,0.917,12679
washroom,-0.785,30,98,1,1,0.5,0.364,0.446,128
sib,-0.787,9,31,1,1,0.698,0.298,0.593,40
tinnitus,-0.787,44,143,1,1,0.384,0.536,0.411,187
hasty,-0.787,39,127,1,1,0.188,0.885,0.424,166
pace,-0.788,691,2216,1,1,0.51,0.38,0.39,2907
allied,-0.79,18,60,1,1,0.714,0.245,0.642,78
sinning,-0.791,32,105,1,1,0.17,0.7,0.422,137
treason,-0.791,145,468,1,1,0.094,0.806,0.552,613
mediate,-0.791,13,44,1,1,0.635,0.308,0.654,57
gypsy,-0.791,125,404,1,1,0.375,0.665,0.396,529
unlawful,-0.791,13,44,1,1,0.094,0.759,0.402,57
lifeline,-0.793,419,1351,1,1,0.735,0.552,0.496,1770
outnumber,-0.794,26,86,1,1,0.347,0.615,0.577,112
incensed,-0.794,8,28,1,1,0.338,0.643,0.392,36
stillbirth,-0.794,8,28,1,1,0.092,0.809,0.291,36
spiders,-0.794,480,1549,1,1,0.26,0.696,0.368,2029
abortion,-0.794,434,1401,1,1,0.082,0.77,0.283,1835
safe,-0.795,6005,19368,1,1,0.898,0.306,0.759,25373
outraged,-0.795,114,370,1,1,0.156,0.696,0.538,484
impostor,-0.795,43,141,1,1,0.135,0.704,0.442,184
perk,-0.797,137,445,1,1,0.903,0.519,0.682,582
cramp,-0.797,29,96,1,1,0.194,0.796,0.34,125
enact,-0.798,16,54,1,1,0.68,0.564,0.598,70
associate,-0.799,704,2282,1,1,0.812,0.409,0.625,2986
governing,-0.8,32,106,1,1,0.635,0.7,0.9,138
sayonara,-0.8,36,119,1,1,0.56,0.398,0.402,155
gad,-0.801,48,158,1,1,0.51,0.47,0.408,206
disorder,-0.801,995,3233,1,1,0.115,0.816,0.218,4228
chemo,-0.801,88,288,1,1,0.214,0.686,0.444,376
congress,-0.802,648,2107,1,1,0.449,0.444,0.857,2755
guidelines,-0.802,51,168,1,1,0.459,0.5,0.664,219
gynecologist,-0.802,7,25,1,1,0.552,0.566,0.682,32
equalizer,-0.802,7,25,1,1,0.604,0.451,0.586,32
nominee,-0.805,69,227,1,1,0.662,0.625,0.765,296
recourse,-0.806,22,74,1,1,0.402,0.337,0.598,96
hateeee,-0.806,18,61,1,1,0.219,0.606,0.368,79
legion,-0.807,108,355,1,1,0.469,0.57,0.852,463
courtroom,-0.807,14,48,1,1,0.385,0.67,0.887,62
chop,-0.808,304,996,1,1,0.25,0.655,0.467,1300
prefer,-0.809,5580,18259,1,1,0.76,0.385,0.536,23839
screwdriver,-0.809,10,35,1,1,0.52,0.519,0.439,45
breather,-0.811,64,212,1,1,0.624,0.471,0.388,276
objection,-0.811,17,58,1,1,0.347,0.592,0.709,75
sketchy,-0.812,81,268,1,1,0.333,0.479,0.241,349
fertility,-0.812,56,186,1,1,0.885,0.529,0.726,242
heinous,-0.812,52,173,1,1,0.133,0.792,0.471,225
toilet,-0.813,834,2742,1,1,0.49,0.29,0.233,3576
unproven,-0.813,6,22,1,1,0.296,0.427,0.216,28
diabolical,-0.813,13,45,1,1,0.102,0.912,0.456,58
saboteur,-0.813,6,22,1,1,0.25,0.804,0.407,28
beneficiary,-0.813,20,68,1,1,0.776,0.399,0.616,88
palpitations,-0.813,20,68,1,1,0.417,0.702,0.528,88
impartiality,-0.813,6,22,1,1,0.622,0.394,0.616,28
support,-0.814,17800,58528,1,1,0.811,0.472,0.737,76328
victimized,-0.815,57,190,1,1,0.115,0.644,0.273,247
unimpressed,-0.816,16,55,1,1,0.198,0.302,0.327,71
census,-0.816,26,88,1,1,0.449,0.289,0.553,114
meditate,-0.819,258,855,1,1,0.812,0.146,0.564,1113
disqualified,-0.82,12,42,1,1,0.129,0.464,0.232,54
relocate,-0.821,57,191,1,1,0.5,0.594,0.64,248
confidentiality,-0.821,15,52,1,1,0.667,0.431,0.718,67
condolence,-0.823,21,72,1,1,0.26,0.443,0.404,93
suffering,-0.824,7048,23401,1,1,0.02,0.719,0.235,30449
diabetic,-0.825,42,142,1,1,0.125,0.269,0.237,184
recovery,-0.826,823,2740,1,1,0.781,0.402,0.737,3563
yey,-0.826,106,355,1,1,0.677,0.53,0.29,461
creak,-0.828,26,89,1,1,0.344,0.67,0.411,115
vindicated,-0.828,35,119,1,1,0.615,0.48,0.609,154
undecided,-0.828,47,159,1,1,0.286,0.433,0.127,206
pediatrician,-0.828,8,29,1,1,0.602,0.5,0.627,37
patronage,-0.828,8,29,1,1,0.583,0.49,0.583,37
eyesight,-0.828,29,99,1,1,0.75,0.226,0.343,128
sneezing,-0.829,58,196,1,1,0.434,0.57,0.345,254
commend,-0.829,58,196,1,1,0.906,0.694,0.711,254
cook,-0.83,1713,5726,1,1,0.847,0.5,0.412,7439
veto,-0.831,28,96,1,1,0.271,0.462,0.509,124
fiasco,-0.832,48,163,1,1,0.167,0.6,0.2,211
electorate,-0.832,48,163,1,1,0.56,0.38,0.696,211
doorbell,-0.833,53,180,1,1,0.564,0.5,0.307,233
detergent,-0.834,16,56,1,1,0.458,0.304,0.426,72
forsake,-0.835,244,822,1,1,0.102,0.567,0.223,1066
lawsuit,-0.836,46,157,1,1,0.219,0.794,0.611,203
handyman,-0.837,10,36,1,1,0.66,0.373,0.393,46
mediator,-0.837,10,36,1,1,0.592,0.438,0.58,46
reassurance,-0.838,398,1343,1,1,0.875,0.127,0.593,1741
overhaul,-0.838,18,63,1,1,0.5,0.651,0.491,81
detest,-0.838,64,218,1,1,0.083,0.8,0.492,282
awareness,-0.838,1817,6125,1,1,0.684,0.422,0.81,7942
regime,-0.839,161,545,1,1,0.29,0.668,0.773,706
paranormal,-0.84,82,279,1,1,0.167,0.814,0.56,361
transgression,-0.84,7,26,1,1,0.158,0.89,0.611,33
expedite,-0.84,7,26,1,1,0.571,0.858,0.798,33
housework,-0.841,60,205,1,1,0.484,0.413,0.342,265
judiciary,-0.841,52,178,1,1,0.439,0.74,0.897,230
jug,-0.842,41,141,1,1,0.52,0.25,0.213,182
indivisible,-0.843,12,43,1,1,0.646,0.398,0.58,55
towel,-0.843,181,615,1,1,0.63,0.208,0.286,796
furnace,-0.845,22,77,1,1,0.429,0.529,0.5,99
shitless,-0.846,47,162,1,1,0.271,0.545,0.333,209
mutter,-0.847,24,84,1,1,0.406,0.427,0.228,108
nausea,-0.847,59,203,1,1,0.104,0.781,0.273,262
firearm,-0.85,26,91,1,1,0.086,0.943,0.864,117
mortified,-0.85,26,91,1,1,0.073,0.731,0.27,117
alibi,-0.85,21,74,1,1,0.396,0.528,0.556,95
establishment,-0.852,119,409,1,1,0.69,0.398,0.631,528
visibility,-0.853,85,293,1,1,0.75,0.444,0.676,378
investigate,-0.853,128,440,1,1,0.64,0.5,0.781,568
vitals,-0.856,6,23,1,1,0.704,0.604,0.798,29
congenital,-0.856,6,23,1,1,0.448,0.434,0.427,29
biopsy,-0.856,6,23,1,1,0.323,0.657,0.481,29
grounding,-0.856,41,143,1,1,0.521,0.452,0.591,184
dentistry,-0.856,6,23,1,1,0.429,0.57,0.569,29
yaaay,-0.856,41,143,1,1,0.65,0.61,0.33,184
umbilical,-0.856,6,23,1,1,0.398,0.406,0.333,29
enforcement,-0.857,94,325,1,1,0.594,0.571,0.736,419
concussion,-0.857,36,126,1,1,0.072,0.708,0.482,162
similar,-0.858,3173,10905,1,1,0.562,0.25,0.423,14078
cohabitation,-0.858,15,54,1,1,0.646,0.526,0.598,69
saturate,-0.86,8,30,1,1,0.281,0.68,0.467,38
carton,-0.862,57,199,1,1,0.286,0.186,0.241,256
restroom,-0.862,130,451,1,1,0.653,0.279,0.267,581
nationwide,-0.863,52,182,1,1,0.684,0.217,0.672,234
inconsistency,-0.863,21,75,1,1,0.125,0.48,0.314,96
nebula,-0.863,76,265,1,1,0.51,0.418,0.438,341
pediatric,-0.863,10,37,1,1,0.56,0.462,0.49,47
democratic,-0.864,352,1219,1,1,0.802,0.519,0.798,1571
earl,-0.865,121,421,1,1,0.582,0.461,0.794,542
infuriating,-0.865,101,352,1,1,0.139,0.87,0.509,453
lease,-0.869,136,475,1,1,0.52,0.463,0.545,611
travesty,-0.869,60,211,1,1,0.354,0.644,0.407,271
panic,-0.874,1870,6529,1,1,0.062,0.938,0.4,8399
bickering,-0.874,50,177,1,1,0.122,0.8,0.536,227
ingrained,-0.874,54,191,1,1,0.531,0.49,0.712,245
sharing,-0.876,5772,20199,1,1,0.827,0.462,0.545,25971
municipality,-0.876,5,20,1,1,0.569,0.28,0.614,25
flak,-0.876,11,41,1,1,0.39,0.6,0.6,52
bowel,-0.876,19,69,1,1,0.306,0.417,0.391,88
tidy,-0.876,69,244,1,1,0.76,0.208,0.647,313
irrefutable,-0.876,11,41,1,1,0.496,0.549,0.716,52
reporter,-0.879,211,743,1,1,0.531,0.55,0.604,954
filing,-0.879,52,185,1,1,0.62,0.42,0.7,237
constituency,-0.88,42,150,1,1,0.5,0.48,0.696,192
cooker,-0.88,40,143,1,1,0.592,0.373,0.407,183
molester,-0.881,28,101,1,1,0.143,0.811,0.478,129
testify,-0.882,80,284,1,1,0.521,0.65,0.741,364
antibiotics,-0.882,24,87,1,1,0.448,0.406,0.557,111
constitutional,-0.883,68,242,1,1,0.633,0.418,0.827,310
prosecutor,-0.884,37,133,1,1,0.45,0.491,0.796,170
counseling,-0.884,238,842,1,1,0.667,0.48,0.704,1080
scares,-0.884,1018,3594,1,1,0.122,0.847,0.386,4612
molestation,-0.885,33,119,1,1,0.102,0.808,0.407,152
mortgage,-0.886,93,331,1,1,0.255,0.408,0.537,424
underwear,-0.886,265,939,1,1,0.61,0.546,0.375,1204
wage,-0.886,216,766,1,1,0.635,0.48,0.565,982
flint,-0.887,55,197,1,1,0.521,0.439,0.536,252
sedition,-0.887,12,45,1,1,0.327,0.557,0.591,57
infusion,-0.887,12,45,1,1,0.583,0.365,0.453,57
neurologist,-0.887,12,45,1,1,0.608,0.5,0.736,57
ditto,-0.888,114,406,1,1,0.449,0.418,0.411,520
mri,-0.888,23,84,1,1,0.365,0.431,0.349,107
firm,-0.888,355,1260,1,1,0.635,0.38,0.728,1615
thoughts,-0.891,14604,51880,1,1,0.745,0.382,0.691,66484
speedy,-0.892,62,223,1,1,0.625,0.625,0.793,285
comforting,-0.894,2136,7610,1,1,0.906,0.337,0.62,9746
counselor,-0.895,248,887,1,1,0.873,0.365,0.706,1135
forefathers,-0.897,13,49,1,1,0.69,0.412,0.627,62
duplicity,-0.897,6,24,1,1,0.406,0.5,0.578,30
doer,-0.897,6,24,1,1,0.724,0.55,0.728,30
rape,-0.897,927,3315,1,1,0.062,0.856,0.527,4242
ultrasound,-0.899,18,67,1,1,0.573,0.594,0.6,85
mandate,-0.899,42,153,1,1,0.448,0.67,0.779,195
hesitate,-0.901,805,2890,1,1,0.459,0.548,0.232,3695
bladder,-0.902,38,139,1,1,0.406,0.412,0.33,177
election,-0.903,803,2890,1,1,0.625,0.519,0.651,3693
wracking,-0.905,19,71,1,1,0.244,0.607,0.454,90
remission,-0.907,22,82,1,1,0.418,0.33,0.518,104
zip,-0.908,107,389,1,1,0.487,0.368,0.422,496
helpful,-0.911,1109,4019,1,1,0.816,0.337,0.705,5128
counsellor,-0.911,68,249,1,1,0.823,0.327,0.74,317
sew,-0.911,76,278,1,1,0.51,0.34,0.34,354
birthright,-0.912,15,57,1,1,0.684,0.417,0.714,72
namaste,-0.915,32,119,1,1,0.719,0.255,0.464,151
accuse,-0.916,152,556,1,1,0.133,0.752,0.5,708
unintentionally,-0.919,183,671,1,1,0.46,0.49,0.286,854
governor,-0.919,152,558,1,1,0.5,0.683,0.934,710
upgrade,-0.92,211,774,1,1,0.786,0.5,0.67,985
colonoscopy,-0.923,5,21,1,1,0.208,0.524,0.466,26
iniquity,-0.923,5,21,1,1,0.219,0.567,0.425,26
rebate,-0.923,5,21,1,1,0.667,0.569,0.51,26
changeable,-0.923,8,32,1,1,0.49,0.48,0.528,40
acupuncture,-0.923,5,21,1,1,0.531,0.324,0.549,26
militia,-0.923,11,43,1,1,0.396,0.729,0.769,54
vigilance,-0.923,11,43,1,1,0.49,0.615,0.724,54
elect,-0.927,59,220,1,1,0.667,0.554,0.661,279
paramedics,-0.928,18,69,1,1,0.479,0.594,0.712,87
criminality,-0.929,15,58,1,1,0.122,0.863,0.58,73
weirdness,-0.931,105,391,1,1,0.316,0.491,0.364,496
lisp,-0.932,9,36,1,1,0.365,0.412,0.288,45
extraterrestrial,-0.932,29,110,1,1,0.51,0.833,0.792,139
candidate,-0.934,309,1148,1,1,0.596,0.49,0.804,1457
horrified,-0.934,105,392,1,1,0.04,0.885,0.368,497
toenail,-0.936,6,25,1,1,0.53,0.38,0.306,31
malfeasance,-0.936,6,25,1,1,0.062,0.745,0.325,31
sneeze,-0.937,134,501,1,1,0.271,0.442,0.336,635
revolt,-0.937,24,92,1,1,0.343,0.878,0.658,116
seedy,-0.938,35,133,1,1,0.229,0.39,0.325,168
metabolism,-0.939,10,40,1,1,0.698,0.509,0.555,50
interference,-0.939,54,204,1,1,0.396,0.736,0.357,258
appalled,-0.941,70,264,1,1,0.194,0.792,0.562,334
bathroom,-0.942,1591,5946,1,1,0.561,0.283,0.345,7537
reassure,-0.943,265,994,1,1,0.837,0.306,0.63,1259
tabloid,-0.943,26,100,1,1,0.438,0.365,0.444,126
sinner,-0.943,200,751,1,1,0.237,0.667,0.356,951
assailant,-0.945,7,29,1,1,0.184,0.868,0.602,36
exact,-0.946,1464,5495,1,1,0.719,0.354,0.685,6959
administration,-0.946,297,1117,1,1,0.625,0.404,0.786,1414
domestic,-0.947,445,1674,1,1,0.729,0.327,0.5,2119
procedure,-0.948,57,217,1,1,0.625,0.548,0.654,274
restrict,-0.949,37,142,1,1,0.115,0.539,0.577,179
ignition,-0.951,12,48,1,1,0.365,0.72,0.657,60
scariest,-0.951,308,1164,1,1,0.167,0.863,0.538,1472
harassment,-0.954,313,1187,1,1,0.083,0.896,0.42,1500
probability,-0.955,65,249,1,1,0.673,0.365,0.651,314
candor,-0.956,23,90,1,1,0.74,0.389,0.607,113
grating,-0.962,15,60,1,1,0.512,0.337,0.282,75
investigation,-0.962,246,941,1,1,0.531,0.592,0.82,1187
enrollment,-0.963,10,41,1,1,0.667,0.391,0.698,51
sciatica,-0.967,5,22,1,1,0.286,0.443,0.393,27
sepsis,-0.967,11,45,1,1,0.229,0.452,0.327,56
disclosure,-0.973,75,292,1,1,0.5,0.615,0.71,367
candlestick,-0.974,6,26,1,1,0.448,0.531,0.534,32
bead,-0.974,27,107,1,1,0.592,0.388,0.381,134
unprofessional,-0.978,31,123,1,1,0.042,0.37,0.17,154
punitive,-0.978,7,30,1,1,0.281,0.576,0.605,37
projectile,-0.978,7,30,1,1,0.276,0.865,0.774,37
suitable,-0.979,273,1062,1,1,0.792,0.298,0.722,1335
libel,-0.982,8,34,1,1,0.128,0.694,0.403,42
gutless,-0.982,17,69,1,1,0.25,0.381,0.384,86
praying,-0.982,2027,7890,1,1,0.646,0.235,0.415,9917
unsafe,-0.983,237,926,1,1,0.115,0.562,0.147,1163
smear,-0.987,64,253,1,1,0.23,0.433,0.4,317
infantry,-0.987,10,42,1,1,0.531,0.684,0.791,52
unarmed,-0.988,33,132,1,1,0.427,0.42,0.241,165
lawful,-0.989,11,46,1,1,0.66,0.394,0.78,57
sandman,-0.994,227,897,1,1,0.479,0.469,0.388,1124
dispose,-0.995,16,66,1,1,0.548,0.538,0.559,82
tarantula,-0.996,17,70,1,1,0.26,0.718,0.544,87
stove,-0.998,83,331,1,1,0.466,0.391,0.405,414
infuriates,-0.999,21,86,1,1,0.135,0.913,0.627,107
irritates,-0.999,68,272,1,1,0.173,0.81,0.295,340
clone,-1.003,298,1187,1,1,0.406,0.471,0.524,1485
resources,-1.006,716,2855,1,1,0.604,0.348,0.627,3571
peephole,-1.01,5,23,1,1,0.479,0.5,0.31,28
improper,-1.01,15,63,1,1,0.229,0.52,0.259,78
unzip,-1.01,13,55,1,1,0.378,0.52,0.538,68
crucifix,-1.01,7,31,1,1,0.469,0.48,0.51,38
revoke,-1.01,18,75,1,1,0.251,0.696,0.737,93
speakerphone,-1.01,8,35,1,1,0.531,0.569,0.56,43
pelvis,-1.01,5,23,1,1,0.378,0.618,0.38,28
teething,-1.01,9,39,1,1,0.396,0.471,0.474,48
earshot,-1.01,11,47,1,1,0.552,0.332,0.408,58
bewilderment,-1.01,12,51,1,1,0.312,0.716,0.216,63
struggle,-1.013,5688,22822,1,1,0.365,0.82,0.741,28510
expenses,-1.02,101,411,1,1,0.24,0.633,0.396,512
escalate,-1.02,24,100,1,1,0.653,0.714,0.728,124
uninterrupted,-1.022,41,169,1,1,0.5,0.434,0.527,210
democracy,-1.023,460,1867,1,1,0.68,0.5,0.84,2327
classification,-1.026,14,60,1,1,0.583,0.423,0.613,74
disliking,-1.028,66,272,1,1,0.163,0.637,0.366,338
deviate,-1.031,11,48,1,1,0.173,0.562,0.269,59
silverware,-1.031,11,48,1,1,0.663,0.365,0.409,59
hypochondriac,-1.032,10,44,1,1,0.194,0.588,0.333,54
exemption,-1.037,8,36,1,1,0.531,0.578,0.627,44
sender,-1.038,95,394,1,1,0.542,0.449,0.509,489
reelection,-1.041,7,32,1,1,0.541,0.673,0.681,39
competency,-1.041,7,32,1,1,0.768,0.775,0.764,39
forwarding,-1.045,6,28,1,1,0.583,0.537,0.51,34
live,-1.05,49913,207754,1,1,0.88,0.673,0.676,257667
nibble,-1.051,29,124,1,1,0.551,0.551,0.411,153
jargon,-1.054,10,45,1,1,0.333,0.548,0.404,55
dictatorship,-1.061,47,201,1,1,0.082,0.806,0.784,248
seizure,-1.063,54,231,1,1,0.177,0.775,0.462,285
terrify,-1.063,31,134,1,1,0.052,0.889,0.509,165
disqualify,-1.064,8,37,1,1,0.208,0.595,0.267,45
corruption,-1.064,344,1456,1,1,0.052,0.83,0.549,1800
suspect,-1.065,812,3434,1,1,0.133,0.75,0.509,4246
journalistic,-1.066,12,54,1,1,0.696,0.449,0.495,66
invention,-1.066,94,401,1,1,0.714,0.577,0.811,495
living,-1.068,32349,137092,1,1,0.865,0.608,0.727,169441
washer,-1.068,41,177,1,1,0.594,0.39,0.365,218
receiver,-1.072,34,148,1,1,0.583,0.464,0.586,182
mace,-1.073,26,114,1,1,0.45,0.412,0.415,140
fearfully,-1.076,10,46,1,1,0.112,0.567,0.271,56
duplex,-1.076,10,46,1,1,0.592,0.452,0.467,56
constitution,-1.077,169,726,1,1,0.59,0.38,0.889,895
freaked,-1.08,191,823,1,1,0.135,0.917,0.34,1014
impeachment,-1.081,115,497,1,1,0.163,0.735,0.694,612
openness,-1.082,100,433,1,1,0.837,0.561,0.667,533
empower,-1.082,157,678,1,1,0.694,0.779,0.891,835
courageous,-1.083,266,1148,1,1,0.918,0.587,0.879,1414
soundproof,-1.084,12,55,1,1,0.49,0.39,0.409,67
voting,-1.089,744,3224,1,1,0.615,0.602,0.768,3968
lute,-1.09,14,64,1,1,0.459,0.407,0.5,78
dictatorial,-1.09,5,25,1,1,0.204,0.77,0.84,30
grieve,-1.091,320,1392,1,1,0.122,0.5,0.333,1712
cabal,-1.095,41,182,1,1,0.5,0.406,0.573,223
scattering,-1.095,13,60,1,1,0.347,0.55,0.394,73
stigma,-1.098,845,3694,1,1,0.327,0.5,0.47,4539
malpractice,-1.1,7,34,1,1,0.094,0.559,0.33,41
assured,-1.103,292,1285,1,1,0.878,0.327,0.754,1577
recollect,-1.103,22,100,1,1,0.688,0.491,0.602,122
reprehensible,-1.103,22,100,1,1,0.316,0.569,0.351,122
replenish,-1.105,14,65,1,1,0.615,0.336,0.689,79
constraint,-1.105,4,21,1,1,0.323,0.55,0.481,25
escalation,-1.112,6,30,1,1,0.571,0.807,0.582,36
relieved,-1.114,528,2346,1,1,0.896,0.314,0.391,2874
paralyze,-1.115,8,39,1,1,0.188,0.367,0.471,47
destined,-1.116,1380,6141,1,1,0.698,0.462,0.617,7521
testimony,-1.117,154,689,1,1,0.615,0.578,0.643,843
vote,-1.119,2591,11558,1,1,0.582,0.5,0.649,14149
thirteen,-1.12,109,490,1,1,0.459,0.385,0.331,599
strong,-1.12,12080,53966,1,1,0.912,0.745,0.895,66046
indestructible,-1.123,24,111,1,1,0.772,0.731,0.853,135
incumbent,-1.128,9,44,1,1,0.396,0.54,0.565,53
cutlery,-1.128,17,80,1,1,0.552,0.3,0.345,97
regimen,-1.128,7,35,1,1,0.428,0.538,0.84,42
undisturbed,-1.128,23,107,1,1,0.725,0.287,0.434,130
reprimand,-1.128,5,26,1,1,0.153,0.528,0.465,31
oncology,-1.128,5,26,1,1,0.204,0.424,0.5,31
unconscionable,-1.136,12,58,1,1,0.208,0.618,0.429,70
evacuate,-1.14,17,81,1,1,0.354,0.792,0.314,98
regard,-1.14,331,1512,1,1,0.802,0.336,0.809,1843
foresight,-1.142,29,136,1,1,0.68,0.482,0.64,165
intercede,-1.143,6,31,1,1,0.582,0.577,0.63,37
terrified,-1.147,1360,6240,1,1,0.09,0.902,0.387,7600
scarier,-1.147,150,692,1,1,0.156,0.846,0.472,842
payload,-1.15,4,22,1,1,0.612,0.51,0.682,26
casing,-1.15,4,22,1,1,0.458,0.327,0.328,26
willies,-1.15,4,22,1,1,0.48,0.49,0.42,26
outpouring,-1.154,33,156,1,1,0.562,0.685,0.552,189
understaffed,-1.155,7,36,1,1,0.148,0.444,0.302,43
violation,-1.155,39,184,1,1,0.083,0.892,0.413,223
assure,-1.156,419,1944,1,1,0.91,0.46,0.839,2363
solidarity,-1.158,576,2676,1,1,0.792,0.407,0.781,3252
phobia,-1.16,177,826,1,1,0.173,0.904,0.291,1003
electoral,-1.163,46,218,1,1,0.49,0.631,0.602,264
permissible,-1.164,8,41,1,1,0.684,0.646,0.612,49
survivor,-1.167,562,2635,1,1,0.677,0.75,0.815,3197
interruption,-1.17,25,121,1,1,0.184,0.632,0.425,146
illuminate,-1.17,97,459,1,1,0.905,0.646,0.782,556
unsteady,-1.172,36,173,1,1,0.122,0.5,0.19,209
doorknob,-1.177,10,51,1,1,0.406,0.553,0.462,61
assessment,-1.187,167,801,1,1,0.75,0.623,0.658,968
handgun,-1.188,8,42,1,1,0.156,0.914,0.782,50
blindfolded,-1.188,8,42,1,1,0.208,0.564,0.209,50
ocd,-1.19,238,1144,1,1,0.333,0.472,0.37,1382
accused,-1.192,341,1640,1,1,0.13,0.67,0.42,1981
renovate,-1.192,4,23,1,1,0.878,0.549,0.755,27
burglary,-1.192,4,23,1,1,0.146,0.918,0.543,27
redress,-1.192,4,23,1,1,0.677,0.558,0.649,27
ptsd,-1.196,671,3236,1,1,0.373,0.52,0.346,3907
cereals,-1.196,10,52,1,1,0.719,0.224,0.311,62
sovereignty,-1.196,49,240,1,1,0.719,0.529,0.886,289
reassured,-1.198,116,564,1,1,0.854,0.186,0.519,680
dermatologist,-1.199,5,28,1,1,0.531,0.358,0.528,33
groceries,-1.2,239,1160,1,1,0.74,0.363,0.417,1399
numbering,-1.204,6,33,1,1,0.51,0.363,0.482,39
debacle,-1.207,30,150,1,1,0.156,0.606,0.266,180
genesis,-1.208,309,1510,1,1,0.612,0.429,0.658,1819
mobilize,-1.208,7,38,1,1,0.604,0.684,0.727,45
awry,-1.209,16,82,1,1,0.156,0.54,0.275,98
revulsion,-1.215,10,53,1,1,0.104,0.765,0.343,63
hydrate,-1.216,11,58,1,1,0.61,0.367,0.547,69
elevator,-1.217,276,1362,1,1,0.562,0.604,0.676,1638
prosecution,-1.219,27,137,1,1,0.245,0.857,0.647,164
prevail,-1.219,132,655,1,1,0.724,0.557,0.75,787
valid,-1.221,1121,5543,1,1,0.693,0.353,0.565,6664
treaty,-1.222,17,88,1,1,0.646,0.382,0.667,105
epilepsy,-1.222,54,271,1,1,0.061,0.854,0.25,325
transparency,-1.233,76,384,1,1,0.847,0.26,0.587,460
plunger,-1.233,4,24,1,1,0.365,0.51,0.373,28
gubernatorial,-1.233,5,29,1,1,0.552,0.604,0.897,34
untoward,-1.233,4,24,1,1,0.122,0.555,0.291,28
polygraph,-1.233,5,29,1,1,0.427,0.491,0.602,34
jurisdiction,-1.233,9,49,1,1,0.48,0.58,0.82,58
emetophobia,-1.233,5,29,1,1,0.243,0.62,0.403,34
leukemia,-1.233,24,124,1,1,0.094,0.572,0.351,148
oath,-1.238,84,426,1,1,0.543,0.615,0.824,510
reckoning,-1.244,52,267,1,1,0.418,0.622,0.532,319
patriot,-1.246,242,1230,1,1,0.771,0.635,0.886,1472
assuredly,-1.246,14,75,1,1,0.786,0.396,0.833,89
zipper,-1.251,21,111,1,1,0.39,0.315,0.233,132
ford,-1.252,379,1936,1,1,0.521,0.34,0.382,2315
customary,-1.253,9,50,1,1,0.7,0.253,0.561,59
terrifies,-1.255,100,515,1,1,0.083,0.923,0.5,615
pelvic,-1.258,7,40,1,1,0.32,0.632,0.373,47
dying,-1.259,7517,38566,1,1,0.04,0.664,0.422,46083
attacker,-1.26,28,148,1,1,0.185,0.962,0.629,176
vigilant,-1.268,49,258,1,1,0.469,0.643,0.791,307
dawn,-1.27,1382,7174,1,1,0.827,0.235,0.519,8556
corroborate,-1.272,9,51,1,1,0.671,0.471,0.616,60
earthquake,-1.276,85,448,1,1,0.073,0.93,0.812,533
bravery,-1.282,214,1128,1,1,0.898,0.745,0.868,1342
hind,-1.284,37,199,1,1,0.483,0.644,0.337,236
constituent,-1.286,10,57,1,1,0.573,0.5,0.827,67
misplace,-1.291,9,52,1,1,0.229,0.461,0.191,61
meningitis,-1.298,5,31,1,1,0.104,0.612,0.407,36
glare,-1.3,83,448,1,1,0.698,0.735,0.733,531
allegation,-1.3,25,138,1,1,0.578,0.578,0.608,163
panicking,-1.302,140,754,1,1,0.094,0.882,0.333,894
falsely,-1.304,92,498,1,1,0.083,0.48,0.265,590
intruder,-1.305,26,144,1,1,0.146,0.74,0.324,170
prudent,-1.307,12,69,1,1,0.706,0.25,0.657,81
phew,-1.309,231,1251,1,1,0.531,0.429,0.302,1482
unseat,-1.31,4,26,1,1,0.229,0.5,0.312,30
treatable,-1.318,17,97,1,1,0.78,0.302,0.56,114
accusation,-1.321,71,392,1,1,0.073,0.718,0.564,463
psoriasis,-1.322,14,81,1,1,0.125,0.674,0.33,95
imposition,-1.328,5,32,1,1,0.357,0.604,0.618,37
corroboration,-1.328,5,32,1,1,0.625,0.431,0.733,37
glade,-1.342,25,144,1,1,0.6,0.385,0.434,169
supervision,-1.344,50,284,1,1,0.459,0.578,0.825,334
thyroid,-1.351,15,89,1,1,0.234,0.455,0.373,104
dismayed,-1.352,29,168,1,1,0.165,0.735,0.389,197
hyperventilating,-1.355,19,112,1,1,0.164,0.802,0.625,131
candidacy,-1.358,8,50,1,1,0.49,0.657,0.696,58
median,-1.358,11,67,1,1,0.459,0.216,0.375,78
extraneous,-1.358,5,33,1,1,0.276,0.625,0.478,38
withholding,-1.371,18,108,1,1,0.165,0.49,0.48,126
oncologist,-1.373,3,22,1,1,0.26,0.654,0.64,25
cilantro,-1.373,7,45,1,1,0.469,0.26,0.208,52
fluency,-1.373,3,22,1,1,0.776,0.504,0.718,25
abdominal,-1.391,6,40,1,1,0.49,0.456,0.445,46
voter,-1.395,149,881,1,1,0.612,0.538,0.754,1030
outage,-1.397,27,164,1,1,0.306,0.684,0.438,191
quarter,-1.409,374,2234,1,1,0.568,0.296,0.509,2608
injuring,-1.415,3,23,1,1,0.073,0.79,0.245,26
recoup,-1.415,9,59,1,1,0.719,0.422,0.575,68
regroup,-1.419,40,246,1,1,0.633,0.602,0.797,286
cyst,-1.447,20,129,1,1,0.173,0.578,0.312,149
prohibit,-1.448,4,30,1,1,0.167,0.758,0.537,34
completely,-1.452,8416,52384,1,1,0.73,0.37,0.69,60800
reinstate,-1.453,12,80,1,1,0.76,0.551,0.596,92
psi,-1.456,3,24,1,1,0.429,0.454,0.449,27
hallelujah,-1.457,130,818,1,1,0.77,0.554,0.657,948
precaution,-1.464,9,62,1,1,0.625,0.52,0.406,71
miscarriage,-1.47,141,899,1,1,0.042,0.781,0.312,1040
condolences,-1.476,183,1172,1,1,0.198,0.48,0.288,1355
lymphoma,-1.48,4,31,1,1,0.208,0.645,0.33,35
ballot,-1.512,65,435,1,1,0.521,0.361,0.358,500
sentiment,-1.512,311,2061,1,1,0.765,0.451,0.639,2372
hysterectomy,-1.515,7,52,1,1,0.178,0.66,0.47,59
jeans,-1.522,289,1934,1,1,0.622,0.324,0.371,2223
drumming,-1.524,34,233,1,1,0.594,0.75,0.426,267
culpability,-1.533,3,26,1,1,0.112,0.745,0.368,29
unsupervised,-1.537,26,182,1,1,0.478,0.481,0.442,208
burp,-1.543,21,149,1,1,0.219,0.594,0.432,170
referendum,-1.563,91,639,1,1,0.51,0.469,0.643,730
uneven,-1.57,40,286,1,1,0.125,0.457,0.24,326
hyperventilate,-1.57,4,34,1,1,0.347,0.729,0.556,38
jumpy,-1.57,15,111,1,1,0.353,0.81,0.216,126
confidential,-1.571,100,707,1,1,0.643,0.471,0.761,807
die,-1.571,30307,212532,1,1,0.031,0.765,0.259,242839
reputation,-1.588,391,2795,1,1,0.74,0.542,0.721,3186
startle,-1.6,13,100,1,1,0.276,0.817,0.417,113
promiscuous,-1.6,83,605,1,1,0.214,0.8,0.436,688
reassuring,-1.606,264,1922,1,1,0.847,0.308,0.691,2186
dishwasher,-1.607,44,326,1,1,0.48,0.296,0.324,370
stationery,-1.61,6,50,1,1,0.57,0.12,0.455,56
complementary,-1.613,12,94,1,1,0.714,0.32,0.586,106
confidentially,-1.616,5,43,1,1,0.633,0.469,0.558,48
decompress,-1.639,31,239,1,1,0.438,0.43,0.509,270
unafraid,-1.668,32,254,1,1,0.5,0.52,0.655,286
insulin,-1.684,12,101,1,1,0.429,0.472,0.375,113
sedation,-1.703,3,31,1,1,0.51,0.27,0.398,34
cervical,-1.703,5,47,1,1,0.375,0.413,0.445,52
stepdaughter,-1.703,2,23,1,1,0.51,0.51,0.432,25
deductible,-1.724,5,48,1,1,0.375,0.286,0.455,53
assault,-1.728,461,3789,1,1,0.167,0.848,0.55,4250
helper,-1.729,192,1583,1,1,0.704,0.438,0.567,1775
recharge,-1.741,298,2484,1,1,0.584,0.702,0.664,2782
prevention,-1.744,321,2682,1,1,0.76,0.463,0.6,3003
hotline,-1.744,322,2692,1,1,0.592,0.565,0.663,3014
glad,-1.753,12344,103806,1,1,0.938,0.76,0.74,116150
stonewall,-1.775,4,42,1,1,0.337,0.457,0.655,46
misconduct,-1.777,17,154,1,1,0.061,0.667,0.304,171
reeling,-1.845,86,801,1,1,0.327,0.542,0.267,887
refuel,-1.862,15,149,1,1,0.592,0.445,0.5,164
sunscreen,-1.926,14,149,1,1,0.656,0.387,0.462,163
alb,-1.94,6,70,1,1,0.521,0.38,0.427,76
suffer,-2.017,5017,54958,1,1,0.082,0.91,0.259,59975
flares,-2.181,29,386,1,1,0.58,0.642,0.556,415
nylons,-2.189,1,25,1,1,0.556,0.379,0.32,26
petrified,-2.248,84,1172,1,1,0.221,0.625,0.232,1256
thankgod,-2.251,5,82,1,1,0.823,0.451,0.466,87
thermostat,-2.307,10,160,1,1,0.439,0.48,0.321,170
gunfire,-2.373,15,249,1,1,0.156,0.93,0.673,264
dusk,-2.59,354,6890,1,1,0.532,0.276,0.519,7244
trench,-2.773,277,6484,1,1,0.429,0.76,0.429,6761
aftertaste,-2.798,31,764,1,1,0.354,0.362,0.455,795
impropriety,-2.812,3,96,1,1,0.133,0.591,0.389,99
hastily,-3.114,14,491,1,1,0.271,0.609,0.609,505
deejay,-3.468,16,793,1,1,0.551,0.63,0.473,809
poise,-4.173,17,1701,1,1,0.677,0.202,0.708,1718
