Term,pmi,freq_pos,freq_neg,VAD original,VAD extended,valence,arousal,dominance,frequency
fortress,6.635,5249,122,1,1,0.816,0.5,0.933,5371
cholera,5.507,151,10,1,1,0.02,0.867,0.507,161
shire,5.253,149,13,1,1,0.479,0.257,0.609,162
vega,5.193,110,10,1,1,0.51,0.333,0.434,120
porous,5.184,59,5,1,1,0.385,0.37,0.264,64
richness,5.115,251,26,1,1,0.896,0.833,0.922,277
revue,5.009,83,9,1,1,0.594,0.35,0.42,92
incline,4.827,83,11,1,1,0.49,0.423,0.345,94
pensive,4.559,165,30,1,1,0.54,0.22,0.529,195
monotony,4.513,178,34,1,1,0.398,0.135,0.353,212
refreshment,4.509,55,10,1,1,0.667,0.41,0.352,65
oft,4.376,155,34,1,1,0.5,0.308,0.474,189
austere,4.298,32,7,1,1,0.5,0.39,0.422,39
peopled,4.296,106,25,1,1,0.594,0.45,0.679,131
contemplation,4.291,306,74,1,1,0.552,0.324,0.627,380
stillness,4.176,583,159,1,1,0.729,0.125,0.339,742
hundred,4.163,3844,1066,1,1,0.604,0.37,0.406,4910
exaltation,4.154,24,6,1,1,0.594,0.892,0.673,30
realism,4.112,201,58,1,1,0.74,0.545,0.67,259
lofty,4.029,103,32,1,1,0.755,0.306,0.569,135
uniformity,4.002,45,14,1,1,0.745,0.353,0.538,59
purification,3.98,41,13,1,1,0.847,0.452,0.774,54
mirth,3.946,28,9,1,1,0.888,0.64,0.608,37
confederacy,3.937,22,7,1,1,0.59,0.541,0.736,29
monastery,3.851,57,21,1,1,0.694,0.183,0.726,78
dissatisfaction,3.836,186,71,1,1,0.115,0.663,0.202,257
superman,3.813,913,359,1,1,0.945,0.794,0.929,1272
lifeblood,3.797,19,7,1,1,0.673,0.69,0.708,26
slowness,3.741,25,10,1,1,0.302,0.212,0.191,35
heady,3.728,34,14,1,1,0.448,0.806,0.565,48
nightingale,3.714,45,19,1,1,0.74,0.34,0.496,64
monastic,3.714,45,19,1,1,0.438,0.314,0.676,64
contemplative,3.704,81,35,1,1,0.729,0.308,0.739,116
servitude,3.676,30,13,1,1,0.25,0.49,0.25,43
colonel,3.62,110,52,1,1,0.459,0.592,0.89,162
sweetness,3.62,311,148,1,1,0.906,0.474,0.528,459
idleness,3.615,24,11,1,1,0.308,0.33,0.228,35
picturesque,3.605,32,15,1,1,0.802,0.491,0.483,47
bliss,3.596,1935,946,1,1,0.816,0.5,0.782,2881
tumult,3.574,17,8,1,1,0.271,0.64,0.636,25
savagery,3.574,41,20,1,1,0.219,0.907,0.711,61
blend,3.494,396,214,1,1,0.469,0.452,0.463,610
mockingbird,3.473,46,25,1,1,0.513,0.337,0.423,71
merriment,3.469,26,14,1,1,0.948,0.721,0.632,40
cultivation,3.469,17,9,1,1,0.625,0.324,0.462,26
tranquility,3.438,423,242,1,1,0.84,0.135,0.442,665
bustle,3.427,106,61,1,1,0.347,0.814,0.445,167
tranquil,3.389,117,70,1,1,0.917,0.094,0.355,187
altitude,3.351,39,24,1,1,0.708,0.482,0.736,63
scenic,3.313,56,36,1,1,0.684,0.548,0.756,92
glacier,3.312,19,12,1,1,0.573,0.396,0.554,31
sphinx,3.312,19,12,1,1,0.604,0.324,0.49,31
blissful,3.295,368,243,1,1,0.885,0.639,0.676,611
stout,3.287,23,15,1,1,0.656,0.657,0.817,38
bask,3.277,158,106,1,1,0.76,0.33,0.381,264
simplicity,3.268,180,122,1,1,0.667,0.25,0.337,302
bustling,3.267,49,33,1,1,0.49,0.85,0.528,82
chronicle,3.258,34,23,1,1,0.427,0.571,0.586,57
simplify,3.257,66,45,1,1,0.565,0.347,0.602,111
mournful,3.249,25,17,1,1,0.18,0.441,0.188,42
labyrinth,3.243,88,61,1,1,0.479,0.811,0.491,149
introspection,3.234,265,186,1,1,0.603,0.337,0.575,451
transcendence,3.229,16,11,1,1,0.656,0.608,0.754,27
serenity,3.221,585,416,1,1,0.9,0.122,0.557,1001
overshadow,3.208,42,30,1,1,0.333,0.549,0.654,72
adaptation,3.203,97,70,1,1,0.663,0.365,0.609,167
finality,3.195,25,18,1,1,0.615,0.368,0.627,43
penance,3.183,45,33,1,1,0.219,0.667,0.463,78
repose,3.169,43,32,1,1,0.469,0.1,0.33,75
retreat,3.16,604,457,1,1,0.5,0.519,0.312,1061
gentleness,3.14,56,43,1,1,0.927,0.278,0.447,99
seclusion,3.137,283,219,1,1,0.23,0.558,0.505,502
ascetic,3.133,17,13,1,1,0.438,0.375,0.472,30
solitaire,3.131,85,66,1,1,0.365,0.227,0.279,151
metropolis,3.128,31,24,1,1,0.656,0.625,0.779,55
intrusion,3.122,55,43,1,1,0.293,0.641,0.67,98
trample,3.098,40,32,1,1,0.235,0.764,0.562,72
durable,3.092,20,16,1,1,0.74,0.294,0.688,36
desolation,3.09,84,68,1,1,0.073,0.481,0.273,152
reverie,3.089,15,12,1,1,0.667,0.413,0.471,27
meridian,3.064,17,14,1,1,0.51,0.324,0.558,31
starved,3.062,253,211,1,1,0.097,0.689,0.219,464
perilous,3.058,36,30,1,1,0.143,0.862,0.575,66
priestess,3.053,18,15,1,1,0.531,0.39,0.691,33
sullen,3.048,25,21,1,1,0.25,0.407,0.263,46
pleasures,3.04,197,168,1,1,0.896,0.654,0.705,365
serene,3.039,184,157,1,1,0.802,0.132,0.37,341
sleepless,3.038,531,454,1,1,0.213,0.41,0.207,985
metamorphosis,3.035,20,17,1,1,0.541,0.571,0.613,37
destitute,3.034,91,78,1,1,0.13,0.451,0.222,169
refining,3.015,23,20,1,1,0.694,0.466,0.664,43
cavern,3.015,15,13,1,1,0.323,0.36,0.365,28
vacant,3.01,164,144,1,1,0.578,0.22,0.464,308
descent,2.999,98,87,1,1,0.3,0.402,0.158,185
monk,2.996,146,130,1,1,0.472,0.208,0.439,276
illicit,2.99,28,25,1,1,0.188,0.794,0.39,53
lightness,2.974,33,30,1,1,0.794,0.36,0.526,63
gregarious,2.968,35,32,1,1,0.551,0.471,0.529,67
seductive,2.961,51,47,1,1,0.771,0.821,0.667,98
wanderer,2.958,53,49,1,1,0.458,0.519,0.396,102
ingenious,2.955,13,12,1,1,0.76,0.69,0.891,25
opus,2.955,13,12,1,1,0.458,0.368,0.391,25
enchanting,2.95,29,27,1,1,0.917,0.681,0.708,56
pilgrimage,2.948,30,28,1,1,0.708,0.522,0.625,58
regeneration,2.946,15,14,1,1,0.76,0.64,0.845,29
enchanted,2.942,67,63,1,1,0.917,0.633,0.687,130
entangled,2.937,36,34,1,1,0.319,0.578,0.357,70
frightful,2.935,37,35,1,1,0.125,0.755,0.455,72
canyon,2.933,118,112,1,1,0.468,0.731,0.634,230
futility,2.932,39,37,1,1,0.125,0.32,0.176,76
sanctum,2.928,21,20,1,1,0.521,0.438,0.657,41
meditative,2.923,48,46,1,1,0.614,0.12,0.454,94
divinity,2.923,48,46,1,1,0.896,0.559,0.774,94
samurai,2.918,55,53,1,1,0.562,0.736,0.838,108
pristine,2.914,30,29,1,1,0.65,0.363,0.625,59
meditation,2.902,865,847,1,1,0.786,0.12,0.478,1712
tame,2.895,142,140,1,1,0.56,0.604,0.642,282
meandering,2.881,18,18,1,1,0.427,0.644,0.539,36
loch,2.881,18,18,1,1,0.449,0.235,0.425,36
component,2.855,73,75,1,1,0.531,0.382,0.525,148
glove,2.853,105,108,1,1,0.5,0.23,0.382,213
mediation,2.851,32,33,1,1,0.661,0.35,0.657,65
ode,2.847,84,87,1,1,0.604,0.269,0.519,171
ephemeral,2.845,26,27,1,1,0.5,0.312,0.377,53
ennui,2.84,23,24,1,1,0.406,0.461,0.316,47
splendid,2.838,67,70,1,1,0.896,0.74,0.81,137
painter,2.836,42,44,1,1,0.677,0.366,0.487,86
cascade,2.832,19,20,1,1,0.735,0.509,0.395,39
savor,2.827,89,94,1,1,0.827,0.552,0.526,183
spontaneity,2.824,16,17,1,1,0.817,0.698,0.655,33
confines,2.822,32,34,1,1,0.396,0.386,0.542,66
worldly,2.82,78,83,1,1,0.438,0.612,0.295,161
revel,2.819,92,98,1,1,0.74,0.705,0.684,190
patriarch,2.817,14,15,1,1,0.592,0.448,0.898,29
uninterrupted,2.816,132,141,1,1,0.5,0.434,0.527,273
silky,2.815,43,46,1,1,0.802,0.397,0.271,89
brainy,2.812,13,14,1,1,0.708,0.52,0.648,27
overlord,2.807,25,27,1,1,0.75,0.755,0.932,52
alpine,2.807,12,13,1,1,0.594,0.337,0.474,25
detachment,2.799,81,88,1,1,0.243,0.7,0.443,169
ski,2.795,99,108,1,1,0.684,0.67,0.471,207
skiing,2.793,53,58,1,1,0.823,0.824,0.62,111
rejuvenate,2.79,41,45,1,1,0.776,0.588,0.767,86
jour,2.79,20,22,1,1,0.479,0.394,0.415,42
chagrin,2.77,16,18,1,1,0.104,0.704,0.472,34
mull,2.768,24,27,1,1,0.663,0.34,0.594,51
exile,2.767,115,129,1,1,0.184,0.63,0.483,244
delude,2.765,56,63,1,1,0.143,0.627,0.353,119
moor,2.763,15,17,1,1,0.311,0.464,0.378,32
ambience,2.758,37,42,1,1,0.735,0.356,0.426,79
undertake,2.753,21,24,1,1,0.796,0.702,0.754,45
biography,2.751,35,40,1,1,0.698,0.229,0.718,75
morrow,2.748,27,31,1,1,0.708,0.314,0.49,58
penetrating,2.748,20,23,1,1,0.469,0.792,0.782,43
novelist,2.733,24,28,1,1,0.34,0.343,0.529,52
leisurely,2.727,17,20,1,1,0.806,0.25,0.367,37
enigmatic,2.727,17,20,1,1,0.469,0.589,0.679,37
relaxation,2.724,158,185,1,1,0.873,0.161,0.381,343
creativity,2.723,471,552,1,1,0.938,0.684,0.815,1023
pas,2.722,185,217,1,1,0.49,0.344,0.262,402
deluge,2.719,16,19,1,1,0.245,0.714,0.612,35
attain,2.714,76,90,1,1,0.806,0.51,0.719,166
quaint,2.711,26,31,1,1,0.625,0.463,0.474,57
snowfall,2.709,15,18,1,1,0.675,0.28,0.455,33
moonlit,2.707,20,24,1,1,0.873,0.269,0.508,44
hopper,2.705,51,61,1,1,0.396,0.491,0.442,112
woodland,2.704,30,36,1,1,0.776,0.306,0.48,66
landscape,2.702,147,176,1,1,0.719,0.176,0.423,323
swami,2.699,14,17,1,1,0.51,0.547,0.491,31
alchemy,2.699,19,23,1,1,0.541,0.583,0.693,42
acrylic,2.699,29,35,1,1,0.582,0.279,0.42,64
highlands,2.693,28,34,1,1,0.735,0.431,0.596,62
tout,2.688,46,56,1,1,0.48,0.538,0.375,102
birthplace,2.687,13,16,1,1,0.781,0.29,0.491,29
delighted,2.683,255,311,1,1,0.938,0.664,0.685,566
fortitude,2.678,88,108,1,1,0.823,0.608,0.897,196
restorative,2.678,39,48,1,1,0.633,0.51,0.703,87
juxtaposition,2.676,21,26,1,1,0.427,0.5,0.46,47
allegory,2.674,12,15,1,1,0.615,0.58,0.509,27
sonnet,2.674,12,15,1,1,0.718,0.294,0.404,27
rhythmic,2.674,12,15,1,1,0.714,0.642,0.664,27
delightful,2.67,131,162,1,1,0.918,0.735,0.644,293
shoreline,2.67,16,20,1,1,0.677,0.296,0.529,36
impenetrable,2.668,20,25,1,1,0.531,0.577,0.839,45
terrain,2.664,32,40,1,1,0.54,0.3,0.472,72
fruitful,2.663,77,96,1,1,0.73,0.618,0.637,173
expanse,2.663,40,50,1,1,0.594,0.529,0.689,90
calmness,2.663,126,157,1,1,0.934,0.105,0.394,283
transcendent,2.658,15,19,1,1,0.667,0.6,0.824,34
blackbird,2.658,11,14,1,1,0.52,0.34,0.405,25
soak,2.656,177,222,1,1,0.48,0.37,0.24,399
untamed,2.645,14,18,1,1,0.429,0.778,0.709,32
involuntary,2.643,51,65,1,1,0.354,0.49,0.231,116
rye,2.637,46,59,1,1,0.49,0.298,0.411,105
multitude,2.637,140,179,1,1,0.562,0.765,0.847,319
seagull,2.636,17,22,1,1,0.635,0.245,0.314,39
toil,2.634,24,31,1,1,0.558,0.51,0.583,55
fertile,2.633,31,40,1,1,0.888,0.408,0.704,71
clandestine,2.63,13,17,1,1,0.425,0.677,0.469,30
delight,2.629,191,246,1,1,0.949,0.666,0.647,437
literary,2.629,93,120,1,1,0.719,0.324,0.667,213
celibacy,2.617,75,98,1,1,0.302,0.276,0.509,173
inaudible,2.613,12,16,1,1,0.28,0.398,0.358,28
nourishment,2.611,28,37,1,1,0.786,0.29,0.631,65
prelude,2.609,15,20,1,1,0.544,0.392,0.556,35
cacophony,2.609,15,20,1,1,0.408,0.562,0.44,35
communion,2.609,95,125,1,1,0.765,0.357,0.607,220
exquisite,2.607,53,70,1,1,0.892,0.644,0.604,123
campsite,2.607,18,24,1,1,0.68,0.49,0.547,42
radiant,2.602,58,77,1,1,0.888,0.717,0.791,135
forlorn,2.599,42,56,1,1,0.316,0.571,0.217,98
sabbatical,2.594,17,23,1,1,0.771,0.24,0.427,40
equilibrium,2.594,20,27,1,1,0.676,0.235,0.62,47
acquire,2.586,95,128,1,1,0.833,0.468,0.7,223
effectiveness,2.583,22,30,1,1,0.64,0.654,0.812,52
citadel,2.576,13,18,1,1,0.585,0.464,0.602,31
conduit,2.576,13,18,1,1,0.47,0.302,0.413,31
canoe,2.574,24,33,1,1,0.542,0.3,0.418,57
poet,2.572,214,292,1,1,0.827,0.35,0.556,506
diversion,2.571,32,44,1,1,0.74,0.821,0.714,76
addictive,2.569,450,615,1,1,0.302,0.683,0.472,1065
bard,2.568,37,51,1,1,0.47,0.41,0.439,88
illumination,2.563,15,21,1,1,0.76,0.588,0.537,36
relish,2.562,100,138,1,1,0.854,0.61,0.632,238
inwards,2.558,20,28,1,1,0.49,0.385,0.438,48
renounce,2.556,12,17,1,1,0.156,0.49,0.552,29
gleam,2.556,12,17,1,1,0.781,0.52,0.741,29
sacred,2.554,402,558,1,1,0.833,0.375,0.862,960
sanctuary,2.546,318,445,1,1,0.863,0.226,0.575,763
backdrop,2.545,19,27,1,1,0.32,0.309,0.444,46
spirituality,2.543,101,142,1,1,0.865,0.281,0.667,243
leisure,2.535,98,139,1,1,0.631,0.429,0.421,237
throng,2.533,11,16,1,1,0.48,0.81,0.706,27
luxurious,2.529,63,90,1,1,0.947,0.644,0.754,153
splendor,2.525,20,29,1,1,0.927,0.612,0.85,49
acres,2.525,55,79,1,1,0.51,0.363,0.5,134
karmic,2.525,20,29,1,1,0.357,0.459,0.464,49
untitled,2.52,22,32,1,1,0.213,0.24,0.24,54
wildlife,2.515,112,162,1,1,0.656,0.53,0.561,274
fisherman,2.513,17,25,1,1,0.656,0.461,0.546,42
catcher,2.511,37,54,1,1,0.653,0.413,0.54,91
abstinence,2.509,30,44,1,1,0.26,0.392,0.429,74
momentary,2.506,54,79,1,1,0.562,0.271,0.33,133
apostle,2.505,45,66,1,1,0.646,0.347,0.732,111
cocoon,2.503,49,72,1,1,0.47,0.28,0.29,121
unexplored,2.502,12,18,1,1,0.401,0.64,0.388,30
buddhism,2.493,18,27,1,1,0.51,0.115,0.673,45
sanctity,2.489,24,36,1,1,0.771,0.33,0.628,60
immerse,2.488,53,79,1,1,0.51,0.577,0.509,132
enlightenment,2.484,83,124,1,1,0.837,0.549,0.619,207
commune,2.476,55,83,1,1,0.5,0.488,0.655,138
fortify,2.476,11,17,1,1,0.745,0.824,0.911,28
adventurer,2.476,13,20,1,1,0.781,0.839,0.868,33
hammering,2.476,23,35,1,1,0.347,0.779,0.557,58
drunkenness,2.476,11,17,1,1,0.214,0.774,0.336,28
refine,2.476,15,23,1,1,0.653,0.46,0.64,38
prose,2.467,38,58,1,1,0.542,0.274,0.436,96
mountains,2.467,712,1078,1,1,0.766,0.433,0.569,1790
kryptonite,2.466,34,52,1,1,0.306,0.69,0.588,86
hermit,2.465,451,684,1,1,0.271,0.337,0.351,1135
yearning,2.464,262,398,1,1,0.709,0.51,0.537,660
respite,2.462,74,113,1,1,0.6,0.373,0.42,187
indivisible,2.458,18,28,1,1,0.646,0.398,0.58,46
sands,2.458,37,57,1,1,0.646,0.304,0.377,94
reservoir,2.456,16,25,1,1,0.531,0.276,0.462,41
doomsday,2.456,16,25,1,1,0.125,0.861,0.67,41
abode,2.454,29,45,1,1,0.62,0.302,0.5,74
hibernation,2.454,29,45,1,1,0.469,0.245,0.384,74
vitality,2.45,12,19,1,1,0.923,0.565,0.869,31
margarita,2.45,38,59,1,1,0.75,0.438,0.42,97
beaches,2.45,88,136,1,1,0.865,0.5,0.538,224
tonic,2.448,34,53,1,1,0.541,0.36,0.5,87
elevation,2.447,45,70,1,1,0.76,0.759,0.711,115
nourish,2.447,56,87,1,1,0.878,0.46,0.639,143
rustle,2.446,10,16,1,1,0.333,0.538,0.394,26
invisibility,2.446,21,33,1,1,0.438,0.461,0.382,54
perennial,2.446,10,16,1,1,0.527,0.358,0.5,26
literature,2.434,196,307,1,1,0.708,0.25,0.598,503
favorable,2.433,22,35,1,1,0.952,0.38,0.788,57
intrude,2.431,57,90,1,1,0.058,0.735,0.48,147
dune,2.429,27,43,1,1,0.459,0.173,0.414,70
recesses,2.429,13,21,1,1,0.367,0.47,0.379,34
trespass,2.429,13,21,1,1,0.229,0.67,0.613,34
contentment,2.428,149,235,1,1,0.875,0.61,0.782,384
scenery,2.423,166,263,1,1,0.745,0.253,0.592,429
mutation,2.422,11,18,1,1,0.365,0.625,0.611,29
languish,2.422,11,18,1,1,0.235,0.408,0.382,29
restlessness,2.42,28,45,1,1,0.083,0.794,0.397,73
indulgence,2.417,21,34,1,1,0.479,0.49,0.517,55
amuse,2.414,41,66,1,1,0.812,0.684,0.664,107
heroism,2.404,17,28,1,1,0.844,0.802,0.898,45
lighthouse,2.403,79,128,1,1,0.622,0.24,0.51,207
originality,2.403,30,49,1,1,0.898,0.5,0.824,79
recreation,2.402,25,41,1,1,0.909,0.632,0.66,66
furnace,2.402,38,62,1,1,0.429,0.529,0.5,100
romanticism,2.389,10,17,1,1,0.854,0.521,0.593,27
imaginative,2.389,21,35,1,1,0.78,0.541,0.593,56
amid,2.387,60,99,1,1,0.51,0.34,0.256,159
amidst,2.385,164,270,1,1,0.48,0.33,0.316,434
faculties,2.385,13,22,1,1,0.643,0.431,0.76,35
hillside,2.385,13,22,1,1,0.625,0.292,0.458,35
ecstasy,2.384,44,73,1,1,0.796,0.922,0.655,117
mastery,2.381,36,60,1,1,0.755,0.648,0.873,96
sublime,2.381,56,93,1,1,0.784,0.333,0.585,149
solemn,2.381,56,93,1,1,0.708,0.37,0.709,149
sea,2.38,1833,3025,1,1,0.833,0.353,0.589,4858
lodge,2.38,39,65,1,1,0.656,0.356,0.474,104
motionless,2.377,28,47,1,1,0.323,0.21,0.246,75
solace,2.374,873,1451,1,1,0.776,0.294,0.453,2324
inactivity,2.37,14,24,1,1,0.135,0.143,0.227,38
reflection,2.37,825,1376,1,1,0.71,0.5,0.528,2201
innermost,2.366,42,71,1,1,0.583,0.5,0.51,113
awaken,2.365,107,180,1,1,0.729,0.412,0.611,287
measured,2.363,83,140,1,1,0.542,0.265,0.578,223
penetrate,2.363,27,46,1,1,0.287,0.877,0.732,73
dormant,2.362,24,41,1,1,0.385,0.245,0.245,65
aimless,2.361,21,36,1,1,0.15,0.267,0.183,57
hideaway,2.36,18,31,1,1,0.448,0.481,0.36,49
elixir,2.351,9,16,1,1,0.708,0.587,0.604,25
indispensable,2.351,19,33,1,1,0.71,0.449,0.802,52
elegance,2.351,19,33,1,1,0.918,0.396,0.824,52
opium,2.351,9,16,1,1,0.276,0.49,0.333,25
hike,2.347,207,354,1,1,0.615,0.442,0.538,561
lush,2.346,47,81,1,1,0.74,0.783,0.833,128
prolonged,2.345,68,117,1,1,0.406,0.453,0.56,185
fasting,2.341,133,229,1,1,0.388,0.37,0.394,362
marvellous,2.336,28,49,1,1,0.878,0.809,0.849,77
restful,2.336,39,68,1,1,0.781,0.116,0.413,107
submerged,2.335,21,37,1,1,0.337,0.528,0.357,58
alluring,2.335,21,37,1,1,0.837,0.745,0.843,58
oneself,2.334,374,647,1,1,0.66,0.337,0.483,1021
overcast,2.331,14,25,1,1,0.417,0.25,0.475,39
azure,2.331,14,25,1,1,0.62,0.256,0.339,39
trout,2.328,22,39,1,1,0.516,0.387,0.298,61
indulge,2.328,141,246,1,1,0.833,0.716,0.669,387
brood,2.327,26,46,1,1,0.633,0.519,0.434,72
withered,2.322,23,41,1,1,0.188,0.292,0.16,64
outdoors,2.322,131,230,1,1,0.781,0.444,0.453,361
rugged,2.322,23,41,1,1,0.561,0.569,0.793,64
perverse,2.322,35,62,1,1,0.146,0.808,0.464,97
reflective,2.314,79,140,1,1,0.656,0.292,0.735,219
canvas,2.312,72,128,1,1,0.719,0.09,0.364,200
spiritual,2.312,936,1655,1,1,0.938,0.327,0.564,2591
soaking,2.311,68,121,1,1,0.438,0.324,0.375,189
initiation,2.311,12,22,1,1,0.698,0.529,0.527,34
strenuous,2.311,12,22,1,1,0.104,0.66,0.481,34
sensibility,2.311,12,22,1,1,0.583,0.423,0.448,34
seduction,2.311,12,22,1,1,0.51,0.891,0.618,34
banished,2.309,34,61,1,1,0.052,0.713,0.37,95
benign,2.309,34,61,1,1,0.694,0.44,0.509,95
fragility,2.309,21,38,1,1,0.316,0.306,0.2,59
vie,2.307,57,102,1,1,0.484,0.491,0.5,159
aluminum,2.306,17,31,1,1,0.449,0.28,0.434,48
obedience,2.306,35,63,1,1,0.765,0.287,0.536,98
breathtaking,2.304,72,129,1,1,0.936,0.792,0.921,201
withdraw,2.303,155,277,1,1,0.26,0.425,0.336,432
refined,2.303,22,40,1,1,0.85,0.43,0.653,62
duration,2.302,50,90,1,1,0.656,0.37,0.536,140
gleaming,2.301,13,24,1,1,0.827,0.635,0.627,37
sufficiency,2.301,13,24,1,1,0.594,0.438,0.576,37
regenerate,2.299,18,33,1,1,0.782,0.607,0.767,51
isolation,2.298,2019,3618,1,1,0.198,0.338,0.339,5637
perpetual,2.297,96,173,1,1,0.625,0.438,0.741,269
delicacy,2.293,9,17,1,1,0.812,0.279,0.336,26
pastime,2.293,29,53,1,1,0.677,0.353,0.443,82
rendezvous,2.293,9,17,1,1,0.75,0.49,0.658,26
observatory,2.293,9,17,1,1,0.643,0.324,0.731,26
subdued,2.293,14,26,1,1,0.236,0.463,0.223,40
discipline,2.292,201,363,1,1,0.615,0.471,0.806,564
wilderness,2.285,387,703,1,1,0.281,0.333,0.29,1090
oneness,2.285,53,97,1,1,0.745,0.272,0.72,150
cathedral,2.284,48,88,1,1,0.598,0.33,0.643,136
twelfth,2.283,10,19,1,1,0.521,0.292,0.527,29
ascendant,2.283,10,19,1,1,0.656,0.673,0.821,29
convent,2.283,10,19,1,1,0.48,0.217,0.594,29
hammock,2.283,32,59,1,1,0.673,0.255,0.287,91
compose,2.283,60,110,1,1,0.639,0.432,0.694,170
yearn,2.282,122,223,1,1,0.592,0.491,0.491,345
unbroken,2.28,16,30,1,1,0.55,0.224,0.602,46
insurmountable,2.279,45,83,1,1,0.62,0.627,0.737,128
maturity,2.278,190,348,1,1,0.827,0.4,0.806,538
lair,2.278,28,52,1,1,0.469,0.438,0.392,80
brisk,2.275,11,21,1,1,0.719,0.745,0.742,32
decadent,2.275,11,21,1,1,0.29,0.559,0.324,32
heresy,2.275,11,21,1,1,0.265,0.765,0.443,32
poverty,2.27,414,764,1,1,0.071,0.519,0.183,1178
advisable,2.268,12,23,1,1,0.867,0.48,0.51,35
confine,2.268,25,47,1,1,0.327,0.551,0.538,72
withstand,2.268,71,132,1,1,0.37,0.548,0.571,203
silence,2.264,5972,11069,1,1,0.438,0.2,0.223,17041
circular,2.262,27,51,1,1,0.562,0.342,0.417,78
soil,2.262,111,207,1,1,0.35,0.18,0.356,318
perch,2.262,13,25,1,1,0.531,0.3,0.314,38
lilac,2.262,13,25,1,1,0.688,0.18,0.357,38
mystic,2.259,50,94,1,1,0.643,0.52,0.535,144
midst,2.257,612,1143,1,1,0.324,0.275,0.296,1755
coolness,2.253,15,29,1,1,0.49,0.307,0.548,44
captivating,2.253,23,44,1,1,0.895,0.594,0.816,67
interior,2.247,86,163,1,1,0.618,0.157,0.462,249
abbey,2.244,36,69,1,1,0.58,0.367,0.444,105
reverence,2.242,18,35,1,1,0.643,0.347,0.516,53
evanescence,2.242,18,35,1,1,0.527,0.519,0.458,53
astral,2.241,28,54,1,1,0.604,0.417,0.567,82
weakened,2.241,28,54,1,1,0.373,0.304,0.092,82
wondrous,2.241,28,54,1,1,0.854,0.679,0.818,82
psychedelic,2.239,9,18,1,1,0.45,0.63,0.482,27
elk,2.239,9,18,1,1,0.439,0.337,0.34,27
mosaic,2.235,10,20,1,1,0.635,0.25,0.302,30
quivering,2.235,10,20,1,1,0.407,0.776,0.342,30
disappoint,2.231,392,752,1,1,0.15,0.633,0.288,1144
ruckus,2.231,11,22,1,1,0.271,0.706,0.411,33
novel,2.229,371,713,1,1,0.702,0.352,0.439,1084
eloquence,2.227,12,24,1,1,0.729,0.49,0.804,36
prized,2.227,12,24,1,1,0.906,0.53,0.714,36
kinship,2.226,26,51,1,1,0.771,0.3,0.652,77
voluntary,2.223,58,113,1,1,0.771,0.46,0.643,171
imperial,2.222,44,86,1,1,0.669,0.646,0.922,130
oils,2.222,29,57,1,1,0.459,0.229,0.391,86
materialism,2.218,16,32,1,1,0.22,0.39,0.556,48
elusive,2.216,35,69,1,1,0.229,0.615,0.466,104
situated,2.216,17,34,1,1,0.542,0.231,0.543,51
stoic,2.216,35,69,1,1,0.427,0.473,0.602,104
exploration,2.216,72,141,1,1,0.594,0.65,0.773,213
individuality,2.214,78,153,1,1,0.612,0.469,0.527,231
hiking,2.213,181,354,1,1,0.82,0.843,0.67,535
somber,2.212,42,83,1,1,0.184,0.5,0.38,125
grandeur,2.209,23,46,1,1,0.885,0.796,0.839,69
amour,2.207,25,50,1,1,0.865,0.48,0.652,75
lake,2.205,392,772,1,1,0.694,0.196,0.425,1164
clarity,2.201,399,789,1,1,0.796,0.31,0.631,1188
delicious,2.192,281,561,1,1,0.927,0.65,0.589,842
ineffable,2.188,9,19,1,1,0.551,0.577,0.585,28
agreeable,2.188,13,27,1,1,0.906,0.5,0.696,40
sailboat,2.188,9,19,1,1,0.719,0.392,0.381,28
whirl,2.188,9,19,1,1,0.461,0.788,0.661,28
nightfall,2.188,14,29,1,1,0.49,0.436,0.426,43
seaside,2.188,16,33,1,1,0.887,0.52,0.508,49
populous,2.188,8,17,1,1,0.52,0.63,0.725,25
hiker,2.188,8,17,1,1,0.694,0.802,0.644,25
requiem,2.188,10,21,1,1,0.475,0.382,0.426,31
waterfront,2.188,9,19,1,1,0.716,0.274,0.556,28
murmur,2.188,12,25,1,1,0.458,0.52,0.2,37
woodlands,2.188,9,19,1,1,0.656,0.34,0.473,28
commandment,2.188,13,27,1,1,0.656,0.49,0.876,40
bebop,2.188,13,27,1,1,0.482,0.49,0.358,40
incessant,2.188,32,65,1,1,0.438,0.76,0.544,97
undisturbed,2.188,45,91,1,1,0.725,0.287,0.434,136
crimson,2.188,45,91,1,1,0.667,0.385,0.37,136
oasis,2.188,45,91,1,1,0.796,0.283,0.429,136
introspective,2.18,62,126,1,1,0.552,0.36,0.471,188
independence,2.177,705,1426,1,1,0.896,0.663,0.911,2131
philosophical,2.177,46,94,1,1,0.719,0.275,0.713,140
unravel,2.174,35,72,1,1,0.378,0.598,0.455,107
melancholy,2.174,179,364,1,1,0.188,0.26,0.237,543
buddhist,2.172,29,60,1,1,0.57,0.182,0.481,89
satin,2.17,27,56,1,1,0.519,0.396,0.481,83
enjoying,2.167,2769,5659,1,1,0.908,0.759,0.759,8428
interlude,2.165,20,42,1,1,0.47,0.417,0.377,62
innocently,2.165,20,42,1,1,0.776,0.25,0.302,62
incense,2.163,19,40,1,1,0.698,0.275,0.328,59
courtyard,2.163,19,40,1,1,0.503,0.365,0.355,59
nook,2.162,18,38,1,1,0.48,0.321,0.296,56
majestic,2.16,51,106,1,1,0.948,0.731,0.906,157
nectar,2.157,15,32,1,1,0.746,0.331,0.398,47
reminiscent,2.157,15,32,1,1,0.5,0.481,0.611,47
evoke,2.156,30,63,1,1,0.438,0.341,0.5,93
muddle,2.155,14,30,1,1,0.184,0.71,0.336,44
bestow,2.155,14,30,1,1,0.656,0.56,0.642,44
mystical,2.154,28,59,1,1,0.594,0.443,0.689,87
meditating,2.153,98,204,1,1,0.718,0.185,0.399,302
fragment,2.15,12,26,1,1,0.211,0.316,0.429,38
dwelling,2.149,86,180,1,1,0.765,0.33,0.481,266
secrecy,2.146,34,72,1,1,0.294,0.549,0.475,106
chasm,2.144,21,45,1,1,0.265,0.579,0.5,66
desiring,2.144,32,68,1,1,0.814,0.821,0.632,100
moderation,2.144,32,68,1,1,0.531,0.24,0.453,100
bonne,2.139,9,20,1,1,0.448,0.395,0.362,29
bastion,2.139,19,41,1,1,0.531,0.5,0.596,60
rapture,2.138,38,81,1,1,0.439,0.883,0.567,119
nature,2.135,2056,4335,1,1,0.857,0.184,0.643,6391
disengage,2.134,17,37,1,1,0.406,0.529,0.304,54
nightlife,2.134,8,18,1,1,0.542,0.783,0.51,26
archery,2.134,8,18,1,1,0.594,0.604,0.589,26
intuitively,2.134,8,18,1,1,0.67,0.561,0.648,26
stormy,2.134,134,284,1,1,0.146,0.87,0.562,418
naught,2.134,17,37,1,1,0.344,0.176,0.161,54
botanical,2.134,8,18,1,1,0.66,0.259,0.491,26
veiled,2.131,16,35,1,1,0.37,0.317,0.324,51
absence,2.129,522,1109,1,1,0.153,0.235,0.266,1631
abyss,2.128,227,483,1,1,0.353,0.725,0.296,710
ingredient,2.127,23,50,1,1,0.792,0.373,0.451,73
immersion,2.125,22,48,1,1,0.51,0.556,0.564,70
beast,2.124,400,854,1,1,0.214,0.78,0.732,1254
emblem,2.124,29,63,1,1,0.64,0.33,0.754,92
trail,2.123,200,428,1,1,0.6,0.322,0.455,628
endurance,2.117,40,87,1,1,0.592,0.745,0.76,127
cultivate,2.117,107,231,1,1,0.708,0.41,0.598,338
ambient,2.115,32,70,1,1,0.625,0.36,0.582,102
nude,2.115,157,339,1,1,0.49,0.915,0.2,496
focal,2.114,12,27,1,1,0.367,0.365,0.482,39
brittle,2.114,12,27,1,1,0.276,0.49,0.272,39
embers,2.114,12,27,1,1,0.49,0.481,0.508,39
preserved,2.114,12,27,1,1,0.677,0.337,0.667,39
renewal,2.114,38,83,1,1,0.77,0.71,0.672,121
penchant,2.114,12,27,1,1,0.688,0.48,0.609,39
ox,2.114,12,27,1,1,0.417,0.396,0.412,39
brooding,2.113,31,68,1,1,0.327,0.367,0.333,99
mountaintop,2.112,18,40,1,1,0.653,0.541,0.713,58
treasures,2.11,42,92,1,1,0.867,0.771,0.842,134
preserving,2.108,17,38,1,1,0.765,0.462,0.63,55
manor,2.108,53,116,1,1,0.646,0.358,0.738,169
contemporary,2.108,59,129,1,1,0.72,0.365,0.569,188
brewery,2.103,16,36,1,1,0.71,0.622,0.51,52
bosom,2.101,10,23,1,1,0.612,0.588,0.404,33
nomadic,2.101,10,23,1,1,0.427,0.519,0.422,33
quench,2.101,10,23,1,1,0.385,0.344,0.333,33
wistful,2.101,10,23,1,1,0.323,0.451,0.312,33
transcend,2.101,21,47,1,1,0.604,0.771,0.726,68
purify,2.097,20,45,1,1,0.823,0.304,0.746,65
maiden,2.096,25,56,1,1,0.755,0.396,0.461,81
nest,2.095,133,293,1,1,0.687,0.221,0.333,426
allure,2.093,14,32,1,1,0.804,0.585,0.686,46
listless,2.093,9,21,1,1,0.219,0.35,0.231,30
trappings,2.093,9,21,1,1,0.458,0.462,0.37,30
disconnection,2.089,23,52,1,1,0.167,0.283,0.277,75
stimulation,2.086,69,154,1,1,0.708,0.821,0.702,223
cadence,2.086,13,30,1,1,0.427,0.473,0.355,43
flee,2.086,92,205,1,1,0.292,0.796,0.232,297
replenish,2.085,22,50,1,1,0.615,0.336,0.689,72
underworld,2.085,22,50,1,1,0.177,0.676,0.613,72
atmospheric,2.085,22,50,1,1,0.531,0.42,0.594,72
crypt,2.083,8,19,1,1,0.156,0.431,0.386,27
glory,2.081,536,1194,1,1,0.948,0.735,0.817,1730
metaphysical,2.079,12,28,1,1,0.63,0.573,0.686,40
waterfall,2.078,29,66,1,1,0.652,0.46,0.528,95
gravel,2.077,16,37,1,1,0.39,0.37,0.332,53
alignment,2.077,33,75,1,1,0.643,0.412,0.683,108
fishing,2.075,145,326,1,1,0.677,0.283,0.405,471
spinach,2.07,23,53,1,1,0.583,0.2,0.368,76
ethereal,2.07,27,62,1,1,0.52,0.419,0.518,89
hologram,2.07,11,26,1,1,0.615,0.461,0.575,37
vocation,2.07,19,44,1,1,0.833,0.426,0.686,63
creative,2.068,848,1914,1,1,0.917,0.518,0.788,2762
buddha,2.066,53,121,1,1,0.69,0.198,0.604,174
gardens,2.065,64,146,1,1,0.775,0.202,0.296,210
recreational,2.064,18,42,1,1,0.896,0.686,0.479,60
considerable,2.064,33,76,1,1,0.653,0.314,0.683,109
vineyard,2.063,14,33,1,1,0.806,0.382,0.595,47
nakedness,2.06,10,24,1,1,0.48,0.76,0.35,34
scarcely,2.06,10,24,1,1,0.082,0.412,0.16,34
eternal,2.06,439,999,1,1,0.854,0.409,0.843,1438
tempest,2.06,10,24,1,1,0.245,0.843,0.653,34
cave,2.06,481,1095,1,1,0.459,0.333,0.38,1576
plunge,2.059,28,65,1,1,0.307,0.69,0.55,93
sapiens,2.058,17,40,1,1,0.48,0.453,0.584,57
banish,2.055,27,63,1,1,0.163,0.677,0.543,90
prologue,2.055,13,31,1,1,0.571,0.392,0.546,44
cello,2.055,13,31,1,1,0.635,0.324,0.528,44
productivity,2.055,97,223,1,1,0.958,0.691,0.857,320
zen,2.051,81,187,1,1,0.492,0.21,0.432,268
autumn,2.051,135,311,1,1,0.765,0.204,0.45,446
rebirth,2.049,36,84,1,1,0.781,0.712,0.78,120
unadulterated,2.048,9,22,1,1,0.57,0.42,0.528,31
commence,2.048,19,45,1,1,0.76,0.585,0.741,64
nobility,2.048,9,22,1,1,0.844,0.347,0.736,31
palace,2.048,112,259,1,1,0.878,0.51,0.804,371
grove,2.046,22,52,1,1,0.604,0.245,0.417,74
deprivation,2.046,58,135,1,1,0.194,0.61,0.413,193
noun,2.045,38,89,1,1,0.531,0.23,0.477,127
bloom,2.045,171,396,1,1,0.816,0.453,0.587,567
moss,2.044,28,66,1,1,0.235,0.27,0.245,94
indigo,2.041,18,43,1,1,0.514,0.365,0.473,61
taunt,2.041,18,43,1,1,0.083,0.696,0.355,61
rejuvenated,2.034,11,27,1,1,0.809,0.673,0.7,38
accompaniment,2.034,11,27,1,1,0.74,0.479,0.695,38
freshness,2.034,8,20,1,1,0.917,0.333,0.585,28
permanence,2.034,8,20,1,1,0.771,0.37,0.708,28
temple,2.034,134,314,1,1,0.612,0.269,0.66,448
pine,2.029,60,142,1,1,0.583,0.225,0.312,202
crisp,2.028,45,107,1,1,0.776,0.692,0.508,152
conducive,2.027,19,46,1,1,0.775,0.479,0.679,65
nothingness,2.027,96,227,1,1,0.204,0.08,0.161,323
firing,2.026,87,206,1,1,0.188,0.931,0.803,293
chirping,2.025,30,72,1,1,0.5,0.463,0.36,102
fullness,2.024,44,105,1,1,0.868,0.402,0.811,149
wrinkled,2.024,13,32,1,1,0.271,0.402,0.2,45
oblivion,2.024,83,197,1,1,0.153,0.33,0.282,280
practiced,2.024,55,131,1,1,0.612,0.605,0.58,186
celestial,2.023,24,58,1,1,0.817,0.36,0.731,82
torment,2.022,96,228,1,1,0.057,0.75,0.387,324
photography,2.021,123,292,1,1,0.63,0.431,0.36,415
stagnation,2.021,10,25,1,1,0.276,0.324,0.396,35
typewriter,2.021,10,25,1,1,0.542,0.373,0.418,35
composition,2.021,21,51,1,1,0.765,0.408,0.652,72
igloo,2.021,10,25,1,1,0.569,0.302,0.345,35
exhibition,2.019,48,115,1,1,0.698,0.59,0.531,163
beauty,2.017,1412,3352,1,1,0.842,0.6,0.644,4764
revels,2.016,7,18,1,1,0.827,0.683,0.647,25
dojo,2.016,7,18,1,1,0.5,0.435,0.455,25
feigned,2.016,7,18,1,1,0.173,0.602,0.333,25
wreath,2.016,7,18,1,1,0.745,0.44,0.66,25
condensed,2.016,7,18,1,1,0.598,0.415,0.623,25
refuge,2.016,193,460,1,1,0.64,0.238,0.481,653
trees,2.015,466,1109,1,1,0.653,0.137,0.537,1575
mortal,2.015,102,244,1,1,0.196,0.786,0.51,346
recharge,2.014,888,2114,1,1,0.584,0.702,0.664,3002
reside,2.014,41,99,1,1,0.451,0.44,0.455,140
captivity,2.014,20,49,1,1,0.225,0.493,0.387,69
antithesis,2.012,12,30,1,1,0.396,0.412,0.536,42
towering,2.012,12,30,1,1,0.5,0.69,0.806,42
dissolve,2.011,30,73,1,1,0.271,0.49,0.41,103
crave,2.011,846,2021,1,1,0.625,0.51,0.731,2867
cleansing,2.011,48,116,1,1,0.729,0.298,0.472,164
graffiti,2.01,17,42,1,1,0.582,0.633,0.353,59
require,2.01,405,969,1,1,0.398,0.439,0.56,1374
recluse,2.009,68,164,1,1,0.24,0.49,0.446,232
surrendering,2.009,22,54,1,1,0.198,0.411,0.245,76
humility,2.009,73,176,1,1,0.74,0.118,0.444,249
quiet,2.008,4360,10441,1,1,0.792,0.105,0.431,14801
urban,2.006,127,306,1,1,0.561,0.528,0.644,433
boundless,2.006,19,47,1,1,0.684,0.642,0.652,66
anonymity,2.006,39,95,1,1,0.469,0.255,0.43,134
mirage,2.003,31,76,1,1,0.546,0.487,0.562,107
pretense,2.001,16,40,1,1,0.323,0.6,0.54,56
elegant,2.001,33,81,1,1,0.865,0.5,0.685,114
embrace,1.996,1360,3296,1,1,0.949,0.49,0.452,4656
poetry,1.996,383,930,1,1,0.697,0.235,0.629,1313
arctic,1.994,69,169,1,1,0.615,0.352,0.546,238
nonfiction,1.994,13,33,1,1,0.426,0.315,0.431,46
cultivated,1.994,20,50,1,1,0.837,0.343,0.564,70
melancholic,1.993,50,123,1,1,0.181,0.306,0.277,173
engrossed,1.99,15,38,1,1,0.541,0.471,0.304,53
quiver,1.989,24,60,1,1,0.32,0.452,0.335,84
abbot,1.987,8,21,1,1,0.427,0.321,0.483,29
mindfulness,1.987,71,175,1,1,0.729,0.635,0.745,246
hedonism,1.987,8,21,1,1,0.51,0.5,0.608,29
alight,1.987,8,21,1,1,0.667,0.657,0.605,29
clutter,1.986,37,92,1,1,0.135,0.598,0.4,129
interrupted,1.986,113,278,1,1,0.281,0.559,0.333,391
kite,1.984,30,75,1,1,0.643,0.5,0.573,105
preserve,1.984,83,205,1,1,0.837,0.431,0.755,288
gorge,1.983,10,26,1,1,0.365,0.644,0.42,36
fortunes,1.983,10,26,1,1,0.824,0.706,0.789,36
archaic,1.983,21,53,1,1,0.271,0.327,0.332,74
outdoor,1.981,62,154,1,1,0.814,0.256,0.447,216
tenacious,1.98,12,31,1,1,0.724,0.658,0.692,43
glittering,1.98,12,31,1,1,0.86,0.588,0.818,43
intuition,1.98,81,201,1,1,0.857,0.508,0.602,282
philosopher,1.978,46,115,1,1,0.684,0.316,0.72,161
prerequisite,1.977,16,41,1,1,0.448,0.424,0.482,57
getaway,1.974,64,160,1,1,0.5,0.76,0.368,224
necessity,1.973,172,428,1,1,0.567,0.471,0.588,600
antidote,1.971,32,81,1,1,0.541,0.49,0.629,113
oak,1.971,32,81,1,1,0.583,0.245,0.536,113
conditional,1.965,21,54,1,1,0.521,0.343,0.556,75
sparse,1.965,9,24,1,1,0.24,0.367,0.209,33
parable,1.965,7,19,1,1,0.479,0.357,0.525,26
unbridled,1.965,11,29,1,1,0.396,0.759,0.448,40
esoteric,1.965,11,29,1,1,0.5,0.676,0.545,40
malt,1.965,9,24,1,1,0.75,0.373,0.324,33
indefinite,1.965,15,39,1,1,0.448,0.292,0.296,54
soulful,1.965,25,64,1,1,0.755,0.331,0.5,89
essential,1.965,327,819,1,1,0.812,0.405,0.759,1146
alimony,1.965,7,19,1,1,0.612,0.477,0.464,26
weep,1.96,161,406,1,1,0.053,0.621,0.164,567
desolate,1.959,71,180,1,1,0.104,0.32,0.228,251
inner,1.957,1140,2873,1,1,0.551,0.216,0.443,4013
portrait,1.955,58,148,1,1,0.698,0.186,0.467,206
expansive,1.954,18,47,1,1,0.708,0.65,0.778,65
devotion,1.954,90,229,1,1,0.802,0.561,0.673,319
icy,1.954,52,133,1,1,0.684,0.375,0.345,185
grid,1.953,86,219,1,1,0.562,0.426,0.443,305
solitary,1.952,559,1417,1,1,0.224,0.202,0.268,1976
sanction,1.952,14,37,1,1,0.201,0.75,0.517,51
homestead,1.952,14,37,1,1,0.865,0.221,0.536,51
magnitude,1.95,51,131,1,1,0.608,0.613,0.774,182
displeased,1.947,10,27,1,1,0.135,0.69,0.4,37
scuba,1.947,10,27,1,1,0.542,0.494,0.456,37
dreary,1.947,32,83,1,1,0.26,0.49,0.324,115
atonement,1.947,10,27,1,1,0.55,0.602,0.683,37
aroma,1.947,21,55,1,1,0.823,0.235,0.442,76
ascend,1.945,19,50,1,1,0.83,0.62,0.812,69
civilization,1.945,128,328,1,1,0.823,0.452,0.839,456
seashore,1.943,8,22,1,1,0.796,0.31,0.375,30
archetype,1.943,8,22,1,1,0.448,0.52,0.569,30
creek,1.943,53,137,1,1,0.552,0.392,0.33,190
transcendental,1.943,8,22,1,1,0.635,0.652,0.842,30
sneer,1.943,8,22,1,1,0.133,0.755,0.345,30
remembrance,1.943,53,137,1,1,0.812,0.25,0.519,190
abundance,1.942,94,242,1,1,0.812,0.69,0.852,336
catalyst,1.941,40,104,1,1,0.604,0.509,0.585,144
chatter,1.94,63,163,1,1,0.56,0.45,0.347,226
avoidance,1.938,36,94,1,1,0.47,0.481,0.466,130
desert,1.937,503,1294,1,1,0.469,0.279,0.389,1797
boon,1.937,13,35,1,1,0.878,0.294,0.642,48
refreshed,1.936,53,138,1,1,0.91,0.377,0.48,191
haiku,1.935,25,66,1,1,0.583,0.356,0.392,91
meditate,1.934,284,734,1,1,0.812,0.146,0.564,1018
reprieve,1.934,18,48,1,1,0.531,0.471,0.574,66
pastel,1.934,18,48,1,1,0.719,0.357,0.367,66
intentional,1.933,99,257,1,1,0.65,0.615,0.75,356
relinquish,1.932,11,30,1,1,0.265,0.606,0.286,41
canto,1.932,11,30,1,1,0.776,0.461,0.554,41
finite,1.932,23,61,1,1,0.384,0.347,0.293,84
poetic,1.931,81,211,1,1,0.86,0.269,0.548,292
gratitude,1.931,286,741,1,1,0.885,0.441,0.61,1027
strife,1.93,38,100,1,1,0.344,0.898,0.63,138
insulated,1.926,9,25,1,1,0.208,0.265,0.304,34
confinement,1.926,174,454,1,1,0.333,0.656,0.52,628
ornament,1.926,9,25,1,1,0.561,0.373,0.441,34
coastal,1.926,19,51,1,1,0.604,0.37,0.51,70
bazaar,1.926,9,25,1,1,0.604,0.34,0.5,34
buff,1.923,32,85,1,1,0.561,0.425,0.361,117
devotional,1.921,17,46,1,1,0.74,0.394,0.655,63
charcoal,1.92,12,33,1,1,0.302,0.186,0.342,45
exterior,1.919,33,88,1,1,0.542,0.4,0.627,121
jest,1.916,23,62,1,1,0.52,0.736,0.222,85
acre,1.916,15,41,1,1,0.583,0.387,0.423,56
syllable,1.916,7,20,1,1,0.448,0.25,0.417,27
emergence,1.916,7,20,1,1,0.276,0.857,0.676,27
monte,1.916,15,41,1,1,0.589,0.33,0.391,56
firewood,1.912,10,28,1,1,0.52,0.348,0.263,38
symbolize,1.912,10,28,1,1,0.633,0.327,0.673,38
commotion,1.912,10,28,1,1,0.49,0.7,0.646,38
camouflage,1.912,10,28,1,1,0.438,0.585,0.45,38
chambers,1.911,46,123,1,1,0.542,0.442,0.388,169
dispel,1.909,13,36,1,1,0.388,0.402,0.411,49
intoxicating,1.908,30,81,1,1,0.224,0.76,0.464,111
disrupt,1.908,64,171,1,1,0.265,0.64,0.349,235
harmony,1.908,98,261,1,1,0.949,0.23,0.509,359
cove,1.908,16,44,1,1,0.5,0.304,0.37,60
coldness,1.904,37,100,1,1,0.093,0.47,0.427,137
fragrance,1.9,17,47,1,1,0.847,0.357,0.667,64
bronze,1.9,14,39,1,1,0.622,0.333,0.526,53
luminous,1.9,8,23,1,1,0.918,0.392,0.783,31
exalted,1.9,8,23,1,1,0.676,0.845,0.696,31
deprive,1.9,23,63,1,1,0.271,0.591,0.34,86
obscurity,1.9,26,71,1,1,0.208,0.392,0.38,97
undefined,1.9,8,23,1,1,0.26,0.418,0.35,31
ancestor,1.9,11,31,1,1,0.592,0.388,0.594,42
untouched,1.9,41,111,1,1,0.531,0.276,0.6,152
pleasurable,1.9,14,39,1,1,0.948,0.529,0.669,53
frost,1.897,42,114,1,1,0.449,0.455,0.385,156
imagery,1.896,30,82,1,1,0.653,0.327,0.39,112
conquest,1.894,18,50,1,1,0.71,0.702,0.833,68
glorious,1.893,184,496,1,1,0.959,0.673,0.827,680
muses,1.893,15,42,1,1,0.714,0.434,0.571,57
adventures,1.891,252,680,1,1,0.812,0.764,0.749,932
caress,1.89,35,96,1,1,0.833,0.418,0.509,131
interrupt,1.888,99,269,1,1,0.21,0.635,0.509,368
analytical,1.886,16,45,1,1,0.625,0.324,0.8,61
pier,1.885,23,64,1,1,0.583,0.279,0.445,87
precision,1.883,13,37,1,1,0.677,0.431,0.875,50
stimulus,1.883,13,37,1,1,0.771,0.779,0.75,50
laden,1.883,13,37,1,1,0.392,0.478,0.554,50
darkened,1.88,35,97,1,1,0.135,0.44,0.452,132
fireplace,1.879,39,108,1,1,0.667,0.38,0.417,147
forgetfulness,1.878,10,29,1,1,0.271,0.385,0.302,39
repel,1.878,10,29,1,1,0.224,0.62,0.441,39
confined,1.877,88,242,1,1,0.286,0.472,0.444,330
excerpt,1.875,33,92,1,1,0.437,0.367,0.543,125
evade,1.874,22,62,1,1,0.304,0.49,0.342,84
traces,1.874,22,62,1,1,0.482,0.448,0.389,84
cement,1.873,26,73,1,1,0.544,0.265,0.527,99
sundown,1.87,11,32,1,1,0.812,0.276,0.445,43
unwritten,1.87,11,32,1,1,0.367,0.384,0.272,43
unaffected,1.87,11,32,1,1,0.542,0.265,0.571,43
mist,1.87,67,186,1,1,0.375,0.194,0.221,253
complement,1.87,27,76,1,1,0.76,0.277,0.6,103
tending,1.87,27,76,1,1,0.622,0.556,0.594,103
mower,1.87,7,21,1,1,0.458,0.51,0.368,28
renowned,1.87,11,32,1,1,0.844,0.481,0.697,43
stroll,1.866,57,159,1,1,0.745,0.415,0.444,216
indoor,1.865,41,115,1,1,0.615,0.245,0.347,156
formed,1.864,173,480,1,1,0.656,0.272,0.696,653
tarot,1.864,50,140,1,1,0.479,0.422,0.43,190
peace,1.863,8908,24664,1,1,0.939,0.156,0.613,33572
softness,1.861,21,60,1,1,0.875,0.086,0.402,81
regroup,1.861,74,207,1,1,0.633,0.602,0.797,281
privacy,1.86,608,1690,1,1,0.52,0.42,0.598,2298
landmark,1.86,17,49,1,1,0.694,0.355,0.681,66
hilltop,1.86,8,24,1,1,0.688,0.643,0.787,32
masterful,1.86,8,24,1,1,0.854,0.51,0.96,32
haste,1.857,13,38,1,1,0.378,0.745,0.5,51
zeppelin,1.857,13,38,1,1,0.542,0.55,0.472,51
gothic,1.855,18,52,1,1,0.197,0.333,0.475,70
ponder,1.854,124,348,1,1,0.74,0.38,0.689,472
fruits,1.854,100,281,1,1,0.865,0.357,0.259,381
affinity,1.854,28,80,1,1,0.8,0.5,0.537,108
farmhouse,1.852,9,27,1,1,0.69,0.33,0.444,36
monarch,1.852,9,27,1,1,0.583,0.559,0.87,36
neighboring,1.852,9,27,1,1,0.656,0.306,0.481,36
tangle,1.852,9,27,1,1,0.354,0.545,0.254,36
rim,1.852,19,55,1,1,0.51,0.397,0.302,74
sorrowful,1.852,29,83,1,1,0.049,0.422,0.163,112
harmonious,1.852,14,41,1,1,0.938,0.391,0.719,55
ascending,1.852,9,27,1,1,0.826,0.644,0.777,36
slumber,1.85,45,128,1,1,0.592,0.191,0.426,173
magical,1.85,327,919,1,1,0.875,0.651,0.595,1246
ascension,1.847,15,44,1,1,0.765,0.72,0.714,59
laboratory,1.847,15,44,1,1,0.571,0.49,0.537,59
enigma,1.847,15,44,1,1,0.513,0.7,0.5,59
dominion,1.845,10,30,1,1,0.542,0.704,0.89,40
garment,1.845,10,30,1,1,0.531,0.333,0.38,40
interruption,1.844,38,109,1,1,0.184,0.632,0.425,147
craving,1.84,373,1058,1,1,0.51,0.755,0.636,1431
pilgrim,1.84,17,50,1,1,0.531,0.404,0.569,67
node,1.84,23,67,1,1,0.396,0.343,0.361,90
murky,1.84,11,33,1,1,0.143,0.618,0.37,44
appropriation,1.84,11,33,1,1,0.51,0.632,0.717,44
chapel,1.838,36,104,1,1,0.573,0.24,0.44,140
fondness,1.837,18,53,1,1,0.885,0.391,0.503,71
monument,1.837,18,53,1,1,0.833,0.404,0.811,71
contemplate,1.835,150,429,1,1,0.74,0.347,0.642,579
herb,1.834,19,56,1,1,0.643,0.418,0.353,75
snowy,1.833,46,133,1,1,0.656,0.304,0.357,179
chariot,1.831,6,19,1,1,0.684,0.55,0.491,25
deafness,1.831,6,19,1,1,0.125,0.413,0.219,25
surf,1.831,34,99,1,1,0.847,0.65,0.5,133
apparition,1.831,6,19,1,1,0.406,0.573,0.636,25
tapestry,1.831,6,19,1,1,0.52,0.176,0.362,25
swagger,1.831,6,19,1,1,0.333,0.731,0.538,25
elliptical,1.831,6,19,1,1,0.338,0.385,0.49,25
lament,1.831,27,79,1,1,0.198,0.398,0.352,106
teapot,1.831,6,19,1,1,0.479,0.11,0.309,25
penitent,1.831,6,19,1,1,0.542,0.53,0.508,25
transformation,1.829,72,208,1,1,0.796,0.618,0.77,280
countryside,1.829,80,231,1,1,0.732,0.288,0.327,311
loneliness,1.828,5820,16687,1,1,0.146,0.182,0.222,22507
magnificent,1.827,83,240,1,1,1,0.68,0.886,323
profound,1.827,152,438,1,1,0.755,0.546,0.736,590
bourgeois,1.827,22,65,1,1,0.439,0.593,0.682,87
painting,1.826,234,674,1,1,0.792,0.324,0.333,908
opt,1.826,62,180,1,1,0.51,0.471,0.345,242
incompleteness,1.825,7,22,1,1,0.271,0.451,0.234,29
trine,1.825,7,22,1,1,0.396,0.365,0.317,29
canopy,1.825,7,22,1,1,0.615,0.264,0.398,29
shimmering,1.825,7,22,1,1,0.844,0.648,0.904,29
suburbia,1.825,7,22,1,1,0.438,0.49,0.421,29
safari,1.825,15,45,1,1,0.663,0.673,0.64,60
mineral,1.825,7,22,1,1,0.519,0.287,0.605,29
undivided,1.825,15,45,1,1,0.51,0.38,0.49,60
recoil,1.825,7,22,1,1,0.089,0.429,0.259,29
balm,1.824,32,94,1,1,0.625,0.275,0.414,126
deliverance,1.823,24,71,1,1,0.75,0.52,0.658,95
cherishing,1.823,16,48,1,1,0.836,0.38,0.625,64
socialite,1.82,8,25,1,1,0.684,0.668,0.57,33
emerge,1.82,53,155,1,1,0.602,0.594,0.731,208
innovation,1.819,36,106,1,1,0.949,0.68,0.89,142
vintage,1.819,36,106,1,1,0.68,0.39,0.481,142
classics,1.819,46,135,1,1,0.75,0.333,0.51,181
yogi,1.818,18,54,1,1,0.653,0.347,0.349,72
closeness,1.818,47,138,1,1,0.796,0.237,0.45,185
ancient,1.817,146,425,1,1,0.42,0.217,0.439,571
cleanse,1.817,58,170,1,1,0.625,0.31,0.66,228
soaring,1.816,19,57,1,1,0.708,0.704,0.65,76
weariness,1.816,9,28,1,1,0.104,0.333,0.226,37
coil,1.816,9,28,1,1,0.448,0.343,0.298,37
menacing,1.816,9,28,1,1,0.042,0.88,0.643,37
shrine,1.816,29,86,1,1,0.802,0.255,0.574,115
refill,1.816,40,118,1,1,0.67,0.4,0.464,158
familiarity,1.816,40,118,1,1,0.854,0.346,0.616,158
intrigue,1.813,10,31,1,1,0.362,0.83,0.327,41
solidify,1.813,10,31,1,1,0.583,0.318,0.754,41
theological,1.813,10,31,1,1,0.48,0.363,0.683,41
commemorate,1.813,10,31,1,1,0.812,0.602,0.636,41
recollection,1.811,23,69,1,1,0.722,0.337,0.566,92
brimming,1.811,11,34,1,1,0.656,0.69,0.758,45
zeal,1.811,11,34,1,1,0.367,0.741,0.616,45
exude,1.811,11,34,1,1,0.375,0.519,0.411,45
feast,1.809,76,224,1,1,0.979,0.724,0.68,300
muse,1.809,76,224,1,1,0.76,0.36,0.509,300
crest,1.809,12,37,1,1,0.458,0.333,0.333,49
tumble,1.809,12,37,1,1,0.276,0.556,0.272,49
complete,1.807,1854,5428,1,1,0.75,0.414,0.809,7282
carve,1.806,43,128,1,1,0.469,0.443,0.598,171
reconnect,1.805,88,260,1,1,0.63,0.548,0.667,348
resonance,1.805,14,43,1,1,0.541,0.426,0.629,57
exclusion,1.805,29,87,1,1,0.24,0.53,0.389,116
monotonous,1.804,15,46,1,1,0.354,0.221,0.4,61
vanishing,1.802,16,49,1,1,0.292,0.55,0.322,65
stargazing,1.802,16,49,1,1,0.802,0.461,0.709,65
rendering,1.802,16,49,1,1,0.531,0.434,0.667,65
essence,1.802,122,361,1,1,0.663,0.369,0.575,483
unparalleled,1.8,18,55,1,1,0.708,0.306,0.538,73
anguish,1.8,117,347,1,1,0.153,0.792,0.265,464
stimulating,1.799,20,61,1,1,0.74,0.804,0.809,81
euphoric,1.797,22,67,1,1,0.745,0.904,0.588,89
lyrical,1.796,24,73,1,1,0.708,0.451,0.618,97
await,1.796,49,147,1,1,0.448,0.264,0.276,196
spectacle,1.796,24,73,1,1,0.812,0.745,0.762,97
forest,1.796,583,1728,1,1,0.729,0.27,0.435,2311
lunar,1.795,25,76,1,1,0.562,0.296,0.427,101
disposition,1.795,25,76,1,1,0.663,0.542,0.734,101
sunlight,1.795,107,319,1,1,0.906,0.407,0.639,426
turmoil,1.79,92,276,1,1,0.198,0.888,0.417,368
traveler,1.789,52,157,1,1,0.837,0.571,0.7,209
cabin,1.784,299,898,1,1,0.643,0.292,0.43,1197
dreamy,1.783,31,95,1,1,0.837,0.35,0.5,126
grail,1.783,14,44,1,1,0.573,0.384,0.566,58
brute,1.783,10,32,1,1,0.115,0.547,0.379,42
engulf,1.783,11,35,1,1,0.398,0.573,0.5,46
armored,1.783,7,23,1,1,0.469,0.509,0.861,30
attainable,1.783,10,32,1,1,0.76,0.5,0.759,42
slink,1.783,7,23,1,1,0.46,0.546,0.314,30
venomous,1.783,11,35,1,1,0.159,0.841,0.636,46
volcanic,1.783,6,20,1,1,0.344,0.91,0.781,26
paddle,1.783,16,50,1,1,0.561,0.375,0.393,66
chastity,1.783,16,50,1,1,0.469,0.392,0.509,66
paperback,1.783,10,32,1,1,0.633,0.269,0.314,42
vial,1.783,6,20,1,1,0.594,0.346,0.445,26
bounty,1.783,21,65,1,1,0.76,0.755,0.833,86
scarecrow,1.783,7,23,1,1,0.219,0.274,0.349,30
vault,1.783,27,83,1,1,0.49,0.378,0.644,110
symbolism,1.783,24,74,1,1,0.688,0.347,0.64,98
campfire,1.783,20,62,1,1,0.677,0.509,0.436,82
intangible,1.783,8,26,1,1,0.525,0.48,0.473,34
meadow,1.783,21,65,1,1,0.622,0.13,0.382,86
coveted,1.783,7,23,1,1,0.661,0.73,0.625,30
stony,1.783,7,23,1,1,0.356,0.494,0.525,30
trucker,1.783,6,20,1,1,0.494,0.609,0.5,26
temperament,1.783,20,62,1,1,0.42,0.625,0.703,82
pianist,1.783,6,20,1,1,0.806,0.491,0.573,26
perceptive,1.783,9,29,1,1,0.745,0.5,0.741,38
sectarian,1.783,8,26,1,1,0.26,0.606,0.517,34
relic,1.783,7,23,1,1,0.646,0.452,0.591,30
omission,1.783,7,23,1,1,0.367,0.333,0.275,30
wilt,1.783,11,35,1,1,0.226,0.354,0.312,46
groundwork,1.783,6,20,1,1,0.5,0.375,0.593,26
musing,1.783,11,35,1,1,0.74,0.151,0.465,46
crescent,1.783,13,41,1,1,0.698,0.382,0.407,54
regal,1.783,7,23,1,1,0.643,0.459,0.556,30
sunken,1.783,16,50,1,1,0.103,0.476,0.173,66
selflove,1.783,6,20,1,1,0.854,0.63,0.661,26
imprison,1.783,8,26,1,1,0.112,0.829,0.545,34
nominate,1.783,37,113,1,1,0.615,0.471,0.669,150
steward,1.783,6,20,1,1,0.633,0.238,0.55,26
fateful,1.783,9,29,1,1,0.29,0.583,0.402,38
outward,1.774,36,111,1,1,0.449,0.439,0.365,147
restraint,1.772,29,90,1,1,0.167,0.618,0.52,119
keeper,1.768,87,267,1,1,0.612,0.457,0.773,354
abstract,1.766,40,124,1,1,0.438,0.292,0.444,164
cloak,1.765,37,115,1,1,0.469,0.188,0.333,152
outer,1.765,93,286,1,1,0.552,0.471,0.456,379
immortality,1.764,34,106,1,1,0.688,0.635,0.861,140
imprisoned,1.764,51,158,1,1,0.032,0.717,0.302,209
oracle,1.763,16,51,1,1,0.552,0.531,0.67,67
overcrowded,1.763,16,51,1,1,0.292,0.52,0.491,67
rainy,1.761,241,741,1,1,0.61,0.451,0.433,982
sufficiently,1.761,14,45,1,1,0.776,0.367,0.714,59
withdrawn,1.76,42,131,1,1,0.182,0.368,0.221,173
waning,1.759,13,42,1,1,0.375,0.333,0.3,55
baptism,1.759,13,42,1,1,0.844,0.384,0.566,55
contrary,1.759,150,463,1,1,0.327,0.449,0.338,613
ugliness,1.758,53,165,1,1,0.094,0.407,0.267,218
roaring,1.758,26,82,1,1,0.449,0.817,0.634,108
imperative,1.758,39,122,1,1,0.625,0.647,0.708,161
horizon,1.757,129,399,1,1,0.729,0.284,0.59,528
bore,1.757,90,279,1,1,0.417,0.44,0.455,369
effortless,1.757,12,39,1,1,0.626,0.09,0.352,51
completeness,1.757,12,39,1,1,0.823,0.433,0.769,51
majesty,1.756,24,76,1,1,0.823,0.602,0.955,100
boredom,1.756,197,609,1,1,0.167,0.139,0.255,806
reclaim,1.756,36,113,1,1,0.469,0.724,0.648,149
beach,1.755,806,2487,1,1,0.885,0.529,0.455,3293
winged,1.755,11,36,1,1,0.646,0.469,0.519,47
mediate,1.755,11,36,1,1,0.635,0.308,0.654,47
fiction,1.753,176,546,1,1,0.438,0.657,0.441,722
amazement,1.753,10,33,1,1,0.75,0.8,0.639,43
vertical,1.753,10,33,1,1,0.52,0.387,0.492,43
tumultuous,1.753,10,33,1,1,0.208,0.622,0.59,43
prophetic,1.753,10,33,1,1,0.688,0.586,0.796,43
cowboy,1.753,65,203,1,1,0.594,0.625,0.695,268
guru,1.751,41,129,1,1,0.573,0.36,0.653,170
noisy,1.751,163,507,1,1,0.271,0.812,0.561,670
jagged,1.75,9,30,1,1,0.082,0.462,0.213,39
ritual,1.749,77,241,1,1,0.375,0.52,0.508,318
medicinal,1.746,8,27,1,1,0.667,0.417,0.614,35
incorporate,1.746,17,55,1,1,0.745,0.612,0.571,72
tinker,1.746,8,27,1,1,0.396,0.528,0.275,35
aerial,1.746,8,27,1,1,0.615,0.461,0.463,35
beckon,1.746,8,27,1,1,0.663,0.455,0.452,35
yoga,1.744,195,610,1,1,0.75,0.115,0.422,805
punishment,1.743,233,729,1,1,0.083,0.825,0.536,962
waterworks,1.742,7,24,1,1,0.51,0.49,0.561,31
outback,1.742,7,24,1,1,0.5,0.324,0.43,31
stitching,1.742,7,24,1,1,0.51,0.382,0.345,31
continental,1.742,7,24,1,1,0.486,0.35,0.755,31
fornication,1.742,7,24,1,1,0.365,0.951,0.457,31
mount,1.742,47,149,1,1,0.5,0.292,0.348,196
stairway,1.742,7,24,1,1,0.562,0.51,0.407,31
provincial,1.739,14,46,1,1,0.645,0.341,0.481,60
fellowship,1.739,119,375,1,1,0.9,0.429,0.778,494
evolution,1.739,96,303,1,1,0.781,0.657,0.854,399
intricate,1.736,13,43,1,1,0.559,0.704,0.5,56
beholden,1.736,6,21,1,1,0.296,0.555,0.212,27
prowess,1.736,6,21,1,1,0.792,0.657,0.833,27
hooded,1.736,6,21,1,1,0.306,0.745,0.439,27
fauna,1.736,6,21,1,1,0.646,0.346,0.404,27
promiscuity,1.736,6,21,1,1,0.219,0.96,0.396,27
squint,1.736,6,21,1,1,0.385,0.461,0.452,27
diligence,1.736,13,43,1,1,0.688,0.423,0.7,56
enlarge,1.736,6,21,1,1,0.735,0.606,0.688,27
inquisitive,1.736,6,21,1,1,0.301,0.637,0.615,27
needful,1.736,13,43,1,1,0.582,0.46,0.614,56
glaze,1.736,6,21,1,1,0.65,0.34,0.356,27
seals,1.736,13,43,1,1,0.412,0.241,0.402,56
gallery,1.736,69,219,1,1,0.659,0.433,0.569,288
interval,1.736,6,21,1,1,0.51,0.284,0.4,27
chaos,1.736,444,1398,1,1,0.016,0.923,0.373,1842
carving,1.734,19,62,1,1,0.541,0.444,0.368,81
monochrome,1.733,12,40,1,1,0.312,0.292,0.339,52
purity,1.733,51,163,1,1,0.823,0.205,0.712,214
traverse,1.729,11,37,1,1,0.571,0.59,0.629,48
balance,1.729,665,2108,1,1,0.684,0.265,0.735,2773
orchard,1.729,11,37,1,1,0.76,0.269,0.333,48
reread,1.728,52,167,1,1,0.448,0.377,0.492,219
intensity,1.726,45,145,1,1,0.622,0.93,0.952,190
runner,1.725,55,177,1,1,0.459,0.747,0.632,232
rebellion,1.724,32,104,1,1,0.245,0.843,0.746,136
granite,1.724,10,34,1,1,0.572,0.343,0.483,44
unreachable,1.723,26,85,1,1,0.208,0.679,0.557,111
innate,1.723,26,85,1,1,0.49,0.4,0.521,111
lavender,1.722,31,101,1,1,0.812,0.198,0.388,132
northwest,1.722,15,50,1,1,0.604,0.345,0.451,65
longing,1.722,254,812,1,1,0.604,0.434,0.56,1066
imprisonment,1.721,20,66,1,1,0.133,0.63,0.471,86
rebellious,1.721,20,66,1,1,0.344,0.88,0.663,86
deer,1.721,72,232,1,1,0.583,0.375,0.292,304
prize,1.72,97,312,1,1,0.885,0.763,0.67,409
external,1.719,110,354,1,1,0.479,0.341,0.509,464
trusty,1.718,14,47,1,1,0.863,0.398,0.696,61
merchant,1.718,9,31,1,1,0.675,0.5,0.62,40
glen,1.718,19,63,1,1,0.573,0.337,0.406,82
bacon,1.718,118,380,1,1,0.698,0.406,0.295,498
contrast,1.717,58,188,1,1,0.48,0.406,0.52,246
tourist,1.716,38,124,1,1,0.745,0.48,0.43,162
pleasure,1.715,539,1732,1,1,0.939,0.74,0.682,2271
complacency,1.715,18,60,1,1,0.604,0.503,0.519,78
deafening,1.714,79,256,1,1,0.281,0.835,0.482,335
frigid,1.714,13,44,1,1,0.219,0.481,0.395,57
inaccessible,1.714,13,44,1,1,0.083,0.585,0.446,57
scotch,1.714,27,89,1,1,0.578,0.52,0.615,116
brief,1.712,162,524,1,1,0.469,0.3,0.279,686
conundrum,1.711,26,86,1,1,0.354,0.524,0.408,112
circuit,1.711,17,57,1,1,0.586,0.461,0.707,74
lengthy,1.711,26,86,1,1,0.57,0.342,0.528,112
clubhouse,1.711,8,28,1,1,0.694,0.571,0.493,36
disarray,1.711,8,28,1,1,0.198,0.657,0.223,36
flash,1.709,201,651,1,1,0.571,0.59,0.657,852
culinary,1.708,12,41,1,1,0.654,0.443,0.519,53
togetherness,1.708,85,277,1,1,0.906,0.36,0.635,362
descending,1.707,16,54,1,1,0.219,0.493,0.25,70
hobbit,1.707,16,54,1,1,0.479,0.489,0.472,70
lounging,1.707,16,54,1,1,0.735,0.167,0.449,70
breathless,1.706,20,67,1,1,0.323,0.49,0.222,87
sunset,1.705,213,693,1,1,0.875,0.231,0.298,906
sacrament,1.703,7,25,1,1,0.69,0.316,0.7,32
guitarist,1.703,7,25,1,1,0.827,0.74,0.549,32
sustenance,1.703,11,38,1,1,0.82,0.519,0.679,49
compel,1.703,7,25,1,1,0.2,0.847,0.625,32
plateau,1.703,7,25,1,1,0.611,0.316,0.4,32
pleasant,1.703,163,532,1,1,0.939,0.31,0.673,695
reliance,1.703,23,77,1,1,0.844,0.431,0.853,100
seducing,1.703,7,25,1,1,0.569,0.794,0.708,32
likeness,1.703,15,51,1,1,0.688,0.41,0.561,66
repentance,1.703,19,64,1,1,0.417,0.604,0.324,83
divine,1.702,274,893,1,1,0.918,0.571,0.885,1167
wisdom,1.7,468,1527,1,1,0.93,0.302,0.871,1995
gown,1.7,26,87,1,1,0.625,0.283,0.421,113
occasional,1.698,132,433,1,1,0.49,0.298,0.387,565
thrive,1.698,337,1102,1,1,0.948,0.529,0.772,1439
copious,1.697,14,48,1,1,0.427,0.462,0.527,62
recoup,1.697,14,48,1,1,0.719,0.422,0.575,62
doom,1.697,107,352,1,1,0.073,0.75,0.442,459
erode,1.696,10,35,1,1,0.208,0.643,0.58,45
assorted,1.696,10,35,1,1,0.602,0.46,0.472,45
machinery,1.696,10,35,1,1,0.458,0.615,0.629,45
filmmaker,1.696,10,35,1,1,0.704,0.51,0.635,45
humidity,1.696,10,35,1,1,0.464,0.373,0.367,45
indifference,1.695,39,130,1,1,0.265,0.417,0.299,169
immaculate,1.692,13,45,1,1,0.698,0.33,0.688,58
comparatively,1.692,6,22,1,1,0.604,0.391,0.538,28
providence,1.692,13,45,1,1,0.603,0.337,0.755,58
delve,1.692,20,68,1,1,0.469,0.529,0.684,88
communicative,1.692,6,22,1,1,0.847,0.56,0.637,28
windmill,1.692,6,22,1,1,0.773,0.412,0.412,28
seared,1.692,6,22,1,1,0.229,0.41,0.398,28
croissant,1.692,6,22,1,1,0.745,0.33,0.43,28
arbor,1.692,6,22,1,1,0.583,0.49,0.591,28
sorrow,1.691,376,1239,1,1,0.052,0.235,0.164,1615
continual,1.689,16,55,1,1,0.5,0.423,0.685,71
mischief,1.688,26,88,1,1,0.385,0.834,0.292,114
gracious,1.687,39,131,1,1,0.918,0.634,0.637,170
starship,1.687,9,32,1,1,0.74,0.719,0.704,41
temporal,1.687,9,32,1,1,0.5,0.413,0.36,41
resourceful,1.687,9,32,1,1,0.906,0.704,0.886,41
ample,1.686,22,75,1,1,0.744,0.349,0.719,97
retire,1.685,113,376,1,1,0.398,0.392,0.186,489
harp,1.685,12,42,1,1,0.618,0.31,0.356,54
yield,1.685,25,85,1,1,0.719,0.578,0.618,110
companion,1.685,678,2245,1,1,0.77,0.377,0.618,2923
tenderness,1.684,28,95,1,1,0.949,0.276,0.367,123
passage,1.684,60,201,1,1,0.429,0.314,0.37,261
graceful,1.682,18,62,1,1,0.906,0.51,0.655,80
mage,1.682,21,72,1,1,0.622,0.373,0.453,93
recollect,1.681,24,82,1,1,0.688,0.491,0.602,106
concentration,1.681,77,258,1,1,0.735,0.5,0.722,335
presence,1.681,1809,6012,1,1,0.874,0.431,0.607,7821
gardening,1.68,33,112,1,1,0.854,0.333,0.361,145
nurture,1.679,57,192,1,1,0.745,0.378,0.657,249
author,1.678,225,752,1,1,0.775,0.343,0.749,977
wrought,1.677,8,29,1,1,0.322,0.559,0.681,37
infused,1.677,11,39,1,1,0.385,0.473,0.546,50
picnic,1.677,38,129,1,1,0.625,0.47,0.375,167
proficient,1.677,8,29,1,1,0.854,0.461,0.817,37
homage,1.677,17,59,1,1,0.833,0.56,0.737,76
shaman,1.677,8,29,1,1,0.49,0.531,0.604,37
edging,1.677,8,29,1,1,0.479,0.394,0.37,37
synergy,1.677,8,29,1,1,0.667,0.51,0.72,37
folklore,1.677,8,29,1,1,0.755,0.585,0.449,37
embark,1.677,20,69,1,1,0.541,0.55,0.619,89
wither,1.675,43,146,1,1,0.15,0.42,0.259,189
architecture,1.673,25,86,1,1,0.82,0.39,0.694,111
lotus,1.671,16,56,1,1,0.604,0.377,0.51,72
idealistic,1.67,13,46,1,1,0.812,0.469,0.755,59
palmer,1.67,13,46,1,1,0.48,0.269,0.413,59
abhor,1.67,13,46,1,1,0.125,0.602,0.349,59
crystal,1.669,110,372,1,1,0.618,0.27,0.508,482
malice,1.668,21,73,1,1,0.073,0.811,0.492,94
newfound,1.668,21,73,1,1,0.745,0.741,0.52,94
mountain,1.668,526,1772,1,1,0.698,0.408,0.649,2298
raindrops,1.666,26,90,1,1,0.698,0.337,0.311,116
perimeter,1.665,7,26,1,1,0.47,0.443,0.555,33
foreboding,1.665,7,26,1,1,0.439,0.706,0.636,33
flux,1.665,7,26,1,1,0.473,0.472,0.451,33
burrow,1.665,7,26,1,1,0.438,0.28,0.355,33
interrupts,1.665,15,53,1,1,0.204,0.545,0.389,68
railroad,1.665,7,26,1,1,0.591,0.592,0.5,33
enjoy,1.664,9727,32853,1,1,0.959,0.725,0.75,42580
uneasiness,1.662,12,43,1,1,0.19,0.798,0.241,55
winding,1.662,25,87,1,1,0.398,0.582,0.361,112
seeker,1.661,71,243,1,1,0.646,0.464,0.553,314
prayer,1.66,879,2983,1,1,0.745,0.217,0.604,3862
convey,1.66,73,250,1,1,0.719,0.633,0.708,323
layered,1.657,9,33,1,1,0.571,0.306,0.436,42
mythology,1.657,19,67,1,1,0.684,0.439,0.688,86
habitually,1.657,9,33,1,1,0.6,0.324,0.583,42
isle,1.656,36,125,1,1,0.667,0.39,0.443,161
planting,1.654,38,132,1,1,0.635,0.343,0.595,170
render,1.654,16,57,1,1,0.541,0.395,0.448,73
withdrawal,1.653,69,238,1,1,0.275,0.541,0.226,307
wander,1.653,175,600,1,1,0.427,0.417,0.33,775
acquiring,1.653,11,40,1,1,0.735,0.51,0.817,51
distinguish,1.653,35,122,1,1,0.675,0.471,0.6,157
calamity,1.653,11,40,1,1,0.122,0.795,0.343,51
omnipotent,1.653,11,40,1,1,0.719,0.679,0.919,51
grounding,1.65,32,112,1,1,0.521,0.452,0.591,144
preface,1.649,6,23,1,1,0.459,0.375,0.557,29
citation,1.649,6,23,1,1,0.57,0.549,0.508,29
anguished,1.649,6,23,1,1,0.135,0.72,0.307,29
agitation,1.649,6,23,1,1,0.24,0.931,0.447,29
punishable,1.649,6,23,1,1,0.198,0.588,0.433,29
conception,1.647,22,78,1,1,0.694,0.49,0.614,100
origin,1.647,61,212,1,1,0.729,0.435,0.591,273
trace,1.645,69,240,1,1,0.573,0.346,0.483,309
overdo,1.644,8,30,1,1,0.156,0.864,0.602,38
innumerable,1.644,8,30,1,1,0.667,0.445,0.704,38
renaissance,1.644,8,30,1,1,0.771,0.67,0.767,38
whimsical,1.644,8,30,1,1,0.449,0.637,0.371,38
infiltrate,1.644,8,30,1,1,0.408,0.745,0.587,38
decadence,1.644,8,30,1,1,0.237,0.455,0.291,38
figurative,1.644,8,30,1,1,0.479,0.45,0.634,38
boisterous,1.644,8,30,1,1,0.385,0.806,0.565,38
companionship,1.642,422,1460,1,1,0.833,0.438,0.792,1882
barbecue,1.641,10,37,1,1,0.792,0.643,0.456,47
henceforth,1.641,10,37,1,1,0.527,0.404,0.466,47
symphony,1.641,21,75,1,1,0.765,0.49,0.6,96
fleeting,1.64,75,262,1,1,0.439,0.65,0.387,337
visualize,1.639,25,89,1,1,0.635,0.431,0.537,114
rigid,1.639,12,44,1,1,0.357,0.552,0.591,56
oncoming,1.639,12,44,1,1,0.594,0.625,0.773,56
absorb,1.638,57,200,1,1,0.469,0.558,0.67,257
periodic,1.638,14,51,1,1,0.677,0.324,0.508,65
insatiable,1.638,14,51,1,1,0.375,0.656,0.558,65
coyote,1.637,16,58,1,1,0.459,0.471,0.387,74
hospitality,1.635,22,79,1,1,0.865,0.333,0.725,101
utter,1.635,256,893,1,1,0.531,0.422,0.549,1149
reflecting,1.634,157,549,1,1,0.59,0.408,0.471,706
sipping,1.632,85,299,1,1,0.469,0.349,0.377,384
incubator,1.628,5,20,1,1,0.51,0.435,0.405,25
moat,1.628,7,27,1,1,0.398,0.38,0.314,34
manifestation,1.628,25,90,1,1,0.583,0.75,0.655,115
reconstruction,1.628,5,20,1,1,0.625,0.719,0.667,25
anthropology,1.628,5,20,1,1,0.49,0.367,0.582,25
blossom,1.628,45,160,1,1,0.792,0.275,0.309,205
undue,1.628,7,27,1,1,0.156,0.573,0.318,34
downpour,1.628,13,48,1,1,0.328,0.602,0.481,61
pope,1.628,71,251,1,1,0.6,0.375,0.636,322
inhabited,1.628,11,41,1,1,0.667,0.361,0.51,52
wail,1.628,9,34,1,1,0.418,0.724,0.393,43
nocturnal,1.628,31,111,1,1,0.54,0.5,0.462,142
vulgarity,1.628,5,20,1,1,0.104,0.87,0.346,25
gill,1.628,9,34,1,1,0.521,0.473,0.382,43
revival,1.623,24,87,1,1,0.823,0.664,0.597,111
spectacular,1.621,60,214,1,1,0.947,0.74,0.887,274
poems,1.621,155,549,1,1,0.833,0.388,0.418,704
hushed,1.62,16,59,1,1,0.292,0.194,0.272,75
mischievous,1.619,14,52,1,1,0.439,0.804,0.472,66
chamber,1.618,94,335,1,1,0.583,0.373,0.455,429
unsung,1.617,12,45,1,1,0.296,0.33,0.314,57
vocabulary,1.617,36,130,1,1,0.53,0.247,0.585,166
threshold,1.617,23,84,1,1,0.531,0.519,0.575,107
earnest,1.616,21,77,1,1,0.653,0.38,0.67,98
omen,1.616,10,38,1,1,0.39,0.657,0.583,48
maximize,1.616,10,38,1,1,0.823,0.765,0.792,48
obtain,1.615,41,148,1,1,0.76,0.438,0.731,189
strait,1.613,8,31,1,1,0.438,0.433,0.412,39
medieval,1.613,26,95,1,1,0.56,0.408,0.455,121
vigor,1.613,8,31,1,1,0.86,0.755,0.811,39
prickly,1.613,8,31,1,1,0.333,0.587,0.456,39
pendant,1.613,8,31,1,1,0.676,0.321,0.385,39
preservation,1.611,24,88,1,1,0.667,0.51,0.686,112
merge,1.611,24,88,1,1,0.76,0.48,0.733,112
trilogy,1.611,47,170,1,1,0.615,0.52,0.664,217
ogre,1.611,15,56,1,1,0.135,0.698,0.51,71
spacecraft,1.608,6,24,1,1,0.646,0.698,0.68,30
pious,1.608,13,49,1,1,0.698,0.306,0.426,62
bearings,1.608,6,24,1,1,0.418,0.49,0.426,30
handbook,1.608,6,24,1,1,0.6,0.224,0.567,30
compressed,1.608,6,24,1,1,0.323,0.396,0.388,30
tribulation,1.608,13,49,1,1,0.448,0.612,0.484,62
entice,1.608,6,24,1,1,0.521,0.887,0.518,30
distinctive,1.608,6,24,1,1,0.885,0.52,0.604,30
axis,1.608,13,49,1,1,0.209,0.25,0.356,62
personable,1.608,6,24,1,1,0.816,0.52,0.637,30
beneath,1.608,177,635,1,1,0.354,0.173,0.233,812
alienation,1.607,51,185,1,1,0.378,0.53,0.462,236
polar,1.606,56,203,1,1,0.468,0.261,0.5,259
howl,1.606,37,135,1,1,0.357,0.646,0.407,172
consciousness,1.606,125,450,1,1,0.84,0.483,0.755,575
unwind,1.606,68,246,1,1,0.837,0.181,0.394,314
hideout,1.605,11,42,1,1,0.337,0.443,0.302,53
candlelight,1.605,11,42,1,1,0.789,0.294,0.417,53
stained,1.604,33,121,1,1,0.245,0.46,0.209,154
excess,1.603,38,139,1,1,0.385,0.889,0.712,177
altered,1.602,26,96,1,1,0.255,0.765,0.5,122
fixture,1.6,9,35,1,1,0.663,0.216,0.409,44
martini,1.6,9,35,1,1,0.828,0.5,0.519,44
disappearance,1.6,14,53,1,1,0.214,0.698,0.367,67
feign,1.6,9,35,1,1,0.34,0.394,0.356,44
cuisine,1.6,9,35,1,1,0.714,0.365,0.39,44
scent,1.597,79,288,1,1,0.633,0.41,0.491,367
saturated,1.596,12,46,1,1,0.474,0.7,0.442,58
cedar,1.596,12,46,1,1,0.56,0.267,0.577,58
breezy,1.596,12,46,1,1,0.531,0.472,0.482,58
descend,1.595,20,75,1,1,0.385,0.535,0.231,95
paradoxical,1.595,20,75,1,1,0.406,0.547,0.433,95
linguistic,1.593,7,28,1,1,0.646,0.351,0.618,35
quartz,1.593,7,28,1,1,0.704,0.292,0.481,35
inland,1.593,7,28,1,1,0.51,0.417,0.423,35
reborn,1.593,39,144,1,1,0.802,0.618,0.737,183
pebble,1.593,7,28,1,1,0.354,0.353,0.287,35
eagle,1.593,42,155,1,1,0.604,0.594,0.679,197
discovery,1.592,120,438,1,1,0.823,0.627,0.814,558
mundane,1.591,48,177,1,1,0.312,0.42,0.48,225
notably,1.59,10,39,1,1,0.792,0.533,0.689,49
fraught,1.59,10,39,1,1,0.266,0.662,0.596,49
intimacy,1.59,209,763,1,1,0.857,0.802,0.558,972
fort,1.587,84,309,1,1,0.78,0.673,0.86,393
ferry,1.587,16,61,1,1,0.604,0.509,0.389,77
lavish,1.586,19,72,1,1,0.792,0.648,0.73,91
peaceful,1.583,1776,6506,1,1,0.867,0.108,0.569,8282
elements,1.583,79,292,1,1,0.51,0.312,0.462,371
insulation,1.582,5,21,1,1,0.245,0.327,0.264,26
weave,1.582,17,65,1,1,0.604,0.265,0.172,82
standstill,1.582,5,21,1,1,0.441,0.203,0.5,26
meager,1.582,5,21,1,1,0.144,0.389,0.281,26
deliberate,1.582,47,175,1,1,0.551,0.654,0.682,222
eagerness,1.582,8,32,1,1,0.406,0.621,0.443,40
observant,1.582,17,65,1,1,0.74,0.422,0.708,82
tentative,1.582,5,21,1,1,0.582,0.657,0.534,26
doubtless,1.582,5,21,1,1,0.688,0.415,0.689,26
prompt,1.582,41,153,1,1,0.602,0.548,0.582,194
disciplinary,1.582,5,21,1,1,0.562,0.593,0.796,26
fountain,1.582,29,109,1,1,0.704,0.292,0.559,138
damnation,1.582,8,32,1,1,0.135,0.75,0.416,40
commanding,1.582,5,21,1,1,0.562,0.664,0.925,26
ahoy,1.582,5,21,1,1,0.5,0.497,0.38,26
cappuccino,1.582,5,21,1,1,0.792,0.279,0.384,26
distinguishing,1.582,5,21,1,1,0.622,0.363,0.64,26
castaway,1.582,11,43,1,1,0.208,0.646,0.422,54
virtue,1.581,105,388,1,1,0.896,0.443,0.827,493
roar,1.58,39,146,1,1,0.427,0.816,0.675,185
growth,1.58,676,2487,1,1,0.917,0.588,0.776,3163
blooming,1.579,27,102,1,1,0.86,0.452,0.593,129
exotic,1.578,24,91,1,1,0.84,0.711,0.727,115
ridge,1.578,24,91,1,1,0.484,0.402,0.349,115
reflect,1.578,676,2491,1,1,0.698,0.342,0.472,3167
wholly,1.577,40,150,1,1,0.69,0.353,0.696,190
infinite,1.575,193,715,1,1,0.724,0.583,0.735,908
herbal,1.575,12,47,1,1,0.592,0.255,0.39,59
eerie,1.575,61,228,1,1,0.265,0.771,0.442,289
unplug,1.574,35,132,1,1,0.239,0.441,0.404,167
philosophy,1.573,102,380,1,1,0.684,0.255,0.64,482
tale,1.573,122,454,1,1,0.663,0.3,0.336,576
imitation,1.573,9,36,1,1,0.406,0.592,0.343,45
prolific,1.573,9,36,1,1,0.625,0.55,0.604,45
uninhabited,1.573,9,36,1,1,0.301,0.23,0.221,45
scented,1.571,16,62,1,1,0.865,0.509,0.431,78
authentic,1.571,125,466,1,1,0.885,0.51,0.782,591
collaboration,1.571,57,214,1,1,0.885,0.628,0.741,271
resort,1.571,139,518,1,1,0.573,0.441,0.632,657
devotee,1.569,6,25,1,1,0.816,0.461,0.577,31
dispersed,1.569,6,25,1,1,0.344,0.49,0.274,31
dotted,1.569,6,25,1,1,0.48,0.347,0.426,31
intrinsic,1.569,13,51,1,1,0.406,0.471,0.526,64
adobe,1.569,6,25,1,1,0.5,0.319,0.328,31
subdue,1.569,6,25,1,1,0.275,0.64,0.784,31
unfettered,1.569,6,25,1,1,0.569,0.65,0.586,31
bookworm,1.569,6,25,1,1,0.563,0.337,0.316,31
prudence,1.569,6,25,1,1,0.781,0.284,0.679,31
circumstantial,1.569,6,25,1,1,0.5,0.538,0.519,31
randomness,1.569,6,25,1,1,0.418,0.449,0.433,31
jazzy,1.569,6,25,1,1,0.725,0.431,0.389,31
drizzle,1.569,6,25,1,1,0.521,0.353,0.319,31
fruitless,1.569,6,25,1,1,0.26,0.58,0.311,31
receding,1.569,6,25,1,1,0.224,0.418,0.333,31
sage,1.568,45,170,1,1,0.781,0.327,0.693,215
forge,1.568,31,118,1,1,0.52,0.424,0.686,149
aversion,1.567,24,92,1,1,0.074,0.663,0.525,116
genre,1.567,96,360,1,1,0.52,0.433,0.5,456
assertion,1.567,17,66,1,1,0.74,0.442,0.75,83
carriage,1.566,21,81,1,1,0.65,0.538,0.491,102
devoid,1.564,44,167,1,1,0.219,0.436,0.3,211
spacious,1.563,18,70,1,1,0.88,0.365,0.557,88
boundary,1.562,22,85,1,1,0.561,0.427,0.518,107
necessary,1.562,768,2875,1,1,0.75,0.433,0.679,3643
inn,1.562,30,115,1,1,0.66,0.284,0.475,145
physique,1.559,7,29,1,1,0.643,0.5,0.543,36
lull,1.559,11,44,1,1,0.602,0.13,0.402,55
lagoon,1.559,7,29,1,1,0.66,0.231,0.373,36
holistic,1.559,11,44,1,1,0.67,0.348,0.547,55
orchid,1.559,7,29,1,1,0.84,0.345,0.382,36
mound,1.559,7,29,1,1,0.52,0.481,0.509,36
overgrown,1.559,11,44,1,1,0.333,0.5,0.369,55
integrate,1.559,15,59,1,1,0.729,0.39,0.7,74
symposium,1.559,7,29,1,1,0.573,0.394,0.644,36
dreamland,1.559,7,29,1,1,0.844,0.471,0.566,36
rampage,1.559,11,44,1,1,0.24,0.875,0.509,55
suffocation,1.559,7,29,1,1,0.02,0.83,0.462,36
sorcerer,1.559,7,29,1,1,0.377,0.633,0.632,36
prophet,1.556,71,270,1,1,0.673,0.462,0.774,341
fulfillment,1.556,50,191,1,1,0.833,0.528,0.683,241
examination,1.556,16,63,1,1,0.378,0.657,0.679,79
scholar,1.554,25,97,1,1,0.694,0.421,0.731,122
systematically,1.554,12,48,1,1,0.69,0.39,0.651,60
hiss,1.554,12,48,1,1,0.388,0.48,0.37,60
bunker,1.554,38,146,1,1,0.375,0.673,0.773,184
clouded,1.553,21,82,1,1,0.24,0.213,0.302,103
journal,1.553,163,618,1,1,0.688,0.24,0.352,781
awakening,1.552,98,373,1,1,0.745,0.5,0.618,471
reboot,1.552,35,135,1,1,0.673,0.577,0.519,170
itinerary,1.552,8,33,1,1,0.551,0.55,0.454,41
unleash,1.551,22,86,1,1,0.479,0.775,0.559,108
drain,1.551,193,733,1,1,0.277,0.47,0.222,926
waves,1.551,327,1240,1,1,0.643,0.47,0.509,1567
disciple,1.55,13,52,1,1,0.765,0.385,0.462,65
exhilarating,1.549,18,71,1,1,0.917,0.823,0.81,89
depth,1.547,146,557,1,1,0.708,0.561,0.759,703
observer,1.546,19,75,1,1,0.663,0.363,0.603,94
grit,1.546,24,94,1,1,0.449,0.296,0.345,118
ancestral,1.546,9,37,1,1,0.64,0.481,0.75,46
covet,1.546,9,37,1,1,0.302,0.779,0.524,46
deepen,1.546,9,37,1,1,0.625,0.53,0.776,46
atomic,1.546,9,37,1,1,0.327,0.817,0.713,46
communal,1.546,44,170,1,1,0.592,0.321,0.556,214
diner,1.545,35,136,1,1,0.643,0.302,0.538,171
voyage,1.544,25,98,1,1,0.816,0.714,0.58,123
vanity,1.544,41,159,1,1,0.26,0.54,0.439,200
vein,1.543,36,140,1,1,0.347,0.373,0.318,176
harvest,1.543,36,140,1,1,0.781,0.353,0.548,176
limitless,1.542,26,102,1,1,0.688,0.574,0.655,128
conversing,1.541,21,83,1,1,0.755,0.409,0.442,104
apprehension,1.541,10,41,1,1,0.385,0.72,0.454,51
pursuit,1.541,93,358,1,1,0.643,0.453,0.617,451
dwell,1.539,148,569,1,1,0.698,0.245,0.611,717
paradise,1.538,188,723,1,1,0.875,0.54,0.796,911
hilt,1.537,5,22,1,1,0.396,0.65,0.537,27
posture,1.537,17,68,1,1,0.562,0.309,0.598,85
clipping,1.537,5,22,1,1,0.46,0.5,0.405,27
fen,1.537,5,22,1,1,0.49,0.276,0.379,27
polished,1.537,11,45,1,1,0.667,0.413,0.491,56
tantamount,1.537,5,22,1,1,0.633,0.288,0.67,27
hawking,1.537,5,22,1,1,0.521,0.509,0.491,27
consummate,1.537,5,22,1,1,0.551,0.54,0.558,27
greenhouse,1.537,5,22,1,1,0.719,0.438,0.384,27
renovation,1.537,5,22,1,1,0.816,0.59,0.779,27
cradle,1.537,17,68,1,1,0.776,0.194,0.333,85
inferno,1.537,11,45,1,1,0.051,0.857,0.463,56
behemoth,1.537,5,22,1,1,0.583,0.781,0.853,27
capitals,1.537,5,22,1,1,0.755,0.5,0.655,27
attire,1.537,17,68,1,1,0.742,0.388,0.483,85
devour,1.536,30,118,1,1,0.344,0.888,0.574,148
abide,1.536,30,118,1,1,0.635,0.354,0.705,148
capture,1.535,87,337,1,1,0.357,0.65,0.537,424
intuitive,1.535,31,122,1,1,0.771,0.573,0.69,153
abrupt,1.534,12,49,1,1,0.271,0.819,0.545,61
depart,1.534,25,99,1,1,0.398,0.48,0.444,124
nostalgia,1.534,71,276,1,1,0.417,0.337,0.339,347
puny,1.531,6,26,1,1,0.312,0.324,0.135,32
underpants,1.531,6,26,1,1,0.448,0.473,0.276,32
arched,1.531,6,26,1,1,0.582,0.403,0.398,32
penitentiary,1.531,6,26,1,1,0.229,0.726,0.491,32
darkly,1.531,6,26,1,1,0.219,0.548,0.443,32
sloth,1.531,13,53,1,1,0.198,0.14,0.125,66
reserves,1.531,13,53,1,1,0.653,0.363,0.52,66
heightened,1.531,27,107,1,1,0.592,0.529,0.788,134
unchanged,1.531,6,26,1,1,0.49,0.204,0.237,32
density,1.531,13,53,1,1,0.602,0.471,0.561,66
duel,1.531,13,53,1,1,0.271,0.696,0.589,66
heather,1.529,59,231,1,1,0.5,0.352,0.407,290
crowds,1.529,315,1221,1,1,0.469,0.723,0.806,1536
duke,1.528,52,204,1,1,0.667,0.44,0.669,256
massacre,1.528,37,146,1,1,0.031,0.887,0.64,183
remote,1.528,213,827,1,1,0.458,0.333,0.477,1040
clouds,1.527,241,936,1,1,0.735,0.195,0.324,1177
exodus,1.527,23,92,1,1,0.286,0.663,0.567,115
holiness,1.527,15,61,1,1,0.86,0.264,0.742,76
occult,1.527,7,30,1,1,0.292,0.382,0.406,37
anew,1.527,23,92,1,1,0.771,0.358,0.385,115
wretch,1.527,7,30,1,1,0.04,0.667,0.25,37
backwoods,1.527,7,30,1,1,0.541,0.35,0.482,37
druid,1.527,7,30,1,1,0.517,0.445,0.481,37
highest,1.526,267,1038,1,1,0.771,0.64,0.71,1305
dexter,1.525,16,65,1,1,0.458,0.473,0.444,81
affections,1.525,16,65,1,1,0.76,0.547,0.655,81
brewing,1.524,25,100,1,1,0.74,0.593,0.609,125
freedom,1.523,1287,5007,1,1,0.969,0.544,0.905,6294
tinge,1.523,8,34,1,1,0.469,0.292,0.264,42
palette,1.523,17,69,1,1,0.59,0.333,0.205,86
synonym,1.523,8,34,1,1,0.615,0.21,0.433,42
trot,1.523,8,34,1,1,0.531,0.664,0.396,42
stature,1.523,8,34,1,1,0.47,0.353,0.664,42
scribble,1.52,9,38,1,1,0.429,0.453,0.358,47
naval,1.52,9,38,1,1,0.542,0.449,0.679,47
atom,1.52,9,38,1,1,0.51,0.5,0.433,47
camping,1.52,120,471,1,1,0.653,0.529,0.48,591
pale,1.519,73,288,1,1,0.281,0.259,0.245,361
detach,1.518,42,167,1,1,0.357,0.625,0.45,209
blindness,1.518,21,85,1,1,0.245,0.48,0.196,106
hue,1.516,23,93,1,1,0.507,0.416,0.417,116
flute,1.516,11,46,1,1,0.635,0.33,0.363,57
doorway,1.515,24,97,1,1,0.573,0.304,0.496,121
manuscript,1.514,25,101,1,1,0.51,0.208,0.54,126
unfold,1.514,38,152,1,1,0.612,0.51,0.52,190
cape,1.514,53,211,1,1,0.531,0.235,0.357,264
barren,1.513,40,160,1,1,0.173,0.373,0.221,200
decisive,1.513,13,54,1,1,0.74,0.509,0.935,67
prairie,1.513,13,54,1,1,0.673,0.183,0.415,67
chosen,1.512,317,1249,1,1,0.865,0.449,0.833,1566
gloom,1.512,43,172,1,1,0.135,0.404,0.196,215
ghostly,1.512,14,58,1,1,0.26,0.764,0.43,72
turbulent,1.512,14,58,1,1,0.302,0.792,0.612,72
wood,1.511,126,499,1,1,0.494,0.182,0.373,625
agonizing,1.51,33,133,1,1,0.083,0.8,0.34,166
unending,1.509,34,137,1,1,0.385,0.519,0.454,171
preferable,1.509,52,208,1,1,0.806,0.433,0.687,260
cripple,1.508,18,74,1,1,0.094,0.392,0.161,92
autonomy,1.508,37,149,1,1,0.781,0.349,0.891,186
eccentric,1.508,18,74,1,1,0.531,0.806,0.721,92
madame,1.508,18,74,1,1,0.604,0.5,0.635,92
tomb,1.508,37,149,1,1,0.112,0.5,0.343,186
disrupting,1.508,18,74,1,1,0.186,0.557,0.339,92
wrath,1.507,39,157,1,1,0.039,0.908,0.548,196
leaf,1.507,60,240,1,1,0.583,0.156,0.294,300
discernment,1.507,20,82,1,1,0.408,0.471,0.694,102
priceless,1.507,126,501,1,1,0.745,0.696,0.779,627
reaper,1.505,23,94,1,1,0.34,0.565,0.464,117
downtime,1.505,25,102,1,1,0.24,0.226,0.324,127
flowers,1.504,373,1481,1,1,0.875,0.324,0.33,1854
damp,1.503,29,118,1,1,0.36,0.279,0.21,147
flourish,1.503,60,241,1,1,0.939,0.573,0.601,301
classical,1.501,37,150,1,1,0.643,0.198,0.536,187
lands,1.501,78,313,1,1,0.594,0.28,0.492,391
activity,1.501,238,949,1,1,0.701,0.66,0.807,1187
invention,1.501,87,349,1,1,0.714,0.577,0.811,436
stunning,1.497,118,474,1,1,0.888,0.673,0.858,592
sculpture,1.495,6,27,1,1,0.75,0.346,0.49,33
vacancy,1.495,9,39,1,1,0.643,0.311,0.418,48
pinnacle,1.495,15,63,1,1,0.633,0.39,0.508,78
withering,1.495,11,47,1,1,0.271,0.65,0.345,58
radically,1.495,13,55,1,1,0.552,0.731,0.715,68
ivory,1.495,14,59,1,1,0.625,0.235,0.566,73
wrinkle,1.495,6,27,1,1,0.15,0.37,0.274,33
serenade,1.495,10,43,1,1,0.875,0.57,0.491,53
berserk,1.495,8,35,1,1,0.398,0.556,0.48,43
spur,1.495,11,47,1,1,0.378,0.545,0.34,58
historian,1.495,9,39,1,1,0.688,0.27,0.637,48
vagabond,1.495,10,43,1,1,0.384,0.531,0.144,53
insinuate,1.495,5,23,1,1,0.292,0.635,0.413,28
drowsy,1.495,6,27,1,1,0.375,0.18,0.24,33
opiate,1.495,5,23,1,1,0.281,0.594,0.598,28
sporadic,1.495,8,35,1,1,0.333,0.394,0.5,43
expedition,1.495,6,27,1,1,0.735,0.802,0.62,33
blasphemy,1.495,10,43,1,1,0.146,0.794,0.406,53
hardwood,1.495,5,23,1,1,0.417,0.363,0.518,28
detour,1.495,8,35,1,1,0.398,0.539,0.309,43
clashing,1.495,5,23,1,1,0.177,0.764,0.575,28
chardonnay,1.495,7,31,1,1,0.677,0.567,0.492,38
courtship,1.495,6,27,1,1,0.667,0.49,0.654,33
assuage,1.495,6,27,1,1,0.745,0.255,0.5,33
enormity,1.495,6,27,1,1,0.594,0.648,0.848,33
execute,1.495,26,107,1,1,0.327,0.708,0.769,133
gust,1.495,6,27,1,1,0.49,0.755,0.556,33
thump,1.495,8,35,1,1,0.28,0.792,0.608,43
fencing,1.495,8,35,1,1,0.542,0.654,0.539,43
conscientious,1.495,5,23,1,1,0.688,0.404,0.688,28
utopian,1.495,5,23,1,1,0.542,0.327,0.552,28
provisions,1.495,6,27,1,1,0.67,0.51,0.642,33
wreckage,1.495,9,39,1,1,0.082,0.353,0.333,48
reverting,1.495,6,27,1,1,0.562,0.385,0.544,33
juncture,1.495,5,23,1,1,0.365,0.582,0.491,28
retaining,1.495,7,31,1,1,0.417,0.559,0.632,38
dearth,1.495,5,23,1,1,0.156,0.539,0.255,28
unconventional,1.495,11,47,1,1,0.177,0.509,0.288,58
discerning,1.495,6,27,1,1,0.542,0.584,0.78,33
chitchat,1.495,8,35,1,1,0.673,0.455,0.403,43
fled,1.495,30,123,1,1,0.224,0.639,0.322,153
harshness,1.495,5,23,1,1,0.323,0.6,0.779,28
absolution,1.495,8,35,1,1,0.715,0.5,0.664,43
frivolous,1.495,9,39,1,1,0.271,0.565,0.377,48
adept,1.495,8,35,1,1,0.594,0.539,0.789,43
winter,1.494,685,2746,1,1,0.663,0.355,0.5,3431
observe,1.49,105,425,1,1,0.771,0.39,0.36,530
sailing,1.49,50,204,1,1,0.667,0.52,0.5,254
incest,1.487,32,132,1,1,0.073,0.853,0.491,164
disconnect,1.486,105,427,1,1,0.438,0.292,0.191,532
painted,1.485,72,294,1,1,0.667,0.333,0.424,366
practise,1.483,20,84,1,1,0.713,0.49,0.616,104
flows,1.481,54,222,1,1,0.571,0.48,0.434,276
godfather,1.48,16,68,1,1,0.694,0.45,0.509,84
adventure,1.479,249,1015,1,1,0.917,0.857,0.71,1264
utmost,1.479,45,186,1,1,0.719,0.74,0.858,231
conformity,1.478,14,60,1,1,0.645,0.363,0.579,74
luxury,1.478,204,833,1,1,0.932,0.673,0.75,1037
genius,1.478,215,878,1,1,0.878,0.667,0.846,1093
interrupting,1.476,39,162,1,1,0.146,0.593,0.509,201
misfortune,1.476,38,158,1,1,0.094,0.78,0.311,196
unfamiliar,1.476,102,419,1,1,0.219,0.558,0.273,521
arrival,1.475,50,207,1,1,0.678,0.51,0.474,257
dungeon,1.475,36,150,1,1,0.276,0.608,0.44,186
indulgent,1.474,11,48,1,1,0.56,0.481,0.529,59
epilogue,1.474,11,48,1,1,0.582,0.353,0.466,59
importance,1.474,291,1192,1,1,0.75,0.58,0.864,1483
pour,1.473,183,751,1,1,0.448,0.57,0.375,934
grass,1.473,170,698,1,1,0.604,0.164,0.333,868
metaphor,1.472,42,175,1,1,0.562,0.28,0.47,217
tug,1.472,31,130,1,1,0.32,0.604,0.558,161
aura,1.471,62,257,1,1,0.76,0.333,0.5,319
ark,1.471,20,85,1,1,0.396,0.427,0.543,105
victor,1.471,51,212,1,1,0.802,0.587,0.796,263
clad,1.47,9,40,1,1,0.583,0.373,0.481,49
humid,1.47,9,40,1,1,0.375,0.324,0.366,49
metropolitan,1.47,9,40,1,1,0.387,0.408,0.723,49
carcass,1.47,9,40,1,1,0.115,0.529,0.309,49
nomad,1.47,9,40,1,1,0.375,0.413,0.433,49
cassette,1.47,9,40,1,1,0.49,0.334,0.355,49
tavern,1.47,9,40,1,1,0.516,0.577,0.475,49
parachute,1.47,9,40,1,1,0.562,0.787,0.564,49
liberation,1.468,36,151,1,1,0.745,0.614,0.857,187
instructed,1.467,17,73,1,1,0.74,0.388,0.722,90
urinal,1.467,8,36,1,1,0.214,0.51,0.306,44
inconceivable,1.467,8,36,1,1,0.198,0.552,0.561,44
ink,1.467,52,217,1,1,0.471,0.408,0.235,269
noise,1.466,929,3827,1,1,0.26,0.883,0.388,4756
intriguing,1.466,33,139,1,1,0.422,0.713,0.462,172
archer,1.466,16,69,1,1,0.573,0.622,0.661,85
grapes,1.465,24,102,1,1,0.784,0.24,0.236,126
fuzz,1.464,7,32,1,1,0.521,0.482,0.363,39
harness,1.464,15,65,1,1,0.57,0.549,0.508,80
signify,1.464,7,32,1,1,0.453,0.422,0.634,39
collector,1.464,15,65,1,1,0.552,0.481,0.648,80
rowing,1.464,7,32,1,1,0.458,0.443,0.467,39
lethargy,1.464,7,32,1,1,0.194,0.302,0.316,39
discern,1.464,23,98,1,1,0.459,0.566,0.518,121
anathema,1.464,7,32,1,1,0.286,0.49,0.519,39
restoration,1.463,22,94,1,1,0.755,0.426,0.734,116
possession,1.462,44,185,1,1,0.677,0.676,0.848,229
misty,1.462,29,123,1,1,0.427,0.451,0.278,152
pivotal,1.462,14,61,1,1,0.582,0.471,0.536,75
miniature,1.462,14,61,1,1,0.429,0.292,0.204,75
crucial,1.462,126,524,1,1,0.541,0.657,0.777,650
hustle,1.462,103,429,1,1,0.406,0.661,0.427,532
liberated,1.461,28,119,1,1,0.78,0.63,0.683,147
crab,1.461,28,119,1,1,0.421,0.396,0.33,147
unmatched,1.46,49,206,1,1,0.776,0.536,0.771,255
antique,1.46,6,28,1,1,0.634,0.29,0.518,34
serendipity,1.46,27,115,1,1,0.677,0.413,0.5,142
teeming,1.46,6,28,1,1,0.582,0.55,0.727,34
settlement,1.46,13,57,1,1,0.635,0.412,0.723,70
accelerated,1.46,6,28,1,1,0.61,0.812,0.682,34
ablaze,1.46,6,28,1,1,0.24,0.847,0.525,34
upkeep,1.46,6,28,1,1,0.59,0.442,0.685,34
acoustics,1.46,6,28,1,1,0.611,0.33,0.509,34
opposites,1.46,13,57,1,1,0.281,0.518,0.462,70
daybreak,1.46,6,28,1,1,0.802,0.358,0.474,34
immense,1.459,101,422,1,1,0.755,0.75,0.811,523
bathe,1.458,32,136,1,1,0.677,0.294,0.371,168
heath,1.457,58,244,1,1,0.802,0.387,0.546,302
headquarters,1.457,12,53,1,1,0.615,0.271,0.525,65
cottage,1.457,64,269,1,1,0.6,0.279,0.361,333
illuminating,1.457,12,53,1,1,0.949,0.613,0.773,65
constructive,1.456,50,211,1,1,0.86,0.57,0.812,261
protector,1.456,37,157,1,1,0.779,0.36,0.824,194
participation,1.456,24,103,1,1,0.781,0.7,0.702,127
retribution,1.454,11,49,1,1,0.625,0.49,0.708,60
enthralled,1.454,5,24,1,1,0.745,0.602,0.615,29
grapefruit,1.454,5,24,1,1,0.521,0.281,0.282,29
yoke,1.454,5,24,1,1,0.281,0.62,0.582,29
infallible,1.454,5,24,1,1,0.776,0.687,0.809,29
evacuation,1.454,5,24,1,1,0.16,0.755,0.582,29
morose,1.454,5,24,1,1,0.24,0.663,0.264,29
incandescent,1.454,5,24,1,1,0.354,0.612,0.621,29
ebb,1.454,11,49,1,1,0.354,0.451,0.404,60
veil,1.454,41,174,1,1,0.5,0.235,0.415,215
interdependent,1.454,5,24,1,1,0.41,0.482,0.598,29
yew,1.454,11,49,1,1,0.312,0.207,0.311,60
decompress,1.453,46,195,1,1,0.438,0.43,0.509,241
sociable,1.452,79,333,1,1,0.854,0.459,0.627,412
cosmic,1.452,50,212,1,1,0.663,0.538,0.692,262
underrated,1.451,205,860,1,1,0.208,0.52,0.333,1065
basil,1.45,10,45,1,1,0.534,0.274,0.309,55
unintended,1.45,10,45,1,1,0.438,0.385,0.349,55
chimes,1.45,10,45,1,1,0.625,0.49,0.402,55
warmth,1.449,307,1289,1,1,0.878,0.307,0.602,1596
shrink,1.448,41,175,1,1,0.385,0.453,0.272,216
spa,1.447,45,192,1,1,0.622,0.151,0.386,237
knack,1.446,14,62,1,1,0.562,0.518,0.82,76
gale,1.446,9,41,1,1,0.271,0.691,0.611,50
discretion,1.446,9,41,1,1,0.552,0.32,0.685,50
swirl,1.446,9,41,1,1,0.49,0.726,0.639,50
insignificance,1.446,9,41,1,1,0.25,0.216,0.222,50
exceed,1.446,9,41,1,1,0.5,0.827,0.586,50
distinction,1.445,38,163,1,1,0.584,0.571,0.75,201
writer,1.445,368,1551,1,1,0.806,0.33,0.78,1919
abject,1.444,18,79,1,1,0.354,0.59,0.417,97
mythical,1.443,13,58,1,1,0.625,0.556,0.583,71
odyssey,1.442,22,96,1,1,0.622,0.692,0.71,118
shadowy,1.441,8,37,1,1,0.135,0.373,0.33,45
chattering,1.441,8,37,1,1,0.46,0.663,0.304,45
intrinsically,1.441,8,37,1,1,0.459,0.382,0.538,45
shrivel,1.441,8,37,1,1,0.16,0.409,0.143,45
patter,1.441,8,37,1,1,0.312,0.635,0.451,45
behold,1.44,57,244,1,1,0.61,0.284,0.449,301
scatter,1.439,12,54,1,1,0.229,0.62,0.404,66
carefree,1.438,55,236,1,1,0.755,0.22,0.5,291
relative,1.438,162,689,1,1,0.5,0.378,0.386,851
adoration,1.438,33,143,1,1,0.885,0.699,0.708,176
desire,1.437,829,3516,1,1,0.896,0.692,0.647,4345
singular,1.436,61,262,1,1,0.61,0.302,0.482,323
fidelity,1.434,7,33,1,1,0.765,0.58,0.709,40
dank,1.434,15,67,1,1,0.39,0.381,0.383,82
doings,1.434,23,101,1,1,0.604,0.491,0.705,124
rooftop,1.434,35,152,1,1,0.571,0.471,0.461,187
highness,1.434,7,33,1,1,0.74,0.67,0.931,40
bondage,1.434,19,84,1,1,0.146,0.705,0.355,103
grueling,1.434,7,33,1,1,0.18,0.763,0.704,40
dire,1.433,58,250,1,1,0.214,0.66,0.259,308
books,1.433,1485,6324,1,1,0.729,0.115,0.43,7809
varied,1.431,18,80,1,1,0.604,0.701,0.472,98
lantern,1.43,14,63,1,1,0.622,0.25,0.243,77
volcano,1.43,14,63,1,1,0.24,0.844,0.787,77
magnetic,1.429,10,46,1,1,0.612,0.529,0.673,56
completion,1.429,21,93,1,1,0.656,0.47,0.525,114
riveting,1.429,10,46,1,1,0.448,0.544,0.394,56
defiant,1.429,10,46,1,1,0.25,0.792,0.769,56
mechanical,1.428,17,76,1,1,0.479,0.569,0.564,93
lens,1.428,35,153,1,1,0.42,0.245,0.472,188
gloomy,1.426,90,389,1,1,0.107,0.41,0.287,479
recklessness,1.426,6,29,1,1,0.292,0.763,0.38,35
enable,1.425,51,222,1,1,0.76,0.491,0.782,273
tremble,1.425,23,102,1,1,0.177,0.878,0.388,125
revelations,1.425,23,102,1,1,0.729,0.655,0.6,125
mayhem,1.424,16,72,1,1,0.188,0.87,0.364,88
astronaut,1.424,16,72,1,1,0.792,0.601,0.761,88
peculiar,1.423,26,115,1,1,0.6,0.491,0.564,141
screenplay,1.423,9,42,1,1,0.5,0.406,0.518,51
cosy,1.422,22,98,1,1,0.847,0.255,0.518,120
wholesome,1.421,97,421,1,1,0.888,0.423,0.754,518
verb,1.421,12,55,1,1,0.582,0.312,0.414,67
metaphorical,1.421,12,55,1,1,0.5,0.412,0.48,67
frosty,1.421,12,55,1,1,0.427,0.48,0.381,67
regain,1.42,63,275,1,1,0.729,0.52,0.759,338
whisky,1.418,21,94,1,1,0.64,0.615,0.49,115
realm,1.418,99,431,1,1,0.708,0.509,0.878,530
farewell,1.416,51,224,1,1,0.13,0.5,0.591,275
robust,1.415,11,51,1,1,0.667,0.604,0.719,62
hearth,1.415,11,51,1,1,0.76,0.275,0.536,62
mysterious,1.415,95,415,1,1,0.448,0.699,0.455,510
rainfall,1.415,5,25,1,1,0.604,0.314,0.378,30
linen,1.415,8,38,1,1,0.656,0.323,0.286,46
namesake,1.415,5,25,1,1,0.418,0.327,0.404,30
boldness,1.415,8,38,1,1,0.806,0.684,0.814,46
barrow,1.415,5,25,1,1,0.479,0.363,0.362,30
dazed,1.415,8,38,1,1,0.3,0.697,0.277,46
irreparable,1.415,5,25,1,1,0.061,0.53,0.43,30
abominable,1.415,5,25,1,1,0.12,0.731,0.482,30
metallic,1.415,5,25,1,1,0.615,0.33,0.607,30
retention,1.415,5,25,1,1,0.344,0.49,0.558,30
superiority,1.415,20,90,1,1,0.582,0.602,0.959,110
rainforest,1.415,5,25,1,1,0.612,0.375,0.398,30
birch,1.415,8,38,1,1,0.562,0.346,0.382,46
alternating,1.415,8,38,1,1,0.48,0.494,0.542,46
constrained,1.415,5,25,1,1,0.135,0.537,0.357,30
scarlet,1.412,28,125,1,1,0.507,0.39,0.411,153
adrift,1.411,39,173,1,1,0.398,0.486,0.23,212
eclipse,1.411,19,86,1,1,0.541,0.469,0.616,105
humankind,1.41,16,73,1,1,0.885,0.394,0.714,89
herbs,1.41,16,73,1,1,0.62,0.299,0.308,89
tower,1.41,109,478,1,1,0.606,0.38,0.644,587
openness,1.409,83,365,1,1,0.837,0.561,0.667,448
filth,1.408,57,252,1,1,0.194,0.592,0.319,309
composed,1.408,32,143,1,1,0.684,0.385,0.682,175
impatience,1.408,10,47,1,1,0.278,0.78,0.411,57
river,1.407,270,1182,1,1,0.688,0.392,0.605,1452
charm,1.407,70,309,1,1,0.833,0.363,0.649,379
inherent,1.407,29,130,1,1,0.562,0.439,0.48,159
succumb,1.407,37,165,1,1,0.202,0.787,0.292,202
fog,1.407,91,401,1,1,0.51,0.213,0.26,492
dimension,1.406,58,257,1,1,0.592,0.415,0.627,315
adjective,1.405,7,34,1,1,0.57,0.316,0.569,41
dissipate,1.405,7,34,1,1,0.385,0.368,0.355,41
chilly,1.405,31,139,1,1,0.329,0.459,0.408,170
makeshift,1.405,7,34,1,1,0.479,0.611,0.389,41
striped,1.405,7,34,1,1,0.344,0.373,0.385,41
lookout,1.405,15,69,1,1,0.698,0.538,0.639,84
symbol,1.404,70,310,1,1,0.643,0.388,0.527,380
habitat,1.404,20,91,1,1,0.633,0.343,0.553,111
chaotic,1.404,109,481,1,1,0.115,0.847,0.442,590
loner,1.404,693,3040,1,1,0.347,0.152,0.221,3733
overhead,1.402,17,78,1,1,0.344,0.7,0.538,95
mandatory,1.401,50,223,1,1,0.271,0.667,0.777,273
required,1.401,203,895,1,1,0.583,0.509,0.7,1098
fatherhood,1.4,4,21,1,1,0.885,0.519,0.682,25
spectacles,1.4,4,21,1,1,0.816,0.775,0.648,25
crafty,1.4,4,21,1,1,0.589,0.679,0.783,25
evaporate,1.4,4,21,1,1,0.357,0.469,0.402,25
conversationalist,1.4,4,21,1,1,0.719,0.467,0.667,25
encompass,1.4,4,21,1,1,0.52,0.298,0.661,25
courthouse,1.4,4,21,1,1,0.571,0.503,0.818,25
elemental,1.4,4,21,1,1,0.627,0.306,0.711,25
rabble,1.4,4,21,1,1,0.184,0.602,0.292,25
fallow,1.4,4,21,1,1,0.375,0.368,0.464,25
stripe,1.4,4,21,1,1,0.629,0.302,0.361,25
invulnerable,1.4,4,21,1,1,0.552,0.683,0.745,25
brim,1.4,9,43,1,1,0.469,0.333,0.33,52
peninsula,1.4,4,21,1,1,0.551,0.384,0.627,25
premonition,1.4,4,21,1,1,0.365,0.765,0.544,25
marketplace,1.4,9,43,1,1,0.698,0.42,0.525,52
softening,1.4,4,21,1,1,0.7,0.255,0.361,25
slaughtering,1.4,4,21,1,1,0.133,0.947,0.714,25
gatekeeper,1.4,4,21,1,1,0.51,0.49,0.598,25
evasive,1.4,4,21,1,1,0.117,0.596,0.425,25
prism,1.4,4,21,1,1,0.52,0.429,0.343,25
inheritance,1.4,14,65,1,1,0.9,0.565,0.798,79
feud,1.4,9,43,1,1,0.146,0.796,0.312,52
wounded,1.4,64,285,1,1,0.115,0.77,0.275,349
superfluous,1.4,4,21,1,1,0.316,0.469,0.393,25
prying,1.397,16,74,1,1,0.385,0.647,0.547,90
snow,1.397,402,1777,1,1,0.667,0.363,0.309,2179
numbness,1.396,28,127,1,1,0.306,0.398,0.265,155
molded,1.396,11,52,1,1,0.667,0.361,0.373,63
pulp,1.396,11,52,1,1,0.469,0.231,0.324,63
snug,1.396,11,52,1,1,0.867,0.173,0.5,63
undoing,1.396,11,52,1,1,0.219,0.452,0.298,63
itch,1.395,37,167,1,1,0.319,0.61,0.465,204
wild,1.395,767,3395,1,1,0.312,0.922,0.75,4162
unequal,1.393,6,30,1,1,0.118,0.433,0.202,36
primordial,1.393,6,30,1,1,0.625,0.569,0.771,36
cohesive,1.393,6,30,1,1,0.531,0.47,0.603,36
thoughtfulness,1.393,6,30,1,1,0.867,0.269,0.667,36
formulate,1.393,6,30,1,1,0.851,0.456,0.673,36
lustful,1.393,6,30,1,1,0.427,0.896,0.643,36
sunburn,1.393,6,30,1,1,0.061,0.755,0.447,36
projector,1.393,6,30,1,1,0.573,0.491,0.711,36
acquisition,1.393,6,30,1,1,0.698,0.509,0.736,36
cameraman,1.393,6,30,1,1,0.542,0.452,0.542,36
dell,1.393,6,30,1,1,0.458,0.38,0.453,36
reserve,1.392,50,225,1,1,0.585,0.289,0.589,275
exchange,1.392,160,713,1,1,0.74,0.569,0.491,873
magic,1.391,550,2444,1,1,0.868,0.663,0.578,2994
tourism,1.391,15,70,1,1,0.823,0.531,0.545,85
protagonist,1.391,31,141,1,1,0.765,0.704,0.877,172
muddy,1.391,15,70,1,1,0.292,0.4,0.283,85
porno,1.391,15,70,1,1,0.302,0.923,0.519,85
artistic,1.391,56,252,1,1,0.802,0.646,0.632,308
observing,1.391,65,292,1,1,0.583,0.4,0.685,357
wizard,1.39,42,190,1,1,0.656,0.43,0.526,232
stifled,1.39,8,39,1,1,0.229,0.731,0.193,47
racket,1.39,8,39,1,1,0.52,0.356,0.352,47
breadth,1.387,10,48,1,1,0.667,0.49,0.644,58
cinematography,1.387,10,48,1,1,0.781,0.571,0.625,58
manhood,1.387,10,48,1,1,0.625,0.735,0.858,58
vast,1.386,232,1038,1,1,0.52,0.535,0.545,1270
absorbed,1.386,36,164,1,1,0.49,0.471,0.519,200
imposing,1.386,12,57,1,1,0.392,0.731,0.836,69
balanced,1.385,68,307,1,1,0.806,0.255,0.745,375
wind,1.385,532,2379,1,1,0.531,0.404,0.578,2911
dismal,1.385,14,66,1,1,0.194,0.45,0.192,80
hamlet,1.385,14,66,1,1,0.573,0.27,0.397,80
dispute,1.382,20,93,1,1,0.219,0.75,0.585,113
fiery,1.382,20,93,1,1,0.418,0.85,0.721,113
autobiography,1.382,20,93,1,1,0.735,0.284,0.629,113
necessities,1.382,22,102,1,1,0.52,0.63,0.463,124
enjoyment,1.381,84,380,1,1,0.93,0.612,0.716,464
synonymous,1.381,30,138,1,1,0.48,0.323,0.4,168
bitterness,1.38,65,295,1,1,0.115,0.633,0.27,360
obscure,1.38,38,174,1,1,0.37,0.551,0.278,212
spotlight,1.379,95,430,1,1,0.688,0.353,0.519,525
domain,1.377,25,116,1,1,0.573,0.549,0.828,141
psyche,1.377,41,188,1,1,0.427,0.375,0.435,229
cusp,1.377,9,44,1,1,0.667,0.71,0.7,53
blurred,1.377,19,89,1,1,0.32,0.367,0.231,108
undead,1.377,13,62,1,1,0.367,0.635,0.406,75
depict,1.377,11,53,1,1,0.663,0.529,0.723,64
famously,1.377,9,44,1,1,0.856,0.765,0.787,53
improbable,1.377,5,26,1,1,0.097,0.412,0.439,31
cholesterol,1.377,5,26,1,1,0.198,0.583,0.398,31
assembled,1.377,9,44,1,1,0.663,0.45,0.644,53
discontent,1.377,13,62,1,1,0.24,0.53,0.263,75
chaplain,1.377,7,35,1,1,0.582,0.37,0.577,42
throes,1.377,5,26,1,1,0.146,0.76,0.235,31
inquire,1.377,7,35,1,1,0.583,0.519,0.363,42
smokey,1.377,7,35,1,1,0.494,0.462,0.43,42
horizontal,1.377,7,35,1,1,0.573,0.304,0.387,42
specie,1.377,5,26,1,1,0.583,0.471,0.65,31
verily,1.377,9,44,1,1,0.713,0.351,0.585,53
propensity,1.377,5,26,1,1,0.521,0.462,0.66,31
unfeeling,1.377,7,35,1,1,0.235,0.377,0.345,42
fictitious,1.377,5,26,1,1,0.224,0.444,0.293,31
inclination,1.377,13,62,1,1,0.378,0.49,0.538,75
absorbing,1.377,19,89,1,1,0.49,0.49,0.578,108
marked,1.377,47,215,1,1,0.592,0.358,0.554,262
stronghold,1.377,9,44,1,1,0.708,0.636,0.954,53
decree,1.377,5,26,1,1,0.552,0.478,0.746,31
runway,1.377,11,53,1,1,0.585,0.373,0.406,64
forty,1.373,28,130,1,1,0.458,0.367,0.482,158
guild,1.373,28,130,1,1,0.58,0.459,0.729,158
farm,1.373,178,808,1,1,0.781,0.327,0.297,986
blinding,1.372,22,103,1,1,0.304,0.596,0.406,125
havoc,1.372,22,103,1,1,0.163,0.769,0.535,125
gateway,1.372,20,94,1,1,0.592,0.376,0.529,114
book,1.372,2469,11175,1,1,0.802,0.21,0.606,13644
feline,1.371,18,85,1,1,0.615,0.745,0.509,103
dignified,1.37,14,67,1,1,0.766,0.481,0.635,81
lingering,1.369,55,253,1,1,0.63,0.643,0.667,308
petite,1.369,12,58,1,1,0.51,0.354,0.245,70
bourbon,1.369,25,117,1,1,0.602,0.49,0.517,142
innocence,1.368,75,344,1,1,0.802,0.26,0.307,419
task,1.368,209,953,1,1,0.55,0.353,0.5,1162
uncharted,1.367,10,49,1,1,0.188,0.406,0.413,59
vibration,1.367,21,99,1,1,0.583,0.657,0.528,120
departed,1.367,21,99,1,1,0.245,0.536,0.391,120
cardinal,1.366,19,90,1,1,0.583,0.358,0.712,109
rags,1.365,8,40,1,1,0.434,0.309,0.198,48
ghastly,1.365,8,40,1,1,0.125,0.79,0.472,48
ferocious,1.365,8,40,1,1,0.167,0.915,0.776,48
timeout,1.365,8,40,1,1,0.344,0.433,0.322,48
audible,1.365,26,122,1,1,0.673,0.37,0.462,148
archangel,1.365,8,40,1,1,0.837,0.5,0.708,48
garden,1.364,312,1426,1,1,0.77,0.23,0.456,1738
orchestra,1.364,24,113,1,1,0.708,0.5,0.664,137
gravity,1.362,50,232,1,1,0.51,0.635,0.538,282
cherish,1.362,366,1676,1,1,0.896,0.491,0.652,2042
quarrel,1.361,6,31,1,1,0.112,0.929,0.496,37
roadside,1.361,6,31,1,1,0.5,0.569,0.472,37
timeless,1.361,27,127,1,1,0.408,0.468,0.583,154
defect,1.361,13,63,1,1,0.135,0.561,0.185,76
inventor,1.361,6,31,1,1,0.781,0.667,0.847,37
cultured,1.361,6,31,1,1,0.635,0.429,0.625,37
hoarse,1.361,6,31,1,1,0.281,0.402,0.315,37
plop,1.361,6,31,1,1,0.385,0.475,0.349,37
subversive,1.361,6,31,1,1,0.198,0.765,0.5,37
vigilante,1.361,6,31,1,1,0.418,0.627,0.72,37
inertia,1.361,6,31,1,1,0.344,0.288,0.322,37
dew,1.36,18,86,1,1,0.604,0.225,0.464,104
extravagant,1.359,11,54,1,1,0.72,0.763,0.812,65
tempered,1.359,11,54,1,1,0.583,0.437,0.667,65
refresh,1.358,52,242,1,1,0.719,0.64,0.689,294
gazing,1.358,40,187,1,1,0.677,0.413,0.362,227
sorely,1.358,16,77,1,1,0.284,0.727,0.37,93
dependence,1.357,21,100,1,1,0.25,0.451,0.433,121
heed,1.356,31,146,1,1,0.75,0.49,0.569,177
racer,1.355,4,22,1,1,0.48,0.631,0.678,26
keg,1.355,4,22,1,1,0.551,0.389,0.404,26
narrowing,1.355,4,22,1,1,0.354,0.593,0.357,26
inference,1.355,4,22,1,1,0.359,0.479,0.398,26
pessimism,1.355,9,45,1,1,0.083,0.484,0.264,54
prompting,1.355,4,22,1,1,0.587,0.423,0.571,26
fiend,1.355,9,45,1,1,0.146,0.903,0.608,54
tripod,1.355,4,22,1,1,0.406,0.388,0.483,26
unyielding,1.355,4,22,1,1,0.367,0.806,0.738,26
dunce,1.355,4,22,1,1,0.188,0.327,0.146,26
sensory,1.355,44,206,1,1,0.583,0.48,0.442,250
retiring,1.355,19,91,1,1,0.408,0.376,0.214,110
crossover,1.355,19,91,1,1,0.559,0.55,0.5,110
rascal,1.355,4,22,1,1,0.169,0.706,0.445,26
artifact,1.355,4,22,1,1,0.51,0.5,0.566,26
burglary,1.355,4,22,1,1,0.146,0.918,0.543,26
heighten,1.355,4,22,1,1,0.755,0.622,0.765,26
cannibalism,1.355,4,22,1,1,0.094,0.89,0.583,26
decayed,1.355,4,22,1,1,0.017,0.375,0.169,26
devote,1.354,27,128,1,1,0.802,0.49,0.642,155
discover,1.353,424,1958,1,1,0.771,0.793,0.673,2382
heritage,1.353,40,188,1,1,0.842,0.512,0.815,228
earthly,1.352,30,142,1,1,0.625,0.318,0.518,172
peasant,1.352,12,59,1,1,0.53,0.275,0.407,71
empathic,1.352,12,59,1,1,0.76,0.57,0.558,71
flexibility,1.352,12,59,1,1,0.867,0.402,0.472,71
order,1.352,1469,6784,1,1,0.78,0.295,0.814,8253
strengthening,1.351,20,96,1,1,0.913,0.627,0.945,116
pond,1.351,57,267,1,1,0.52,0.337,0.358,324
masses,1.35,81,378,1,1,0.552,0.453,0.473,459
array,1.35,15,73,1,1,0.521,0.396,0.568,88
sturdy,1.35,7,36,1,1,0.58,0.642,0.824,43
catalogue,1.35,7,36,1,1,0.647,0.327,0.533,43
prevailing,1.35,7,36,1,1,0.798,0.708,0.864,43
groovy,1.35,7,36,1,1,0.615,0.538,0.464,43
offering,1.348,195,907,1,1,0.688,0.462,0.585,1102
dangerously,1.348,29,138,1,1,0.082,0.93,0.564,167
fruition,1.347,10,50,1,1,0.776,0.567,0.664,60
elation,1.347,10,50,1,1,0.74,0.853,0.623,60
expand,1.347,57,268,1,1,0.792,0.559,0.686,325
subconscious,1.346,49,231,1,1,0.531,0.375,0.415,280
museum,1.346,74,347,1,1,0.792,0.206,0.481,421
gaze,1.346,130,607,1,1,0.633,0.588,0.586,737
reconciliation,1.346,13,64,1,1,0.896,0.57,0.604,77
courtesy,1.346,55,259,1,1,0.927,0.287,0.431,314
stimulate,1.346,13,64,1,1,0.792,0.798,0.754,77
silhouette,1.346,27,129,1,1,0.582,0.41,0.288,156
quest,1.344,143,669,1,1,0.643,0.716,0.545,812
cozy,1.344,100,469,1,1,0.91,0.356,0.545,569
tactile,1.341,5,27,1,1,0.573,0.41,0.491,32
clasp,1.341,5,27,1,1,0.448,0.375,0.241,32
delirium,1.341,5,27,1,1,0.233,0.694,0.484,32
technological,1.341,11,55,1,1,0.68,0.452,0.815,66
derive,1.341,14,69,1,1,0.396,0.324,0.36,83
checkmate,1.341,5,27,1,1,0.667,0.708,0.75,32
tailor,1.341,8,41,1,1,0.573,0.206,0.45,49
visionary,1.341,14,69,1,1,0.823,0.565,0.791,83
toughness,1.341,8,41,1,1,0.552,0.618,0.837,49
ardent,1.341,8,41,1,1,0.694,0.873,0.722,49
sand,1.338,151,710,1,1,0.582,0.279,0.304,861
latte,1.338,21,102,1,1,0.615,0.32,0.311,123
reward,1.337,125,589,1,1,0.948,0.694,0.783,714
pacific,1.337,34,163,1,1,0.627,0.118,0.58,197
dive,1.336,98,463,1,1,0.583,0.531,0.5,561
jewel,1.336,15,74,1,1,0.827,0.588,0.625,89
jazz,1.336,76,360,1,1,0.677,0.362,0.45,436
candles,1.336,102,482,1,1,0.615,0.206,0.268,584
endless,1.334,332,1563,1,1,0.347,0.462,0.472,1895
lieu,1.334,9,46,1,1,0.427,0.41,0.312,55
intellect,1.333,36,173,1,1,0.844,0.418,0.87,209
cemetery,1.333,43,206,1,1,0.051,0.63,0.417,249
preference,1.333,104,493,1,1,0.792,0.5,0.72,597
paramount,1.332,16,79,1,1,0.771,0.615,0.902,95
sensual,1.332,16,79,1,1,0.73,0.79,0.642,95
meek,1.332,16,79,1,1,0.531,0.15,0.198,95
sincere,1.332,159,752,1,1,0.918,0.265,0.725,911
perseverance,1.332,40,192,1,1,0.888,0.63,0.796,232
bolster,1.331,6,32,1,1,0.708,0.471,0.569,38
archbishop,1.331,6,32,1,1,0.622,0.28,0.776,38
crammed,1.331,6,32,1,1,0.406,0.74,0.466,38
hex,1.331,6,32,1,1,0.41,0.51,0.363,38
shyness,1.331,27,131,1,1,0.312,0.265,0.246,158
vocalist,1.331,13,65,1,1,0.688,0.596,0.596,78
policeman,1.331,6,32,1,1,0.542,0.708,0.898,38
pounding,1.329,42,202,1,1,0.333,0.843,0.731,244
master,1.329,368,1742,1,1,0.694,0.49,0.849,2110
ecstatic,1.329,28,136,1,1,0.875,0.769,0.742,164
prod,1.328,10,51,1,1,0.48,0.479,0.426,61
sterile,1.328,10,51,1,1,0.302,0.471,0.291,61
buildings,1.328,54,259,1,1,0.582,0.38,0.552,313
complexity,1.327,25,122,1,1,0.479,0.62,0.595,147
port,1.327,40,193,1,1,0.55,0.409,0.513,233
adverse,1.327,14,70,1,1,0.323,0.61,0.385,84
idle,1.326,52,250,1,1,0.179,0.167,0.112,302
grand,1.326,232,1103,1,1,0.898,0.74,0.888,1335
tasting,1.325,22,108,1,1,0.781,0.603,0.6,130
powder,1.325,26,127,1,1,0.521,0.25,0.194,153
accustomed,1.325,134,639,1,1,0.542,0.365,0.441,773
beginnings,1.325,34,165,1,1,0.837,0.527,0.6,199
sanity,1.324,270,1285,1,1,0.667,0.333,0.655,1555
escaped,1.324,74,355,1,1,0.365,0.755,0.518,429
nihilism,1.323,11,56,1,1,0.367,0.51,0.364,67
beverage,1.323,19,94,1,1,0.635,0.49,0.389,113
twain,1.323,7,37,1,1,0.541,0.255,0.37,44
inclined,1.323,39,189,1,1,0.469,0.347,0.402,228
envision,1.323,19,94,1,1,0.625,0.449,0.483,113
cyclical,1.323,7,37,1,1,0.38,0.45,0.554,44
budding,1.323,7,37,1,1,0.49,0.5,0.355,44
brilliance,1.323,19,94,1,1,0.99,0.673,0.83,113
invade,1.321,49,237,1,1,0.408,0.892,0.714,286
itching,1.321,20,99,1,1,0.208,0.69,0.3,119
residency,1.321,20,99,1,1,0.694,0.357,0.679,119
woods,1.319,622,2969,1,1,0.594,0.269,0.364,3591
habitual,1.319,12,61,1,1,0.527,0.208,0.49,73
inter,1.319,12,61,1,1,0.51,0.375,0.466,73
falsehood,1.319,12,61,1,1,0.031,0.625,0.384,73
photographer,1.318,43,209,1,1,0.714,0.481,0.562,252
lonesome,1.318,153,734,1,1,0.281,0.213,0.336,887
frantic,1.317,17,85,1,1,0.21,0.89,0.627,102
mistrust,1.317,8,42,1,1,0.135,0.657,0.231,50
characteristic,1.317,8,42,1,1,0.583,0.328,0.538,50
weeping,1.317,58,281,1,1,0.082,0.688,0.168,339
opera,1.316,36,176,1,1,0.714,0.5,0.483,212
transform,1.316,50,243,1,1,0.735,0.667,0.696,293
roads,1.316,134,645,1,1,0.677,0.448,0.496,779
frenzy,1.316,13,66,1,1,0.61,0.965,0.682,79
quietly,1.315,308,1478,1,1,0.561,0.125,0.321,1786
covert,1.313,9,47,1,1,0.5,0.57,0.508,56
jumble,1.313,4,23,1,1,0.357,0.613,0.331,27
pottery,1.313,4,23,1,1,0.594,0.286,0.422,27
combative,1.313,4,23,1,1,0.381,0.69,0.816,27
meticulous,1.313,4,23,1,1,0.555,0.48,0.555,27
convict,1.313,9,47,1,1,0.177,0.84,0.477,56
planetary,1.313,9,47,1,1,0.604,0.5,0.62,56
formation,1.313,19,95,1,1,0.615,0.453,0.731,114
forte,1.313,14,71,1,1,0.829,0.737,0.8,85
fable,1.313,4,23,1,1,0.663,0.387,0.389,27
indignation,1.313,9,47,1,1,0.173,0.778,0.431,56
provoking,1.313,19,95,1,1,0.338,0.92,0.717,114
actionable,1.313,4,23,1,1,0.673,0.702,0.613,27
instinctive,1.313,4,23,1,1,0.752,0.575,0.694,27
astronomy,1.313,9,47,1,1,0.613,0.474,0.722,56
unquestionably,1.313,4,23,1,1,0.5,0.63,0.75,27
proceeding,1.313,9,47,1,1,0.688,0.428,0.753,56
computing,1.313,4,23,1,1,0.745,0.398,0.695,27
mocha,1.313,9,47,1,1,0.5,0.396,0.311,56
mammoth,1.313,4,23,1,1,0.48,0.471,0.537,27
stampede,1.313,4,23,1,1,0.235,0.875,0.683,27
satisfaction,1.312,110,532,1,1,0.939,0.637,0.673,642
sauna,1.311,20,100,1,1,0.781,0.35,0.455,120
wasteland,1.31,36,177,1,1,0.365,0.308,0.391,213
value,1.31,997,4803,1,1,0.875,0.582,0.802,5800
abundant,1.309,26,129,1,1,0.958,0.59,0.76,155
parting,1.309,21,105,1,1,0.26,0.542,0.353,126
peppermint,1.309,10,52,1,1,0.72,0.264,0.271,62
intermittent,1.309,10,52,1,1,0.337,0.565,0.436,62
eternity,1.308,234,1132,1,1,0.765,0.52,0.911,1366
sentimental,1.308,44,216,1,1,0.583,0.378,0.312,260
sans,1.308,44,216,1,1,0.459,0.294,0.246,260
sophisticated,1.308,16,81,1,1,0.865,0.481,0.845,97
gratification,1.308,16,81,1,1,0.867,0.643,0.755,97
delicate,1.307,45,221,1,1,0.583,0.294,0.366,266
senses,1.306,106,516,1,1,0.74,0.461,0.693,622
outrun,1.306,5,28,1,1,0.531,0.833,0.573,33
pallet,1.306,5,28,1,1,0.604,0.241,0.349,33
coax,1.306,5,28,1,1,0.367,0.4,0.447,33
inexpensive,1.306,5,28,1,1,0.694,0.414,0.26,33
fanfare,1.306,5,28,1,1,0.656,0.64,0.437,33
predisposed,1.306,5,28,1,1,0.531,0.571,0.483,33
smoky,1.306,5,28,1,1,0.459,0.42,0.327,33
rung,1.306,5,28,1,1,0.51,0.355,0.368,33
fowl,1.306,5,28,1,1,0.51,0.388,0.364,33
rowdy,1.306,11,57,1,1,0.255,0.9,0.518,68
adjacent,1.306,11,57,1,1,0.645,0.276,0.536,68
materials,1.305,30,149,1,1,0.633,0.361,0.473,179
primal,1.304,24,120,1,1,0.55,0.407,0.482,144
purgatory,1.304,24,120,1,1,0.255,0.705,0.413,144
lifetime,1.303,365,1773,1,1,0.816,0.559,0.736,2138
paradox,1.301,47,232,1,1,0.417,0.442,0.482,279
merciless,1.301,6,33,1,1,0.062,0.88,0.634,39
enclosure,1.301,6,33,1,1,0.417,0.375,0.49,39
sprout,1.301,6,33,1,1,0.582,0.565,0.443,39
loon,1.301,13,67,1,1,0.429,0.392,0.325,80
motorbike,1.301,6,33,1,1,0.552,0.608,0.616,39
gourmet,1.301,6,33,1,1,0.911,0.387,0.562,39
pulpit,1.301,6,33,1,1,0.469,0.449,0.517,39
illustration,1.301,20,101,1,1,0.74,0.441,0.64,121
outgrow,1.301,13,67,1,1,0.51,0.529,0.722,80
insomniac,1.301,13,67,1,1,0.231,0.367,0.329,80
swig,1.301,6,33,1,1,0.604,0.481,0.406,39
vibrant,1.3,28,140,1,1,0.771,0.824,0.782,168
occasionally,1.299,201,982,1,1,0.538,0.24,0.264,1183
framework,1.299,14,72,1,1,0.459,0.33,0.36,86
sermon,1.299,29,145,1,1,0.417,0.507,0.615,174
gardener,1.297,7,38,1,1,0.673,0.346,0.361,45
referee,1.297,7,38,1,1,0.531,0.644,0.778,45
expressive,1.297,15,77,1,1,0.755,0.724,0.685,92
herd,1.297,63,311,1,1,0.592,0.5,0.474,374
critter,1.297,7,38,1,1,0.542,0.539,0.482,45
interstellar,1.297,7,38,1,1,0.708,0.702,0.622,45
flimsy,1.297,7,38,1,1,0.302,0.396,0.189,45
reciprocity,1.297,7,38,1,1,0.74,0.673,0.556,45
rehearse,1.297,7,38,1,1,0.588,0.622,0.5,45
fits,1.295,159,781,1,1,0.571,0.363,0.58,940
vermin,1.294,8,43,1,1,0.167,0.712,0.385,51
fixation,1.294,8,43,1,1,0.562,0.459,0.655,51
beagle,1.294,8,43,1,1,0.649,0.47,0.395,51
coy,1.294,8,43,1,1,0.347,0.33,0.213,51
fascinating,1.294,90,444,1,1,0.979,0.817,0.784,534
shore,1.294,109,537,1,1,0.542,0.304,0.204,646
caravan,1.293,27,136,1,1,0.635,0.559,0.455,163
interaction,1.293,520,2549,1,1,0.646,0.735,0.75,3069
werewolf,1.293,18,92,1,1,0.235,0.811,0.591,110
indie,1.292,59,293,1,1,0.479,0.368,0.43,352
salted,1.292,9,48,1,1,0.333,0.4,0.304,57
pierce,1.292,29,146,1,1,0.365,0.67,0.611,175
galactic,1.292,9,48,1,1,0.656,0.67,0.776,57
grunt,1.292,9,48,1,1,0.286,0.798,0.392,57
gravitate,1.291,20,102,1,1,0.479,0.472,0.476,122
nigh,1.291,20,102,1,1,0.653,0.216,0.336,122
disturbance,1.289,22,112,1,1,0.146,0.907,0.404,134
disguised,1.289,22,112,1,1,0.5,0.615,0.326,134
northern,1.289,69,343,1,1,0.57,0.34,0.472,412
golden,1.289,225,1110,1,1,0.802,0.491,0.609,1335
imitate,1.289,11,58,1,1,0.469,0.561,0.336,69
flora,1.289,11,58,1,1,0.833,0.324,0.567,69
emerald,1.289,11,58,1,1,0.74,0.363,0.726,69
territorial,1.289,11,58,1,1,0.405,0.6,0.766,69
shades,1.288,48,240,1,1,0.49,0.3,0.38,288
paradigm,1.287,12,63,1,1,0.573,0.429,0.779,75
singularity,1.287,25,127,1,1,0.582,0.348,0.654,152
inhabit,1.287,12,63,1,1,0.656,0.378,0.556,75
seldom,1.286,41,206,1,1,0.323,0.379,0.287,247
counterpart,1.285,14,73,1,1,0.448,0.608,0.577,87
modern,1.285,233,1154,1,1,0.855,0.423,0.691,1387
dogma,1.284,15,78,1,1,0.53,0.46,0.719,93
wheat,1.284,16,83,1,1,0.531,0.185,0.25,99
emperor,1.283,34,172,1,1,0.651,0.704,0.962,206
solid,1.283,353,1749,1,1,0.667,0.304,0.763,2102
atone,1.283,17,88,1,1,0.418,0.673,0.411,105
unspoken,1.283,35,177,1,1,0.177,0.26,0.208,212
composure,1.283,17,88,1,1,0.802,0.354,0.717,105
dominance,1.282,18,93,1,1,0.542,0.775,0.839,111
namaste,1.282,19,98,1,1,0.719,0.255,0.464,117
craft,1.282,79,395,1,1,0.76,0.321,0.539,474
gift,1.282,747,3702,1,1,0.88,0.539,0.483,4449
bleak,1.281,65,326,1,1,0.204,0.427,0.272,391
excellence,1.281,21,108,1,1,0.958,0.62,0.907,129
patio,1.281,21,108,1,1,0.562,0.245,0.402,129
starlight,1.28,23,118,1,1,0.908,0.368,0.611,141
revive,1.28,24,123,1,1,0.676,0.78,0.778,147
armor,1.278,59,297,1,1,0.469,0.625,0.784,356
graveyard,1.278,32,163,1,1,0.041,0.441,0.272,195
equate,1.275,63,318,1,1,0.724,0.382,0.624,381
masterpiece,1.273,125,628,1,1,0.926,0.623,0.847,753
metal,1.273,136,683,1,1,0.551,0.429,0.547,819
blazing,1.272,13,69,1,1,0.594,0.896,0.735,82
friction,1.272,7,39,1,1,0.271,0.778,0.534,46
installation,1.272,8,44,1,1,0.656,0.469,0.759,52
precipice,1.272,5,29,1,1,0.198,0.784,0.396,34
repression,1.272,7,39,1,1,0.214,0.764,0.481,46
sprinkle,1.272,10,54,1,1,0.635,0.404,0.38,64
crease,1.272,4,24,1,1,0.44,0.286,0.3,28
permitted,1.272,18,94,1,1,0.865,0.41,0.613,112
artistry,1.272,8,44,1,1,0.823,0.346,0.769,52
heir,1.272,14,74,1,1,0.84,0.654,0.764,88
resounding,1.272,7,39,1,1,0.49,0.708,0.596,46
foggy,1.272,23,119,1,1,0.354,0.337,0.302,142
flapping,1.272,5,29,1,1,0.458,0.728,0.404,34
wring,1.272,4,24,1,1,0.36,0.656,0.348,28
conversational,1.272,7,39,1,1,0.719,0.431,0.596,46
esteemed,1.272,5,29,1,1,0.694,0.418,0.531,34
incarceration,1.272,11,59,1,1,0.1,0.8,0.397,70
mastermind,1.272,6,34,1,1,0.792,0.625,0.918,40
simultaneous,1.272,6,34,1,1,0.691,0.577,0.554,40
maligned,1.272,4,24,1,1,0.102,0.684,0.218,28
normality,1.272,12,64,1,1,0.781,0.089,0.444,76
distinguished,1.272,9,49,1,1,0.823,0.593,0.759,58
cigar,1.272,17,89,1,1,0.306,0.463,0.346,106
weeds,1.272,15,79,1,1,0.32,0.551,0.315,94
quarterly,1.272,5,29,1,1,0.604,0.38,0.448,34
sharp,1.272,98,494,1,1,0.459,0.585,0.585,592
geometry,1.272,4,24,1,1,0.49,0.27,0.537,28
seamless,1.272,4,24,1,1,0.459,0.14,0.302,28
acutely,1.272,10,54,1,1,0.417,0.543,0.491,64
intimately,1.272,19,99,1,1,0.806,0.573,0.59,118
sultan,1.272,4,24,1,1,0.529,0.423,0.821,28
inverse,1.272,4,24,1,1,0.459,0.337,0.319,28
sixty,1.272,9,49,1,1,0.694,0.24,0.433,58
unbecoming,1.272,4,24,1,1,0.123,0.471,0.288,28
womanhood,1.272,8,44,1,1,0.812,0.656,0.602,52
scanner,1.272,4,24,1,1,0.531,0.356,0.567,28
reviewer,1.272,6,34,1,1,0.562,0.344,0.5,40
biologist,1.272,5,29,1,1,0.625,0.453,0.693,34
insular,1.272,5,29,1,1,0.531,0.426,0.465,34
integration,1.272,14,74,1,1,0.771,0.48,0.737,88
succubus,1.272,5,29,1,1,0.417,0.647,0.509,34
hostess,1.272,6,34,1,1,0.792,0.604,0.688,40
humanoid,1.272,5,29,1,1,0.521,0.462,0.491,34
orderly,1.272,4,24,1,1,0.844,0.24,0.661,28
projectile,1.272,4,24,1,1,0.276,0.865,0.774,28
curt,1.272,5,29,1,1,0.245,0.61,0.452,34
grouping,1.272,7,39,1,1,0.745,0.58,0.698,46
windowsill,1.272,4,24,1,1,0.429,0.274,0.433,28
oxymoron,1.272,8,44,1,1,0.427,0.481,0.398,52
affiliated,1.272,9,49,1,1,0.673,0.519,0.535,58
vane,1.272,4,24,1,1,0.561,0.28,0.231,28
phantom,1.267,41,210,1,1,0.26,0.759,0.448,251
tortured,1.266,73,371,1,1,0.062,0.89,0.361,444
ministry,1.266,71,361,1,1,0.51,0.346,0.717,432
remainder,1.266,34,175,1,1,0.398,0.357,0.324,209
slice,1.265,57,291,1,1,0.583,0.375,0.303,348
sparkling,1.265,27,140,1,1,0.7,0.418,0.598,167
attachment,1.263,88,448,1,1,0.57,0.343,0.5,536
creation,1.262,163,827,1,1,0.927,0.575,0.868,990
soothing,1.262,135,686,1,1,0.625,0.179,0.519,821
cider,1.261,18,95,1,1,0.53,0.346,0.398,113
corps,1.261,17,90,1,1,0.551,0.453,0.483,107
wallow,1.261,53,272,1,1,0.286,0.878,0.491,325
camaraderie,1.261,17,90,1,1,0.833,0.51,0.648,107
seek,1.26,1410,7137,1,1,0.622,0.429,0.482,8547
summit,1.259,29,151,1,1,0.625,0.618,0.764,180
moonlight,1.258,73,374,1,1,0.865,0.264,0.409,447
published,1.258,85,435,1,1,0.667,0.429,0.57,520
regulate,1.256,12,65,1,1,0.51,0.275,0.481,77
overload,1.256,37,192,1,1,0.381,0.69,0.652,229
grant,1.255,120,614,1,1,0.719,0.38,0.667,734
mimic,1.255,11,60,1,1,0.557,0.587,0.391,71
imam,1.255,35,182,1,1,0.527,0.337,0.539,217
breeze,1.255,214,1092,1,1,0.837,0.284,0.37,1306
charmed,1.254,10,55,1,1,0.938,0.57,0.769,65
anthology,1.254,10,55,1,1,0.338,0.406,0.537,65
slender,1.254,10,55,1,1,0.812,0.548,0.664,65
aesthetic,1.252,60,310,1,1,0.708,0.442,0.526,370
willful,1.252,9,50,1,1,0.557,0.719,0.642,59
frontier,1.252,9,50,1,1,0.438,0.55,0.65,59
coven,1.252,9,50,1,1,0.458,0.578,0.591,59
incomparable,1.252,9,50,1,1,0.625,0.577,0.67,59
silent,1.252,927,4732,1,1,0.469,0.125,0.28,5659
healer,1.251,47,244,1,1,0.863,0.378,0.741,291
cease,1.251,55,285,1,1,0.388,0.25,0.42,340
hindrance,1.25,8,45,1,1,0.135,0.545,0.473,53
blending,1.25,8,45,1,1,0.56,0.418,0.637,53
battered,1.25,17,91,1,1,0.08,0.79,0.306,108
beaming,1.25,8,45,1,1,0.892,0.654,0.587,53
prodigy,1.25,8,45,1,1,0.812,0.704,0.824,53
tendency,1.249,70,362,1,1,0.684,0.5,0.675,432
flow,1.249,211,1083,1,1,0.696,0.316,0.464,1294
amateur,1.248,16,86,1,1,0.469,0.5,0.409,102
fame,1.248,147,757,1,1,0.896,0.755,0.852,904
gradual,1.247,7,40,1,1,0.571,0.35,0.509,47
barring,1.247,7,40,1,1,0.292,0.67,0.42,47
coral,1.247,7,40,1,1,0.802,0.231,0.425,47
emulate,1.247,7,40,1,1,0.438,0.34,0.549,47
courteous,1.247,7,40,1,1,0.937,0.396,0.529,47
flask,1.247,7,40,1,1,0.418,0.412,0.454,47
vengeance,1.247,31,163,1,1,0.103,0.927,0.719,194
unsuspecting,1.247,7,40,1,1,0.302,0.509,0.413,47
preparation,1.247,39,204,1,1,0.771,0.5,0.679,243
surface,1.247,134,691,1,1,0.448,0.375,0.604,825
mellow,1.246,22,117,1,1,0.633,0.069,0.265,139
hardened,1.245,14,76,1,1,0.406,0.618,0.764,90
thrust,1.245,14,76,1,1,0.51,0.647,0.663,90
enter,1.245,311,1601,1,1,0.708,0.47,0.5,1912
electronic,1.245,28,148,1,1,0.571,0.49,0.704,176
practitioner,1.244,6,35,1,1,0.704,0.497,0.684,41
coarse,1.244,6,35,1,1,0.333,0.481,0.481,41
thud,1.244,6,35,1,1,0.255,0.686,0.62,41
disruption,1.244,13,71,1,1,0.235,0.735,0.436,84
explore,1.244,237,1223,1,1,0.776,0.66,0.727,1460
residual,1.244,6,35,1,1,0.448,0.288,0.327,41
jolt,1.244,6,35,1,1,0.365,0.708,0.358,41
prog,1.244,6,35,1,1,0.448,0.412,0.397,41
linger,1.243,40,210,1,1,0.48,0.311,0.412,250
homeland,1.242,19,102,1,1,0.663,0.439,0.868,121
distraction,1.242,201,1040,1,1,0.402,0.557,0.39,1241
crude,1.241,12,66,1,1,0.198,0.402,0.357,78
dichotomy,1.241,12,66,1,1,0.323,0.482,0.483,78
novelty,1.241,12,66,1,1,0.673,0.521,0.74,78
hippie,1.241,12,66,1,1,0.551,0.4,0.396,78
commute,1.241,63,329,1,1,0.622,0.582,0.565,392
input,1.24,62,324,1,1,0.643,0.337,0.527,386
society,1.24,1124,5803,1,1,0.674,0.464,0.782,6927
completed,1.24,80,417,1,1,0.823,0.357,0.777,497
methodology,1.239,5,30,1,1,0.664,0.327,0.745,35
unavoidable,1.239,17,92,1,1,0.35,0.58,0.445,109
bog,1.239,11,61,1,1,0.302,0.361,0.365,72
negotiable,1.239,5,30,1,1,0.688,0.585,0.731,35
sighting,1.239,5,30,1,1,0.582,0.56,0.627,35
avalanche,1.239,11,61,1,1,0.265,0.915,0.683,72
bathing,1.239,23,123,1,1,0.74,0.276,0.361,146
wandering,1.239,149,774,1,1,0.323,0.471,0.357,923
instrument,1.239,29,154,1,1,0.562,0.537,0.655,183
crow,1.239,29,154,1,1,0.224,0.439,0.363,183
bamboo,1.239,5,30,1,1,0.646,0.222,0.356,35
crafts,1.239,17,92,1,1,0.667,0.38,0.391,109
totality,1.239,5,30,1,1,0.688,0.443,0.717,35
trepidation,1.239,5,30,1,1,0.582,0.594,0.464,35
emphatic,1.239,5,30,1,1,0.615,0.707,0.732,35
youthful,1.239,11,61,1,1,0.827,0.48,0.686,72
debauchery,1.239,5,30,1,1,0.354,0.901,0.5,35
soothe,1.238,34,180,1,1,0.817,0.194,0.412,214
striking,1.238,28,149,1,1,0.357,0.827,0.657,177
venture,1.237,56,294,1,1,0.893,0.81,0.644,350
valley,1.237,219,1138,1,1,0.729,0.306,0.386,1357
brainstorm,1.236,10,56,1,1,0.794,0.784,0.636,66
espresso,1.236,10,56,1,1,0.677,0.62,0.508,66
ordained,1.236,10,56,1,1,0.735,0.409,0.731,66
gulp,1.236,10,56,1,1,0.551,0.66,0.409,66
fresh,1.235,394,2047,1,1,0.908,0.292,0.419,2441
bowed,1.235,15,82,1,1,0.41,0.418,0.368,97
flutter,1.235,15,82,1,1,0.479,0.548,0.33,97
rightly,1.234,35,186,1,1,0.74,0.471,0.782,221
ocean,1.233,395,2057,1,1,0.823,0.308,0.642,2452
outlines,1.233,4,25,1,1,0.656,0.402,0.651,29
chaste,1.233,4,25,1,1,0.408,0.248,0.453,29
groggy,1.233,4,25,1,1,0.235,0.265,0.194,29
herald,1.233,4,25,1,1,0.643,0.382,0.5,29
nether,1.233,4,25,1,1,0.24,0.265,0.259,29
docile,1.233,4,25,1,1,0.604,0.259,0.264,29
amethyst,1.233,4,25,1,1,0.622,0.406,0.517,29
novice,1.233,4,25,1,1,0.429,0.346,0.18,29
transgression,1.233,4,25,1,1,0.158,0.89,0.611,29
liberate,1.233,9,51,1,1,0.76,0.632,0.708,60
badger,1.233,9,51,1,1,0.344,0.429,0.357,60
blight,1.233,4,25,1,1,0.271,0.771,0.429,29
blare,1.233,4,25,1,1,0.439,0.561,0.519,29
ineffectual,1.233,4,25,1,1,0.163,0.412,0.2,29
maggot,1.233,4,25,1,1,0.235,0.5,0.235,29
dove,1.231,33,176,1,1,0.729,0.235,0.437,209
element,1.23,60,317,1,1,0.531,0.259,0.481,377
noir,1.23,13,72,1,1,0.375,0.394,0.365,85
fond,1.229,82,432,1,1,0.885,0.602,0.518,514
bicycle,1.229,22,119,1,1,0.708,0.519,0.425,141
dazzling,1.228,8,46,1,1,0.854,0.88,0.767,54
experimental,1.228,8,46,1,1,0.417,0.764,0.396,54
unselfish,1.228,8,46,1,1,0.615,0.353,0.377,54
pure,1.228,640,3347,1,1,0.811,0.306,0.652,3987
joyful,1.227,65,344,1,1,0.99,0.74,0.667,409
converse,1.227,47,250,1,1,0.594,0.406,0.598,297
unspeakable,1.227,12,67,1,1,0.327,0.567,0.393,79
stagnant,1.227,25,135,1,1,0.3,0.5,0.208,160
serpent,1.227,12,67,1,1,0.115,0.696,0.679,79
spirits,1.226,223,1171,1,1,0.583,0.847,0.545,1394
trinity,1.226,29,156,1,1,0.635,0.346,0.66,185
betterment,1.226,16,88,1,1,0.898,0.536,0.769,104
rewarding,1.226,88,465,1,1,0.958,0.637,0.783,553
sphere,1.225,20,109,1,1,0.633,0.277,0.5,129
prosperity,1.224,32,172,1,1,0.917,0.6,0.86,204
guard,1.223,241,1269,1,1,0.592,0.51,0.725,1510
fulfilling,1.223,103,545,1,1,0.823,0.417,0.755,648
carnal,1.223,7,41,1,1,0.417,0.679,0.421,48
eloquent,1.223,15,83,1,1,0.87,0.68,0.741,98
southwest,1.223,7,41,1,1,0.406,0.314,0.355,48
detrimental,1.223,35,188,1,1,0.203,0.679,0.387,223
morph,1.223,7,41,1,1,0.448,0.469,0.451,48
petal,1.223,7,41,1,1,0.81,0.194,0.211,48
peering,1.223,7,41,1,1,0.514,0.409,0.451,48
tracing,1.223,7,41,1,1,0.418,0.591,0.565,48
architect,1.223,11,62,1,1,0.776,0.442,0.836,73
irritation,1.223,15,83,1,1,0.073,0.833,0.496,98
enslaved,1.223,11,62,1,1,0.104,0.72,0.321,73
compulsion,1.223,11,62,1,1,0.118,0.76,0.604,73
poem,1.222,229,1208,1,1,0.81,0.27,0.571,1437
emptiness,1.221,299,1577,1,1,0.177,0.173,0.184,1876
mere,1.221,117,620,1,1,0.396,0.221,0.176,737
remedy,1.22,63,336,1,1,0.625,0.283,0.491,399
sulk,1.22,29,157,1,1,0.25,0.58,0.406,186
creature,1.22,145,768,1,1,0.669,0.625,0.62,913
volatile,1.219,10,57,1,1,0.323,0.786,0.565,67
deceptive,1.219,10,57,1,1,0.027,0.605,0.294,67
robotic,1.219,10,57,1,1,0.417,0.602,0.657,67
hangover,1.219,32,173,1,1,0.188,0.565,0.267,205
providing,1.218,130,690,1,1,0.816,0.55,0.896,820
acquainted,1.218,17,94,1,1,0.906,0.358,0.632,111
vicinity,1.218,17,94,1,1,0.7,0.353,0.466,111
dense,1.217,31,168,1,1,0.354,0.343,0.536,199
potion,1.216,6,36,1,1,0.5,0.4,0.417,42
missionary,1.216,6,36,1,1,0.729,0.404,0.596,42
pastry,1.216,6,36,1,1,0.87,0.407,0.419,42
laser,1.216,13,73,1,1,0.469,0.531,0.769,86
smother,1.216,13,73,1,1,0.292,0.685,0.42,86
retrospective,1.216,6,36,1,1,0.594,0.481,0.528,42
blueprint,1.216,6,36,1,1,0.49,0.173,0.425,42
engaging,1.216,82,438,1,1,0.948,0.612,0.862,520
thinker,1.215,30,163,1,1,0.706,0.386,0.764,193
tropical,1.215,23,126,1,1,0.74,0.461,0.509,149
prisoner,1.215,40,216,1,1,0.071,0.654,0.308,256
debris,1.213,9,52,1,1,0.135,0.396,0.327,61
resurrection,1.213,19,105,1,1,0.708,0.74,0.759,124
empress,1.213,9,52,1,1,0.716,0.669,0.855,61
induced,1.213,22,121,1,1,0.397,0.471,0.491,143
proportion,1.213,22,121,1,1,0.541,0.462,0.518,143
colonial,1.212,12,68,1,1,0.553,0.327,0.613,80
fray,1.212,12,68,1,1,0.337,0.542,0.482,80
hazy,1.212,12,68,1,1,0.45,0.433,0.23,80
copyright,1.212,12,68,1,1,0.458,0.402,0.663,80
hidden,1.212,268,1427,1,1,0.208,0.43,0.327,1695
enlightening,1.21,24,132,1,1,0.825,0.729,0.727,156
atmosphere,1.209,136,728,1,1,0.604,0.3,0.56,864
gradually,1.208,54,292,1,1,0.583,0.385,0.464,346
salvation,1.208,75,404,1,1,0.857,0.48,0.8,479
intimate,1.208,135,724,1,1,0.724,0.598,0.393,859
depicting,1.207,5,31,1,1,0.49,0.566,0.602,36
quicksand,1.207,5,31,1,1,0.219,0.74,0.508,36
inconsequential,1.207,8,47,1,1,0.25,0.48,0.345,55
ignite,1.207,17,95,1,1,0.458,0.785,0.675,112
burial,1.207,14,79,1,1,0.203,0.577,0.333,93
mosque,1.207,29,159,1,1,0.542,0.352,0.528,188
transient,1.207,8,47,1,1,0.51,0.405,0.43,55
vulture,1.207,5,31,1,1,0.316,0.604,0.472,36
incessantly,1.207,8,47,1,1,0.417,0.765,0.606,55
sorcery,1.207,5,31,1,1,0.279,0.74,0.64,36
bereft,1.207,14,79,1,1,0.229,0.49,0.336,93
impeccable,1.207,8,47,1,1,0.833,0.37,0.824,55
coldly,1.207,5,31,1,1,0.365,0.358,0.407,36
unattached,1.207,8,47,1,1,0.192,0.439,0.283,55
synthetic,1.207,5,31,1,1,0.396,0.35,0.519,36
total,1.207,507,2710,1,1,0.771,0.286,0.714,3217
excluding,1.204,22,122,1,1,0.271,0.55,0.324,144
devoted,1.204,42,229,1,1,0.867,0.32,0.698,271
atlas,1.204,19,106,1,1,0.531,0.306,0.554,125
snail,1.204,16,90,1,1,0.48,0.104,0.296,106
cocoa,1.204,16,90,1,1,0.776,0.255,0.322,106
sword,1.203,103,556,1,1,0.438,0.653,0.713,659
output,1.203,13,74,1,1,0.604,0.389,0.434,87
irresistible,1.203,13,74,1,1,0.823,0.833,0.839,87
perfection,1.202,82,444,1,1,0.881,0.745,0.934,526
healing,1.202,862,4626,1,1,0.75,0.452,0.585,5488
continuity,1.202,10,58,1,1,0.781,0.439,0.684,68
poignant,1.201,29,160,1,1,0.646,0.444,0.518,189
ranch,1.2,42,230,1,1,0.357,0.42,0.409,272
evolve,1.2,50,273,1,1,0.655,0.692,0.896,323
snowstorm,1.199,7,42,1,1,0.204,0.833,0.629,49
porcelain,1.199,7,42,1,1,0.562,0.31,0.349,49
afresh,1.199,7,42,1,1,0.643,0.521,0.48,49
symbolic,1.199,15,85,1,1,0.67,0.385,0.574,100
imprint,1.199,7,42,1,1,0.615,0.574,0.685,49
bordering,1.199,7,42,1,1,0.643,0.382,0.438,49
destination,1.198,96,521,1,1,0.708,0.471,0.637,617
greater,1.197,342,1847,1,1,0.755,0.519,0.796,2189
siren,1.197,17,96,1,1,0.57,0.627,0.5,113
impose,1.196,22,123,1,1,0.503,0.721,0.745,145
repent,1.196,32,177,1,1,0.449,0.422,0.386,209
moist,1.195,9,53,1,1,0.47,0.316,0.386,62
rekindle,1.195,9,53,1,1,0.656,0.52,0.788,62
evasion,1.195,4,26,1,1,0.229,0.51,0.418,30
sharpened,1.195,4,26,1,1,0.573,0.647,0.727,30
deterioration,1.195,4,26,1,1,0.13,0.512,0.283,30
conductor,1.195,4,26,1,1,0.677,0.663,0.621,30
vivid,1.195,44,242,1,1,0.698,0.627,0.667,286
meanness,1.195,4,26,1,1,0.102,0.694,0.368,30
terrestrial,1.195,4,26,1,1,0.542,0.413,0.582,30
decorative,1.195,4,26,1,1,0.908,0.46,0.381,30
puzzling,1.195,4,26,1,1,0.296,0.644,0.353,30
privy,1.195,4,26,1,1,0.583,0.481,0.648,30
frazzled,1.195,4,26,1,1,0.344,0.415,0.339,30
decode,1.195,4,26,1,1,0.551,0.51,0.64,30
afternoon,1.194,352,1907,1,1,0.533,0.388,0.339,2259
titan,1.193,21,118,1,1,0.598,0.653,0.811,139
conventional,1.193,16,91,1,1,0.594,0.292,0.634,107
kingdom,1.192,170,925,1,1,0.714,0.547,0.91,1095
secluded,1.19,100,547,1,1,0.357,0.265,0.24,647
receptive,1.19,13,75,1,1,0.729,0.519,0.639,88
telepathy,1.19,6,37,1,1,0.594,0.51,0.588,43
sordid,1.19,6,37,1,1,0.219,0.555,0.447,43
immeasurable,1.19,13,75,1,1,0.51,0.539,0.712,88
stardust,1.19,13,75,1,1,0.843,0.41,0.549,88
hurl,1.19,6,37,1,1,0.316,0.745,0.574,43
unseen,1.189,73,401,1,1,0.427,0.351,0.421,474
prejudice,1.188,45,249,1,1,0.11,0.613,0.407,294
neglect,1.188,86,472,1,1,0.045,0.55,0.163,558
clumsy,1.188,40,222,1,1,0.125,0.42,0.144,262
perceive,1.187,51,282,1,1,0.653,0.49,0.655,333
proposition,1.187,8,48,1,1,0.627,0.75,0.565,56
gab,1.187,17,97,1,1,0.5,0.471,0.375,114
banquet,1.187,8,48,1,1,0.765,0.571,0.6,56
sandy,1.186,37,206,1,1,0.406,0.265,0.296,243
oppressive,1.185,21,119,1,1,0.276,0.59,0.667,140
tenth,1.185,10,59,1,1,0.51,0.349,0.382,69
unexplained,1.185,10,59,1,1,0.271,0.531,0.349,69
sketching,1.185,10,59,1,1,0.729,0.327,0.4,69
folly,1.185,10,59,1,1,0.184,0.833,0.363,69
airs,1.185,10,59,1,1,0.583,0.196,0.37,69
explorer,1.185,10,59,1,1,0.729,0.663,0.714,69
beneficial,1.185,100,550,1,1,0.82,0.579,0.703,650
skyline,1.183,12,70,1,1,0.592,0.412,0.662,82
distinct,1.183,27,152,1,1,0.542,0.578,0.509,179
duality,1.183,14,81,1,1,0.438,0.52,0.503,95
rarity,1.183,14,81,1,1,0.646,0.548,0.364,95
advent,1.182,16,92,1,1,0.665,0.56,0.627,108
hibernate,1.182,16,92,1,1,0.5,0.317,0.431,108
elevated,1.181,18,103,1,1,0.704,0.594,0.62,121
ruler,1.181,18,103,1,1,0.44,0.4,0.631,121
authenticity,1.18,26,147,1,1,0.67,0.548,0.845,173
mortality,1.18,26,147,1,1,0.229,0.726,0.518,173
equivalent,1.179,71,394,1,1,0.646,0.347,0.5,465
physiological,1.176,5,32,1,1,0.51,0.418,0.62,37
commodity,1.176,11,65,1,1,0.615,0.394,0.537,76
orb,1.176,7,43,1,1,0.463,0.37,0.444,50
wield,1.176,7,43,1,1,0.347,0.66,0.625,50
cellar,1.176,11,65,1,1,0.51,0.277,0.406,76
weathered,1.176,5,32,1,1,0.422,0.491,0.537,37
maple,1.176,15,87,1,1,0.541,0.39,0.339,102
vibrate,1.176,11,65,1,1,0.5,0.698,0.604,76
smitten,1.176,5,32,1,1,0.153,0.76,0.204,37
personification,1.176,5,32,1,1,0.76,0.471,0.691,37
apparatus,1.176,5,32,1,1,0.375,0.353,0.377,37
forceful,1.176,7,43,1,1,0.533,0.673,0.898,50
capsule,1.176,5,32,1,1,0.583,0.29,0.57,37
disintegrate,1.176,5,32,1,1,0.143,0.66,0.364,37
salve,1.176,5,32,1,1,0.612,0.39,0.5,37
mixture,1.176,29,164,1,1,0.546,0.36,0.481,193
sift,1.176,5,32,1,1,0.542,0.412,0.461,37
empirical,1.176,5,32,1,1,0.5,0.51,0.574,37
molding,1.176,5,32,1,1,0.552,0.308,0.546,37
quilt,1.176,9,54,1,1,0.643,0.123,0.226,63
rosary,1.176,11,65,1,1,0.806,0.14,0.43,76
cyclist,1.176,5,32,1,1,0.684,0.582,0.576,37
basin,1.176,7,43,1,1,0.552,0.231,0.398,50
concealed,1.176,11,65,1,1,0.344,0.363,0.352,76
communicator,1.176,5,32,1,1,0.573,0.509,0.796,37
brook,1.176,15,87,1,1,0.594,0.347,0.412,102
formative,1.176,9,54,1,1,0.688,0.442,0.8,63
thief,1.175,46,258,1,1,0.088,0.888,0.443,304
wonderfully,1.174,42,236,1,1,0.969,0.76,0.821,278
convert,1.174,34,192,1,1,0.551,0.538,0.704,226
entrepreneur,1.173,26,148,1,1,0.885,0.704,0.92,174
suburbs,1.172,22,126,1,1,0.51,0.571,0.286,148
flexible,1.172,22,126,1,1,0.719,0.46,0.465,148
chatty,1.171,16,93,1,1,0.594,0.548,0.345,109
moose,1.17,14,82,1,1,0.648,0.373,0.318,96
separation,1.17,134,746,1,1,0.198,0.592,0.409,880
forecast,1.169,12,71,1,1,0.783,0.419,0.698,83
harrowing,1.169,12,71,1,1,0.209,0.81,0.474,83
chords,1.169,12,71,1,1,0.639,0.406,0.388,83
mystery,1.169,117,653,1,1,0.417,0.667,0.519,770
escape,1.168,804,4462,1,1,0.367,0.765,0.448,5266
sparrow,1.168,10,60,1,1,0.583,0.46,0.327,70
presumption,1.168,10,60,1,1,0.375,0.596,0.518,70
vital,1.167,117,654,1,1,0.75,0.716,0.847,771
ache,1.167,120,671,1,1,0.146,0.76,0.312,791
chirp,1.166,8,49,1,1,0.469,0.602,0.365,57
spectator,1.166,8,49,1,1,0.694,0.56,0.667,57
organic,1.166,26,149,1,1,0.719,0.343,0.535,175
storyteller,1.166,8,49,1,1,0.73,0.357,0.462,57
shaft,1.166,8,49,1,1,0.549,0.275,0.472,57
lapse,1.166,8,49,1,1,0.42,0.316,0.281,57
original,1.165,328,1829,1,1,0.765,0.48,0.746,2157
steep,1.165,15,88,1,1,0.312,0.612,0.321,103
whirlwind,1.165,15,88,1,1,0.417,0.915,0.67,103
detached,1.164,73,411,1,1,0.28,0.396,0.216,484
manifest,1.164,48,272,1,1,0.667,0.647,0.704,320
nuances,1.164,6,38,1,1,0.49,0.375,0.527,44
resurrect,1.164,6,38,1,1,0.781,0.725,0.817,44
unveil,1.164,6,38,1,1,0.439,0.442,0.562,44
reindeer,1.164,6,38,1,1,0.592,0.336,0.396,44
chimney,1.164,6,38,1,1,0.583,0.286,0.225,44
mould,1.164,6,38,1,1,0.357,0.176,0.246,44
commonplace,1.164,6,38,1,1,0.52,0.337,0.442,44
summons,1.164,6,38,1,1,0.552,0.604,0.598,44
thaw,1.164,6,38,1,1,0.438,0.321,0.327,44
shortcut,1.164,6,38,1,1,0.594,0.308,0.426,44
deck,1.163,53,300,1,1,0.42,0.333,0.394,353
north,1.163,269,1504,1,1,0.531,0.255,0.45,1773
exhaust,1.163,25,144,1,1,0.546,0.71,0.337,169
desirable,1.163,25,144,1,1,0.74,0.735,0.75,169
addicted,1.162,229,1282,1,1,0.156,0.712,0.483,1511
sail,1.162,37,211,1,1,0.615,0.22,0.325,248
grounded,1.162,75,423,1,1,0.531,0.601,0.509,498
intellectual,1.162,78,440,1,1,0.906,0.455,0.845,518
hymn,1.161,11,66,1,1,0.735,0.292,0.634,77
covenant,1.161,11,66,1,1,0.594,0.462,0.667,77
sun,1.161,1074,6004,1,1,0.877,0.4,0.681,7078
clockwork,1.161,16,94,1,1,0.49,0.373,0.528,110
riches,1.16,26,150,1,1,0.958,0.694,0.88,176
certainty,1.159,51,290,1,1,0.781,0.4,0.769,341
guillotine,1.158,4,27,1,1,0.163,0.817,0.585,31
counterpoint,1.158,4,27,1,1,0.438,0.509,0.538,31
rigorous,1.158,4,27,1,1,0.438,0.818,0.847,31
rapport,1.158,4,27,1,1,0.771,0.664,0.567,31
exponential,1.158,4,27,1,1,0.704,0.588,0.763,31
mod,1.158,24,139,1,1,0.458,0.367,0.384,163
symmetry,1.158,4,27,1,1,0.604,0.274,0.5,31
fangs,1.158,9,55,1,1,0.286,0.598,0.434,64
toasty,1.158,4,27,1,1,0.698,0.461,0.396,31
nemesis,1.158,9,55,1,1,0.271,0.688,0.647,64
rift,1.158,9,55,1,1,0.246,0.519,0.289,64
crowd,1.158,1079,6051,1,1,0.35,0.827,0.731,7130
proximity,1.157,27,156,1,1,0.677,0.508,0.569,183
undergo,1.156,12,72,1,1,0.398,0.554,0.339,84
motorcycle,1.156,25,145,1,1,0.677,0.764,0.713,170
anarchy,1.156,12,72,1,1,0.146,0.755,0.62,84
library,1.155,293,1651,1,1,0.776,0.122,0.549,1944
unintentional,1.154,7,44,1,1,0.333,0.538,0.306,51
rosemary,1.154,7,44,1,1,0.688,0.381,0.425,51
clutches,1.154,7,44,1,1,0.542,0.373,0.528,51
oppress,1.154,7,44,1,1,0.186,0.654,0.555,51
quota,1.154,7,44,1,1,0.427,0.41,0.4,51
soften,1.154,15,89,1,1,0.694,0.194,0.392,104
asteroid,1.154,7,44,1,1,0.43,0.721,0.623,51
clash,1.154,15,89,1,1,0.293,0.918,0.453,104
castle,1.153,161,911,1,1,0.68,0.396,0.718,1072
digress,1.152,10,61,1,1,0.271,0.625,0.411,71
cooling,1.152,10,61,1,1,0.469,0.324,0.392,71
construct,1.151,24,140,1,1,0.75,0.648,0.792,164
art,1.151,1172,6615,1,1,0.812,0.36,0.603,7787
pioneer,1.151,13,78,1,1,0.796,0.618,0.802,91
disciplined,1.151,13,78,1,1,0.728,0.45,0.75,91
lunchtime,1.151,13,78,1,1,0.896,0.398,0.444,91
soul,1.15,2952,16671,1,1,0.77,0.22,0.51,19623
halt,1.15,16,95,1,1,0.167,0.36,0.432,111
adventurous,1.15,19,112,1,1,0.969,0.898,0.722,131
tree,1.149,359,2034,1,1,0.67,0.118,0.442,2393
guarded,1.149,25,146,1,1,0.758,0.686,0.5,171
spontaneous,1.148,34,197,1,1,0.78,0.578,0.655,231
gratifying,1.147,14,84,1,1,0.857,0.606,0.776,98
infancy,1.147,5,33,1,1,0.75,0.399,0.37,38
congregate,1.147,5,33,1,1,0.653,0.53,0.733,38
oblige,1.147,5,33,1,1,0.281,0.77,0.614,38
stunted,1.147,8,50,1,1,0.194,0.472,0.275,58
pointer,1.147,5,33,1,1,0.583,0.382,0.5,38
navigation,1.147,5,33,1,1,0.841,0.47,0.72,38
brass,1.147,11,67,1,1,0.5,0.32,0.49,78
shaggy,1.147,5,33,1,1,0.51,0.302,0.321,38
attribute,1.147,14,84,1,1,0.781,0.439,0.795,98
canal,1.147,11,67,1,1,0.673,0.259,0.321,78
potent,1.147,8,50,1,1,0.698,0.784,0.907,58
wrench,1.147,5,33,1,1,0.396,0.202,0.545,38
regulatory,1.147,5,33,1,1,0.531,0.448,0.528,38
yank,1.147,5,33,1,1,0.271,0.63,0.538,38
magician,1.147,8,50,1,1,0.714,0.657,0.551,58
surrender,1.145,100,572,1,1,0.115,0.396,0.186,672
difficulty,1.145,88,504,1,1,0.079,0.74,0.368,592
iris,1.145,33,192,1,1,0.708,0.275,0.38,225
practice,1.144,500,2846,1,1,0.684,0.582,0.639,3346
mole,1.143,15,90,1,1,0.436,0.377,0.352,105
century,1.143,124,710,1,1,0.407,0.347,0.735,834
clearing,1.143,44,255,1,1,0.68,0.333,0.509,299
bid,1.142,25,147,1,1,0.76,0.53,0.655,172
compulsory,1.142,12,73,1,1,0.343,0.541,0.791,85
eradicate,1.142,12,73,1,1,0.26,0.69,0.686,85
scorn,1.142,12,73,1,1,0.11,0.721,0.356,85
rebuild,1.142,61,352,1,1,0.656,0.557,0.519,413
hectic,1.142,58,335,1,1,0.167,0.811,0.438,393
daydreaming,1.141,32,187,1,1,0.776,0.36,0.479,219
vision,1.141,224,1281,1,1,0.708,0.447,0.742,1505
revelation,1.141,52,301,1,1,0.879,0.5,0.865,353
redirect,1.141,9,56,1,1,0.469,0.36,0.648,65
virtuous,1.141,9,56,1,1,0.89,0.53,0.822,65
tent,1.14,56,324,1,1,0.51,0.275,0.333,380
altar,1.139,23,136,1,1,0.724,0.387,0.635,159
plaster,1.138,6,39,1,1,0.438,0.264,0.255,45
anal,1.138,20,119,1,1,0.333,0.798,0.334,139
ensemble,1.138,6,39,1,1,0.697,0.418,0.586,45
indecision,1.138,6,39,1,1,0.184,0.48,0.196,45
disillusionment,1.138,6,39,1,1,0.051,0.519,0.19,45
lingo,1.138,6,39,1,1,0.448,0.364,0.447,45
thereof,1.138,13,79,1,1,0.542,0.265,0.281,92
protestant,1.138,6,39,1,1,0.33,0.73,0.546,45
lively,1.138,27,159,1,1,0.847,0.81,0.642,186
annihilation,1.138,6,39,1,1,0.041,0.8,0.591,45
incomprehensible,1.138,13,79,1,1,0.25,0.55,0.344,92
workings,1.138,6,39,1,1,0.704,0.56,0.745,45
sith,1.138,6,39,1,1,0.439,0.564,0.373,45
tempo,1.138,13,79,1,1,0.582,0.337,0.5,92
torrent,1.138,6,39,1,1,0.541,0.745,0.676,45
coloring,1.138,13,79,1,1,0.781,0.469,0.353,92
homey,1.138,6,39,1,1,0.769,0.278,0.5,45
reluctance,1.138,6,39,1,1,0.24,0.606,0.373,45
snowman,1.138,6,39,1,1,0.776,0.291,0.323,45
primitive,1.138,13,79,1,1,0.323,0.388,0.361,92
deserted,1.138,94,542,1,1,0.156,0.48,0.214,636
evening,1.138,560,3206,1,1,0.458,0.185,0.318,3766
return,1.137,631,3614,1,1,0.602,0.412,0.463,4245
suffice,1.137,24,142,1,1,0.643,0.326,0.504,166
intense,1.137,234,1344,1,1,0.592,0.774,0.679,1578
artwork,1.136,43,251,1,1,0.896,0.368,0.679,294
vortex,1.136,10,62,1,1,0.408,0.691,0.602,72
spawn,1.136,21,125,1,1,0.542,0.586,0.709,146
vinyl,1.135,25,148,1,1,0.49,0.241,0.44,173
gem,1.135,66,383,1,1,0.917,0.48,0.582,449
writing,1.135,1439,8254,1,1,0.694,0.475,0.645,9693
invasion,1.135,44,257,1,1,0.271,0.843,0.808,301
dialogue,1.135,101,584,1,1,0.599,0.441,0.625,685
sheltered,1.134,18,108,1,1,0.59,0.377,0.717,126
affirmation,1.134,41,240,1,1,0.75,0.5,0.689,281
recite,1.134,22,131,1,1,0.688,0.398,0.453,153
assassin,1.134,22,131,1,1,0.073,0.933,0.632,153
occupation,1.134,22,131,1,1,0.562,0.47,0.692,153
compete,1.134,68,395,1,1,0.573,0.745,0.786,463
destiny,1.133,238,1372,1,1,0.781,0.413,0.611,1610
achievement,1.133,78,453,1,1,0.896,0.808,0.759,531
bane,1.132,15,91,1,1,0.265,0.694,0.366,106
pavilion,1.132,3,22,1,1,0.583,0.5,0.77,25
wry,1.132,3,22,1,1,0.219,0.548,0.528,25
noteworthy,1.132,3,22,1,1,0.704,0.481,0.759,25
brash,1.132,3,22,1,1,0.36,0.814,0.552,25
birthing,1.132,7,45,1,1,0.796,0.877,0.519,52
domination,1.132,11,68,1,1,0.505,0.786,0.959,79
raspberries,1.132,3,22,1,1,0.802,0.278,0.333,25
superstitious,1.132,7,45,1,1,0.281,0.545,0.514,52
jammed,1.132,7,45,1,1,0.235,0.817,0.411,52
disparity,1.132,7,45,1,1,0.208,0.482,0.361,52
meddle,1.132,3,22,1,1,0.302,0.77,0.526,25
reorganize,1.132,3,22,1,1,0.667,0.59,0.722,25
imposition,1.132,3,22,1,1,0.357,0.604,0.618,25
patronize,1.132,3,22,1,1,0.43,0.451,0.591,25
chameleon,1.132,7,45,1,1,0.49,0.58,0.345,52
speculative,1.132,3,22,1,1,0.276,0.591,0.464,25
voyager,1.132,7,45,1,1,0.684,0.596,0.627,52
zealot,1.132,3,22,1,1,0.48,0.793,0.654,25
particle,1.132,3,22,1,1,0.521,0.265,0.438,25
grunting,1.132,3,22,1,1,0.198,0.827,0.481,25
diarrhoea,1.132,3,22,1,1,0.038,0.692,0.25,25
cumbersome,1.132,3,22,1,1,0.259,0.623,0.292,25
perversion,1.132,7,45,1,1,0.083,0.83,0.49,52
bloodthirsty,1.132,3,22,1,1,0.052,0.804,0.644,25
scorching,1.132,3,22,1,1,0.406,0.635,0.464,25
hefty,1.132,7,45,1,1,0.55,0.654,0.745,52
smartass,1.132,3,22,1,1,0.364,0.52,0.62,25
coffee,1.132,947,5452,1,1,0.823,0.418,0.309,6399
underground,1.131,52,304,1,1,0.396,0.455,0.452,356
glowing,1.13,45,264,1,1,0.94,0.62,0.737,309
reconcile,1.13,20,120,1,1,0.76,0.47,0.625,140
entrance,1.13,41,241,1,1,0.698,0.393,0.526,282
curiosity,1.127,66,386,1,1,0.75,0.755,0.463,452
rattle,1.127,8,51,1,1,0.49,0.429,0.268,59
aforementioned,1.127,8,51,1,1,0.49,0.316,0.408,59
invariably,1.127,8,51,1,1,0.458,0.365,0.55,59
cunning,1.127,8,51,1,1,0.604,0.685,0.683,59
publication,1.127,17,103,1,1,0.549,0.47,0.6,120
composer,1.127,8,51,1,1,0.822,0.588,0.691,59
bubbling,1.127,8,51,1,1,0.5,0.438,0.384,59
integral,1.126,13,80,1,1,0.59,0.337,0.615,93
seafood,1.126,13,80,1,1,0.656,0.5,0.328,93
collection,1.125,122,711,1,1,0.725,0.311,0.588,833
anticipation,1.125,23,138,1,1,0.698,0.539,0.711,161
mindful,1.124,63,370,1,1,0.765,0.45,0.725,433
urgency,1.123,19,115,1,1,0.429,0.908,0.543,134
implication,1.123,9,57,1,1,0.337,0.528,0.69,66
bowels,1.123,4,28,1,1,0.194,0.448,0.362,32
scowl,1.123,4,28,1,1,0.302,0.6,0.413,32
vacate,1.123,4,28,1,1,0.357,0.49,0.397,32
safeguard,1.123,9,57,1,1,0.786,0.624,0.7,66
recognizable,1.123,4,28,1,1,0.625,0.4,0.609,32
tarnish,1.123,4,28,1,1,0.204,0.441,0.342,32
groundhog,1.123,4,28,1,1,0.385,0.324,0.377,32
herring,1.123,4,28,1,1,0.531,0.387,0.422,32
destroyer,1.123,9,57,1,1,0.083,0.83,0.543,66
midsummer,1.123,4,28,1,1,0.781,0.48,0.492,32
impersonal,1.123,4,28,1,1,0.316,0.356,0.472,32
exasperation,1.123,4,28,1,1,0.214,0.833,0.483,32
exclaim,1.123,4,28,1,1,0.635,0.711,0.639,32
dishonor,1.123,4,28,1,1,0.104,0.62,0.185,32
enjoyable,1.121,116,679,1,1,1,0.481,0.605,795
versus,1.121,58,342,1,1,0.31,0.5,0.447,400
orbit,1.12,21,127,1,1,0.561,0.422,0.575,148
loosen,1.12,10,63,1,1,0.487,0.337,0.218,73
bookstore,1.12,21,127,1,1,0.771,0.18,0.503,148
gush,1.12,10,63,1,1,0.51,0.49,0.381,73
pole,1.12,49,290,1,1,0.418,0.398,0.368,339
internal,1.12,149,872,1,1,0.439,0.349,0.423,1021
pearl,1.119,33,197,1,1,0.905,0.425,0.642,230
eraser,1.118,5,34,1,1,0.458,0.209,0.311,39
orc,1.118,5,34,1,1,0.24,0.51,0.388,39
perished,1.118,5,34,1,1,0.135,0.596,0.225,39
pollute,1.118,5,34,1,1,0.173,0.66,0.48,39
unruly,1.118,5,34,1,1,0.24,0.745,0.547,39
beetle,1.118,5,34,1,1,0.323,0.356,0.295,39
trumpet,1.118,11,69,1,1,0.573,0.57,0.393,80
saint,1.117,102,600,1,1,0.812,0.24,0.693,702
rural,1.117,90,530,1,1,0.562,0.245,0.408,620
consumption,1.117,30,180,1,1,0.39,0.531,0.538,210
cinematic,1.116,18,110,1,1,0.663,0.49,0.6,128
quantum,1.116,18,110,1,1,0.704,0.5,0.6,128
park,1.116,590,3453,1,1,0.816,0.343,0.414,4043
absolute,1.115,562,3291,1,1,0.526,0.51,0.827,3853
reserved,1.115,58,344,1,1,0.594,0.316,0.583,402
salvage,1.114,6,40,1,1,0.622,0.51,0.832,46
sustained,1.114,13,81,1,1,0.649,0.34,0.58,94
cornerstone,1.114,6,40,1,1,0.55,0.388,0.596,46
resolute,1.114,6,40,1,1,0.771,0.51,0.712,46
idealism,1.114,6,40,1,1,0.635,0.436,0.689,46
air,1.113,798,4680,1,1,0.708,0.163,0.427,5478
weary,1.113,91,538,1,1,0.194,0.281,0.202,629
spring,1.113,283,1664,1,1,0.837,0.37,0.481,1947
iced,1.112,37,222,1,1,0.564,0.482,0.339,259
conversion,1.111,22,134,1,1,0.48,0.605,0.736,156
shun,1.111,22,134,1,1,0.418,0.604,0.389,156
consuming,1.111,70,416,1,1,0.573,0.541,0.536,486
heap,1.11,15,93,1,1,0.582,0.51,0.474,108
cerebral,1.11,7,46,1,1,0.408,0.509,0.627,53
compound,1.11,23,140,1,1,0.635,0.385,0.735,163
irreversible,1.11,7,46,1,1,0.17,0.541,0.667,53
greatness,1.11,87,516,1,1,0.99,0.75,0.943,603
prestigious,1.11,7,46,1,1,0.979,0.644,0.925,53
conjunction,1.11,7,46,1,1,0.52,0.472,0.509,53
sassy,1.11,24,146,1,1,0.271,0.704,0.32,170
calming,1.108,132,782,1,1,0.885,0.105,0.36,914
similarity,1.108,8,52,1,1,0.729,0.255,0.518,60
abstain,1.108,8,52,1,1,0.385,0.385,0.427,60
stave,1.108,8,52,1,1,0.417,0.333,0.424,60
pathway,1.107,18,111,1,1,0.646,0.41,0.519,129
dominant,1.107,28,170,1,1,0.406,0.854,0.893,198
worship,1.106,196,1161,1,1,0.688,0.38,0.573,1357
goddess,1.106,88,524,1,1,0.865,0.56,0.888,612
lead,1.105,716,4233,1,1,0.323,0.657,0.455,4949
relaxing,1.105,276,1635,1,1,0.854,0.157,0.475,1911
riff,1.105,10,64,1,1,0.521,0.551,0.343,74
natural,1.104,383,2269,1,1,0.854,0.118,0.481,2652
darkness,1.104,1266,7489,1,1,0.102,0.602,0.418,8755
gifted,1.103,60,360,1,1,0.902,0.647,0.868,420
soaked,1.102,25,153,1,1,0.365,0.462,0.358,178
reminisce,1.102,25,153,1,1,0.903,0.49,0.363,178
memoir,1.102,25,153,1,1,0.75,0.242,0.553,178
measure,1.102,93,556,1,1,0.51,0.375,0.365,649
lure,1.101,13,82,1,1,0.439,0.565,0.3,95
intact,1.101,28,171,1,1,0.716,0.212,0.602,199
shell,1.099,116,694,1,1,0.615,0.408,0.391,810
abiding,1.099,16,100,1,1,0.796,0.327,0.75,116
admiration,1.099,54,326,1,1,0.969,0.583,0.726,380
disturbed,1.098,93,558,1,1,0.125,0.87,0.305,651
morn,1.098,18,112,1,1,0.542,0.284,0.345,130
possess,1.098,40,243,1,1,0.67,0.59,0.727,283
ambition,1.097,41,249,1,1,0.51,0.804,0.661,290
years,1.097,9708,57819,1,1,0.653,0.33,0.508,67527
drenched,1.097,22,136,1,1,0.302,0.361,0.388,158
contented,1.097,46,279,1,1,0.857,0.612,0.746,325
restless,1.096,72,434,1,1,0.219,0.81,0.304,506
lover,1.096,397,2372,1,1,0.881,0.816,0.75,2769
cloudy,1.096,26,160,1,1,0.281,0.28,0.202,186
sensitivity,1.095,28,172,1,1,0.75,0.417,0.395,200
laziness,1.095,30,184,1,1,0.271,0.24,0.132,214
joy,1.095,1098,6559,1,1,0.98,0.824,0.794,7657
liberating,1.095,97,584,1,1,0.915,0.62,0.745,681
excessive,1.094,36,220,1,1,0.417,0.731,0.601,256
minor,1.091,120,724,1,1,0.25,0.235,0.175,844
unused,1.089,12,77,1,1,0.344,0.231,0.234,89
musty,1.089,6,41,1,1,0.354,0.367,0.267,47
proclaim,1.089,10,65,1,1,0.719,0.673,0.876,75
marvelous,1.089,26,161,1,1,0.948,0.637,0.778,187
gluttony,1.089,3,23,1,1,0.5,0.702,0.412,26
oftentimes,1.089,23,143,1,1,0.571,0.5,0.482,166
pupil,1.089,4,29,1,1,0.729,0.406,0.368,33
undiscovered,1.089,9,59,1,1,0.438,0.347,0.261,68
swimmer,1.089,4,29,1,1,0.657,0.698,0.61,33
contend,1.089,6,41,1,1,0.51,0.657,0.731,47
etiquette,1.089,12,77,1,1,0.604,0.35,0.421,89
insistent,1.089,5,35,1,1,0.552,0.635,0.701,40
ottoman,1.089,3,23,1,1,0.531,0.337,0.444,26
transmit,1.089,4,29,1,1,0.836,0.581,0.673,33
unsolicited,1.089,22,137,1,1,0.094,0.339,0.28,159
distaste,1.089,12,77,1,1,0.184,0.625,0.37,89
unbalanced,1.089,10,65,1,1,0.302,0.596,0.343,75
viola,1.089,3,23,1,1,0.521,0.461,0.481,26
gauntlet,1.089,8,53,1,1,0.42,0.491,0.39,61
contradiction,1.089,22,137,1,1,0.25,0.66,0.377,159
gall,1.089,6,41,1,1,0.417,0.51,0.353,47
horde,1.089,15,95,1,1,0.286,0.713,0.684,110
bottomless,1.089,13,83,1,1,0.31,0.47,0.368,96
sandbox,1.089,4,29,1,1,0.573,0.274,0.264,33
bicker,1.089,3,23,1,1,0.143,0.643,0.552,26
devilish,1.089,4,29,1,1,0.073,0.865,0.49,33
selfishness,1.089,50,305,1,1,0.2,0.686,0.453,355
plentiful,1.089,7,47,1,1,0.833,0.735,0.745,54
builder,1.089,8,53,1,1,0.66,0.642,0.701,61
sheen,1.089,4,29,1,1,0.812,0.51,0.712,33
modicum,1.089,5,35,1,1,0.234,0.417,0.327,40
fervent,1.089,5,35,1,1,0.646,0.632,0.773,40
citrus,1.089,3,23,1,1,0.469,0.368,0.375,26
psychotherapy,1.089,4,29,1,1,0.396,0.547,0.651,33
disposed,1.089,4,29,1,1,0.688,0.441,0.625,33
parish,1.089,15,95,1,1,0.698,0.354,0.582,110
hypnotic,1.089,3,23,1,1,0.571,0.56,0.569,26
swiftly,1.089,14,89,1,1,0.66,0.885,0.618,103
sapphire,1.089,7,47,1,1,0.77,0.472,0.651,54
banshee,1.089,3,23,1,1,0.408,0.565,0.481,26
reverend,1.089,6,41,1,1,0.65,0.337,0.576,47
operational,1.089,3,23,1,1,0.562,0.57,0.679,26
overlapping,1.089,3,23,1,1,0.595,0.578,0.684,26
forearm,1.089,5,35,1,1,0.469,0.304,0.509,40
breach,1.089,13,83,1,1,0.177,0.745,0.423,96
mismatched,1.089,4,29,1,1,0.25,0.557,0.302,33
pathology,1.089,5,35,1,1,0.271,0.56,0.558,40
everlasting,1.089,38,233,1,1,0.74,0.413,0.809,271
witchcraft,1.089,13,83,1,1,0.183,0.779,0.555,96
expel,1.089,5,35,1,1,0.281,0.725,0.452,40
stern,1.089,15,95,1,1,0.552,0.394,0.415,110
friendliness,1.089,4,29,1,1,0.981,0.27,0.611,33
feisty,1.089,5,35,1,1,0.592,0.853,0.789,40
remaining,1.089,100,605,1,1,0.449,0.29,0.296,705
denounce,1.089,11,71,1,1,0.083,0.78,0.426,82
descendant,1.089,3,23,1,1,0.684,0.42,0.625,26
twinge,1.089,4,29,1,1,0.316,0.72,0.471,33
skewed,1.089,11,71,1,1,0.34,0.48,0.361,82
provocative,1.089,7,47,1,1,0.438,0.814,0.684,54
befitting,1.089,3,23,1,1,0.708,0.333,0.394,26
reggae,1.089,7,47,1,1,0.698,0.52,0.5,54
pragmatic,1.089,8,53,1,1,0.573,0.433,0.637,61
delegation,1.089,3,23,1,1,0.562,0.431,0.609,26
quad,1.089,13,83,1,1,0.52,0.441,0.391,96
shutter,1.089,4,29,1,1,0.191,0.38,0.482,33
jukebox,1.089,4,29,1,1,0.699,0.54,0.429,33
inexplicable,1.089,12,77,1,1,0.224,0.635,0.443,89
stupor,1.089,4,29,1,1,0.323,0.59,0.33,33
ashes,1.089,71,431,1,1,0.327,0.279,0.142,502
foreplay,1.089,3,23,1,1,0.724,0.627,0.474,26
hunger,1.087,76,462,1,1,0.083,0.554,0.328,538
tender,1.087,74,450,1,1,0.63,0.52,0.509,524
patience,1.087,363,2188,1,1,0.771,0.125,0.387,2551
melody,1.087,63,384,1,1,0.847,0.434,0.405,447
steel,1.087,58,354,1,1,0.521,0.42,0.714,412
jungle,1.086,106,643,1,1,0.5,0.51,0.481,749
distant,1.086,342,2064,1,1,0.229,0.324,0.269,2406
disguise,1.086,45,276,1,1,0.573,0.694,0.431,321
golf,1.086,87,529,1,1,0.573,0.358,0.447,616
historical,1.086,42,258,1,1,0.653,0.357,0.833,300
networking,1.085,37,228,1,1,0.625,0.482,0.545,265
rested,1.085,37,228,1,1,0.792,0.235,0.462,265
confuse,1.085,101,614,1,1,0.1,0.58,0.27,715
poison,1.084,97,590,1,1,0.083,0.76,0.573,687
technique,1.084,28,174,1,1,0.76,0.414,0.593,202
melting,1.079,31,193,1,1,0.592,0.47,0.538,224
aligned,1.078,28,175,1,1,0.583,0.275,0.553,203
bodily,1.077,12,78,1,1,0.594,0.481,0.557,90
encore,1.077,12,78,1,1,0.51,0.423,0.5,90
smoothly,1.076,24,151,1,1,0.821,0.134,0.488,175
existence,1.076,533,3246,1,1,0.76,0.513,0.771,3779
brew,1.076,23,145,1,1,0.74,0.538,0.758,168
perish,1.076,23,145,1,1,0.296,0.57,0.415,168
pretentious,1.076,23,145,1,1,0.156,0.736,0.444,168
helmet,1.074,21,133,1,1,0.573,0.327,0.402,154
wealth,1.074,108,663,1,1,0.857,0.637,0.858,771
pesky,1.073,9,60,1,1,0.25,0.76,0.431,69
conquering,1.071,17,109,1,1,0.76,0.873,0.936,126
scrape,1.071,8,54,1,1,0.365,0.615,0.384,62
twilight,1.071,88,543,1,1,0.622,0.341,0.633,631
adapt,1.07,93,574,1,1,0.74,0.355,0.551,667
narrator,1.07,16,103,1,1,0.673,0.43,0.623,119
readily,1.07,16,103,1,1,0.74,0.29,0.547,119
budge,1.069,7,48,1,1,0.719,0.755,0.543,55
expansion,1.069,15,97,1,1,0.776,0.618,0.787,112
antagonist,1.069,7,48,1,1,0.24,0.615,0.7,55
neatly,1.069,7,48,1,1,0.802,0.412,0.588,55
platter,1.069,7,48,1,1,0.686,0.245,0.219,55
invoke,1.069,7,48,1,1,0.583,0.74,0.579,55
steadfast,1.069,15,97,1,1,0.771,0.433,0.8,112
constitute,1.069,7,48,1,1,0.812,0.349,0.906,55
hearty,1.069,7,48,1,1,0.76,0.684,0.792,55
capacity,1.068,155,955,1,1,0.719,0.411,0.806,1110
renew,1.068,30,189,1,1,0.868,0.481,0.713,219
disturb,1.068,145,894,1,1,0.175,0.76,0.481,1039
neurotic,1.067,14,91,1,1,0.198,0.801,0.387,105
hut,1.067,35,220,1,1,0.633,0.27,0.375,255
examine,1.066,27,171,1,1,0.615,0.623,0.786,198
whiteness,1.066,6,42,1,1,0.688,0.235,0.519,48
digest,1.066,27,171,1,1,0.72,0.413,0.483,198
erotic,1.066,13,85,1,1,0.625,0.946,0.683,98
remnant,1.066,6,42,1,1,0.367,0.312,0.388,48
induce,1.066,6,42,1,1,0.257,0.606,0.684,48
belongings,1.065,19,122,1,1,0.592,0.38,0.75,141
caretaker,1.065,19,122,1,1,0.714,0.531,0.759,141
premiere,1.065,19,122,1,1,0.776,0.596,0.573,141
kayak,1.064,12,79,1,1,0.592,0.6,0.364,91
celebrations,1.064,25,159,1,1,0.958,0.794,0.714,184
lurk,1.064,12,79,1,1,0.219,0.74,0.655,91
butterfly,1.064,82,510,1,1,0.892,0.327,0.314,592
liberty,1.062,60,375,1,1,0.938,0.579,0.836,435
motion,1.062,72,449,1,1,0.667,0.538,0.657,521
narration,1.062,5,36,1,1,0.622,0.408,0.551,41
vista,1.062,5,36,1,1,0.698,0.39,0.45,41
eddy,1.062,5,36,1,1,0.5,0.394,0.35,41
fang,1.062,5,36,1,1,0.175,0.491,0.455,41
rake,1.062,5,36,1,1,0.41,0.286,0.314,41
auction,1.062,5,36,1,1,0.594,0.702,0.519,41
triumphant,1.062,5,36,1,1,0.949,0.837,0.972,41
buster,1.062,11,73,1,1,0.469,0.491,0.483,84
cosmos,1.061,28,178,1,1,0.86,0.478,0.664,206
astonishing,1.061,22,141,1,1,0.844,0.802,0.821,163
edition,1.061,73,456,1,1,0.542,0.455,0.564,529
discomfort,1.06,61,382,1,1,0.153,0.719,0.272,443
gritty,1.06,10,67,1,1,0.417,0.373,0.375,77
tiresome,1.06,21,135,1,1,0.24,0.542,0.153,156
vampire,1.058,78,488,1,1,0.271,0.802,0.545,566
maximum,1.058,41,259,1,1,0.724,0.724,0.852,300
soiled,1.057,4,30,1,1,0.106,0.529,0.213,34
gator,1.057,4,30,1,1,0.418,0.52,0.547,34
interpreter,1.057,4,30,1,1,0.708,0.461,0.596,34
sacrificial,1.057,4,30,1,1,0.198,0.755,0.452,34
simpleton,1.057,4,30,1,1,0.429,0.144,0.358,34
loudness,1.057,4,30,1,1,0.35,0.582,0.62,34
tremor,1.057,4,30,1,1,0.104,0.833,0.455,34
unconstitutional,1.057,4,30,1,1,0.23,0.588,0.491,34
midtown,1.057,4,30,1,1,0.479,0.442,0.538,34
pogo,1.057,4,30,1,1,0.48,0.426,0.368,34
fuse,1.057,14,92,1,1,0.373,0.565,0.574,106
pane,1.057,9,61,1,1,0.385,0.25,0.444,70
chum,1.057,4,30,1,1,0.911,0.347,0.518,34
restrained,1.057,4,30,1,1,0.354,0.59,0.509,34
resonant,1.057,4,30,1,1,0.542,0.633,0.663,34
spent,1.056,1320,8191,1,1,0.296,0.296,0.263,9511
tiger,1.056,73,458,1,1,0.479,0.765,0.664,531
buzzing,1.056,33,210,1,1,0.43,0.588,0.37,243
cowardice,1.055,23,148,1,1,0.133,0.621,0.167,171
stability,1.055,71,446,1,1,0.812,0.264,0.849,517
remains,1.055,157,980,1,1,0.61,0.24,0.565,1137
electronics,1.054,13,86,1,1,0.708,0.545,0.574,99
normalcy,1.054,13,86,1,1,0.805,0.151,0.62,99
sweeping,1.054,22,142,1,1,0.344,0.431,0.355,164
reset,1.054,77,484,1,1,0.49,0.45,0.574,561
persistent,1.054,31,198,1,1,0.646,0.667,0.815,229
antsy,1.053,8,55,1,1,0.449,0.558,0.417,63
longevity,1.053,8,55,1,1,0.75,0.353,0.745,63
copper,1.053,8,55,1,1,0.58,0.26,0.5,63
mantle,1.053,8,55,1,1,0.51,0.269,0.422,63
disruptive,1.053,8,55,1,1,0.255,0.755,0.575,63
skull,1.053,35,223,1,1,0.276,0.558,0.574,258
wiki,1.053,8,55,1,1,0.53,0.39,0.455,63
depraved,1.053,8,55,1,1,0.031,0.837,0.395,63
default,1.053,62,391,1,1,0.459,0.343,0.712,453
myriad,1.052,12,80,1,1,0.48,0.429,0.55,92
grey,1.052,163,1021,1,1,0.347,0.14,0.295,1184
digital,1.051,115,722,1,1,0.74,0.382,0.529,837
alternate,1.051,46,292,1,1,0.625,0.363,0.589,338
tiredness,1.051,16,105,1,1,0.387,0.408,0.242,121
backyard,1.05,45,286,1,1,0.552,0.28,0.302,331
ultimate,1.05,171,1073,1,1,0.648,0.645,0.544,1244
device,1.049,60,380,1,1,0.562,0.404,0.627,440
funnel,1.049,3,24,1,1,0.354,0.274,0.336,27
researcher,1.049,11,74,1,1,0.569,0.51,0.857,85
falcon,1.049,11,74,1,1,0.557,0.58,0.678,85
gambler,1.049,3,24,1,1,0.458,0.694,0.618,27
moisture,1.049,3,24,1,1,0.406,0.398,0.327,27
oozing,1.049,3,24,1,1,0.238,0.515,0.427,27
illustrious,1.049,3,24,1,1,0.673,0.55,0.741,27
forfeit,1.049,3,24,1,1,0.083,0.635,0.245,27
lawless,1.049,7,49,1,1,0.219,0.69,0.42,56
barbed,1.049,3,24,1,1,0.177,0.594,0.455,27
scavenger,1.049,3,24,1,1,0.177,0.578,0.408,27
statesman,1.049,3,24,1,1,0.51,0.49,0.736,27
breeder,1.049,3,24,1,1,0.645,0.481,0.605,27
leafy,1.049,3,24,1,1,0.653,0.53,0.7,27
intervening,1.049,3,24,1,1,0.398,0.627,0.442,27
discrete,1.049,3,24,1,1,0.585,0.231,0.429,27
lovesick,1.049,3,24,1,1,0.796,0.842,0.5,27
syntax,1.049,3,24,1,1,0.531,0.346,0.559,27
bouncer,1.049,3,24,1,1,0.49,0.653,0.655,27
hovel,1.049,3,24,1,1,0.333,0.296,0.322,27
unoccupied,1.049,3,24,1,1,0.258,0.245,0.412,27
militant,1.049,7,49,1,1,0.418,0.667,0.75,56
impediment,1.049,3,24,1,1,0.163,0.6,0.409,27
conspire,1.049,3,24,1,1,0.206,0.74,0.52,27
porcupine,1.049,3,24,1,1,0.388,0.421,0.367,27
grounds,1.048,38,243,1,1,0.667,0.5,0.598,281
sufficient,1.047,72,456,1,1,0.833,0.33,0.588,528
dwarf,1.046,14,93,1,1,0.37,0.34,0.288,107
rare,1.046,389,2443,1,1,0.396,0.413,0.236,2832
strolling,1.046,14,93,1,1,0.755,0.515,0.34,107
execution,1.046,25,162,1,1,0.16,0.811,0.713,187
joyous,1.045,36,231,1,1,0.958,0.58,0.728,267
contradictory,1.045,21,137,1,1,0.365,0.651,0.421,158
fundamental,1.045,43,275,1,1,0.708,0.422,0.903,318
treasured,1.044,24,156,1,1,0.849,0.471,0.73,180
macro,1.043,6,43,1,1,0.552,0.469,0.647,49
yarn,1.043,6,43,1,1,0.51,0.265,0.233,49
reinforcement,1.043,6,43,1,1,0.729,0.702,0.902,49
heartily,1.043,6,43,1,1,0.927,0.531,0.664,49
animated,1.043,27,175,1,1,0.823,0.676,0.538,202
maintain,1.043,156,986,1,1,0.684,0.398,0.647,1142
reap,1.042,33,213,1,1,0.677,0.422,0.623,246
nostalgic,1.041,43,276,1,1,0.458,0.351,0.184,319
consistency,1.041,36,232,1,1,0.714,0.5,0.887,268
octopus,1.041,9,62,1,1,0.713,0.378,0.411,71
postponed,1.041,9,62,1,1,0.439,0.327,0.402,71
inviting,1.04,97,617,1,1,0.938,0.571,0.538,714
humbly,1.039,12,81,1,1,0.771,0.194,0.37,93
stride,1.039,12,81,1,1,0.49,0.67,0.434,93
wretched,1.039,25,163,1,1,0.135,0.56,0.19,188
coast,1.039,106,674,1,1,0.719,0.396,0.458,780
akin,1.039,28,182,1,1,0.639,0.343,0.523,210
enhance,1.038,21,138,1,1,0.802,0.578,0.814,159
revolutionary,1.038,21,138,1,1,0.635,0.887,0.824,159
perpetually,1.037,24,157,1,1,0.51,0.473,0.868,181
aloof,1.037,24,157,1,1,0.189,0.423,0.302,181
underneath,1.037,55,353,1,1,0.45,0.265,0.158,408
tempting,1.037,39,252,1,1,0.615,0.74,0.519,291
classic,1.036,153,974,1,1,0.69,0.26,0.611,1127
energize,1.035,5,37,1,1,0.792,0.81,0.875,42
stint,1.035,8,56,1,1,0.49,0.326,0.342,64
catalog,1.035,8,56,1,1,0.561,0.221,0.573,64
shudder,1.035,14,94,1,1,0.344,0.791,0.559,108
prolong,1.035,8,56,1,1,0.573,0.567,0.535,64
swoon,1.035,5,37,1,1,0.292,0.51,0.16,42
jumbled,1.035,5,37,1,1,0.292,0.602,0.445,42
playa,1.035,11,75,1,1,0.724,0.51,0.575,86
suffocate,1.035,26,170,1,1,0.219,0.764,0.44,196
laurel,1.035,8,56,1,1,0.646,0.146,0.302,64
scripture,1.035,47,303,1,1,0.745,0.27,0.63,350
apathy,1.035,26,170,1,1,0.184,0.212,0.204,196
blitz,1.035,5,37,1,1,0.417,0.722,0.789,42
immortal,1.035,56,360,1,1,0.812,0.75,0.795,416
prostitution,1.035,5,37,1,1,0.125,0.843,0.475,42
relentless,1.035,35,227,1,1,0.333,0.713,0.904,262
rendition,1.035,11,75,1,1,0.417,0.36,0.398,86
crane,1.035,5,37,1,1,0.396,0.417,0.589,42
innocuous,1.035,5,37,1,1,0.51,0.321,0.172,42
beware,1.034,57,367,1,1,0.151,0.596,0.518,424
enlightened,1.033,25,164,1,1,0.956,0.566,0.7,189
groove,1.033,22,145,1,1,0.552,0.448,0.361,167
crippled,1.032,16,107,1,1,0.035,0.358,0.236,123
cup,1.032,361,2299,1,1,0.615,0.167,0.231,2660
invitation,1.032,58,374,1,1,0.802,0.549,0.647,432
spending,1.032,1008,6413,1,1,0.333,0.556,0.33,7421
decipher,1.032,13,88,1,1,0.417,0.63,0.652,101
pleasing,1.031,52,336,1,1,0.917,0.449,0.788,388
par,1.031,60,387,1,1,0.615,0.372,0.429,447
mistress,1.031,35,228,1,1,0.63,0.796,0.694,263
bearing,1.031,35,228,1,1,0.571,0.367,0.474,263
dimensional,1.031,10,69,1,1,0.561,0.484,0.596,79
ness,1.031,21,139,1,1,0.396,0.48,0.392,160
requirement,1.031,32,209,1,1,0.51,0.439,0.728,241
blade,1.03,51,330,1,1,0.378,0.602,0.594,381
pact,1.03,29,190,1,1,0.442,0.444,0.593,219
pint,1.03,26,171,1,1,0.686,0.333,0.321,197
choosy,1.029,7,50,1,1,0.28,0.76,0.712,57
provoked,1.029,7,50,1,1,0.271,0.676,0.528,57
shoveling,1.029,7,50,1,1,0.265,0.62,0.537,57
overrun,1.029,7,50,1,1,0.271,0.764,0.598,57
barred,1.029,7,50,1,1,0.143,0.741,0.535,57
exasperated,1.029,7,50,1,1,0.229,0.816,0.377,57
tethered,1.029,7,50,1,1,0.26,0.472,0.351,57
wolf,1.029,230,1472,1,1,0.448,0.712,0.63,1702
translation,1.028,81,522,1,1,0.633,0.435,0.598,603
communication,1.028,213,1364,1,1,0.837,0.4,0.649,1577
acceptance,1.028,176,1128,1,1,0.833,0.287,0.755,1304
restored,1.028,28,184,1,1,0.892,0.41,0.728,212
drum,1.028,33,216,1,1,0.615,0.679,0.339,249
glamorous,1.027,12,82,1,1,0.918,0.63,0.791,94
archive,1.027,12,82,1,1,0.438,0.294,0.527,94
religion,1.027,279,1788,1,1,0.646,0.32,0.755,2067
elephant,1.025,62,402,1,1,0.531,0.51,0.615,464
inning,1.025,4,31,1,1,0.602,0.315,0.52,35
tangerine,1.025,4,31,1,1,0.571,0.271,0.395,35
scorpion,1.025,9,63,1,1,0.198,0.745,0.6,72
perplexing,1.025,4,31,1,1,0.316,0.53,0.362,35
presumptuous,1.025,4,31,1,1,0.265,0.596,0.616,35
cyberspace,1.025,4,31,1,1,0.677,0.594,0.611,35
heist,1.025,4,31,1,1,0.184,0.85,0.645,35
instruct,1.025,4,31,1,1,0.729,0.49,0.833,35
maze,1.025,34,223,1,1,0.438,0.608,0.444,257
fruity,1.025,4,31,1,1,0.683,0.414,0.33,35
haywire,1.025,4,31,1,1,0.358,0.545,0.43,35
presentable,1.025,4,31,1,1,0.836,0.311,0.643,35
railing,1.025,4,31,1,1,0.551,0.298,0.44,35
detract,1.025,4,31,1,1,0.344,0.438,0.368,35
thrill,1.025,29,191,1,1,0.888,0.837,0.711,220
grinder,1.025,4,31,1,1,0.459,0.615,0.561,35
engage,1.024,148,953,1,1,0.771,0.796,0.713,1101
oblivious,1.024,41,268,1,1,0.229,0.388,0.355,309
madness,1.024,213,1370,1,1,0.104,0.804,0.44,1583
hound,1.023,16,108,1,1,0.417,0.528,0.582,124
destruction,1.023,96,621,1,1,0.102,0.929,0.613,717
babbling,1.022,11,76,1,1,0.396,0.418,0.241,87
artificial,1.022,23,153,1,1,0.306,0.385,0.351,176
terrace,1.022,11,76,1,1,0.615,0.269,0.411,87
extraordinary,1.022,61,397,1,1,0.969,0.728,0.86,458
demeanor,1.022,18,121,1,1,0.633,0.433,0.657,139
achieved,1.022,94,609,1,1,0.896,0.519,0.775,703
deadly,1.021,60,391,1,1,0.143,0.849,0.554,451
racking,1.02,6,44,1,1,0.411,0.442,0.375,50
flair,1.02,6,44,1,1,0.775,0.471,0.676,50
parole,1.02,6,44,1,1,0.388,0.62,0.526,50
smite,1.02,6,44,1,1,0.303,0.846,0.682,50
compartment,1.02,6,44,1,1,0.5,0.389,0.607,50
anointing,1.02,6,44,1,1,0.653,0.35,0.547,50
obliged,1.02,13,89,1,1,0.327,0.68,0.411,102
immunity,1.02,6,44,1,1,0.633,0.316,0.786,50
compelling,1.02,27,179,1,1,0.698,0.57,0.87,206
critique,1.019,22,147,1,1,0.302,0.76,0.537,169
poisonous,1.019,22,147,1,1,0.102,0.87,0.533,169
cluster,1.019,15,102,1,1,0.49,0.458,0.446,117
messiah,1.019,15,102,1,1,0.781,0.634,0.8,117
align,1.019,31,205,1,1,0.656,0.364,0.627,236
assert,1.018,8,57,1,1,0.75,0.619,0.809,65
armchair,1.018,8,57,1,1,0.646,0.164,0.339,65
retract,1.018,8,57,1,1,0.316,0.443,0.358,65
indifferent,1.017,30,199,1,1,0.396,0.157,0.25,229
ere,1.016,10,70,1,1,0.479,0.312,0.377,80
creaking,1.016,10,70,1,1,0.302,0.743,0.415,80
chai,1.016,21,141,1,1,0.5,0.375,0.363,162
segregation,1.016,10,70,1,1,0.302,0.545,0.39,80
cramped,1.016,10,70,1,1,0.24,0.567,0.36,80
catastrophe,1.015,12,83,1,1,0.146,0.952,0.67,95
charisma,1.015,12,83,1,1,0.938,0.591,0.759,95
insanity,1.015,102,665,1,1,0.098,0.847,0.337,767
carnival,1.014,16,109,1,1,0.927,0.888,0.555,125
persistence,1.014,16,109,1,1,0.684,0.611,0.873,125
analyze,1.014,33,219,1,1,0.667,0.462,0.71,252
weakness,1.014,289,1876,1,1,0.088,0.37,0.125,2165
sailor,1.013,20,135,1,1,0.5,0.588,0.5,155
superpower,1.012,24,161,1,1,0.806,0.784,0.972,185
subjective,1.012,28,187,1,1,0.51,0.35,0.432,215
establish,1.011,36,239,1,1,0.708,0.5,0.688,275
pen,1.01,112,733,1,1,0.622,0.194,0.25,845
affluent,1.009,3,25,1,1,0.756,0.388,0.477,28
interrogate,1.009,3,25,1,1,0.323,0.808,0.68,28
intergalactic,1.009,3,25,1,1,0.562,0.661,0.741,28
deluxe,1.009,7,51,1,1,0.792,0.612,0.755,58
developing,1.009,69,454,1,1,0.833,0.587,0.714,523
broaden,1.009,5,38,1,1,0.678,0.602,0.61,43
dent,1.009,9,64,1,1,0.306,0.606,0.325,73
persecution,1.009,17,116,1,1,0.229,0.865,0.66,133
bonfire,1.009,9,64,1,1,0.48,0.719,0.473,73
cache,1.009,3,25,1,1,0.552,0.348,0.389,28
visage,1.009,9,64,1,1,0.7,0.361,0.482,73
intercourse,1.009,5,38,1,1,0.551,0.608,0.557,43
compression,1.009,3,25,1,1,0.646,0.521,0.579,28
simulated,1.009,3,25,1,1,0.5,0.461,0.356,28
litigation,1.009,3,25,1,1,0.388,0.76,0.602,28
triad,1.009,3,25,1,1,0.469,0.413,0.528,28
foresight,1.009,5,38,1,1,0.68,0.482,0.64,43
grapple,1.009,7,51,1,1,0.49,0.577,0.482,58
comparative,1.009,3,25,1,1,0.47,0.273,0.562,28
chalet,1.009,3,25,1,1,0.653,0.349,0.278,28
intercede,1.009,3,25,1,1,0.582,0.577,0.63,28
avenge,1.009,5,38,1,1,0.073,0.867,0.559,43
silk,1.009,19,129,1,1,0.76,0.115,0.3,148
fluorescent,1.009,3,25,1,1,0.602,0.595,0.5,28
hostility,1.009,13,90,1,1,0.122,0.775,0.465,103
neglecting,1.009,23,155,1,1,0.177,0.441,0.23,178
unwise,1.009,5,38,1,1,0.141,0.61,0.304,43
ley,1.009,3,25,1,1,0.604,0.389,0.764,28
infertile,1.009,5,38,1,1,0.274,0.458,0.255,43
float,1.009,51,337,1,1,0.688,0.394,0.344,388
obligatory,1.009,13,90,1,1,0.337,0.571,0.78,103
specter,1.009,3,25,1,1,0.265,0.723,0.54,28
rooster,1.009,5,38,1,1,0.459,0.385,0.275,43
tgif,1.009,3,25,1,1,0.542,0.471,0.436,28
incurable,1.009,11,77,1,1,0.104,0.667,0.255,88
custard,1.009,5,38,1,1,0.618,0.26,0.293,43
parlor,1.009,3,25,1,1,0.5,0.327,0.366,28
frequent,1.008,52,344,1,1,0.594,0.481,0.525,396
expression,1.007,127,833,1,1,0.79,0.65,0.721,960
affair,1.007,53,351,1,1,0.52,0.459,0.657,404
plague,1.006,49,325,1,1,0.083,0.596,0.355,374
rhythm,1.006,72,475,1,1,0.771,0.759,0.573,547
mankind,1.004,57,378,1,1,0.823,0.471,0.768,435
salt,1.003,90,594,1,1,0.323,0.312,0.306,684
femme,1.003,12,84,1,1,0.551,0.529,0.398,96
alter,1.003,47,313,1,1,0.333,0.694,0.654,360
residence,1.001,28,189,1,1,0.615,0.382,0.585,217
seeds,1.001,37,248,1,1,0.731,0.269,0.418,285
static,1.001,26,176,1,1,0.297,0.25,0.366,202
skepticism,1.001,8,58,1,1,0.229,0.48,0.582,66
devout,1.001,8,58,1,1,0.62,0.357,0.464,66
impending,0.999,22,150,1,1,0.48,0.735,0.752,172
slaughter,0.998,20,137,1,1,0.052,0.953,0.602,157
wildfire,0.998,6,45,1,1,0.14,0.929,0.552,51
monarchy,0.998,6,45,1,1,0.45,0.557,0.87,51
outskirts,0.998,20,137,1,1,0.474,0.519,0.312,157
rain,0.998,726,4779,1,1,0.542,0.388,0.33,5505
price,0.997,259,1710,1,1,0.479,0.475,0.535,1969
cheery,0.997,11,78,1,1,0.949,0.657,0.486,89
space,0.996,2972,19583,1,1,0.8,0.317,0.573,22555
robe,0.995,21,144,1,1,0.594,0.216,0.298,165
flower,0.995,141,935,1,1,0.802,0.189,0.254,1076
leads,0.995,243,1608,1,1,0.53,0.471,0.615,1851
guards,0.995,51,342,1,1,0.448,0.663,0.72,393
bubble,0.994,181,1200,1,1,0.774,0.213,0.364,1381
malaise,0.994,4,32,1,1,0.15,0.6,0.161,36
reliability,0.994,4,32,1,1,0.917,0.38,0.696,36
immovable,0.994,4,32,1,1,0.48,0.31,0.571,36
gratuitous,0.994,4,32,1,1,0.735,0.65,0.452,36
agape,0.994,4,32,1,1,0.612,0.529,0.464,36
submarine,0.994,4,32,1,1,0.572,0.481,0.549,36
weeding,0.994,4,32,1,1,0.458,0.528,0.454,36
clink,0.994,4,32,1,1,0.458,0.462,0.319,36
ragged,0.994,9,65,1,1,0.198,0.519,0.226,74
frosted,0.994,4,32,1,1,0.748,0.471,0.218,36
rifles,0.994,4,32,1,1,0.337,0.864,0.765,36
peak,0.993,113,752,1,1,0.5,0.345,0.431,865
photo,0.993,383,2537,1,1,0.729,0.327,0.431,2920
branch,0.993,58,389,1,1,0.538,0.206,0.25,447
raft,0.992,12,85,1,1,0.51,0.229,0.228,97
ruins,0.992,77,515,1,1,0.25,0.49,0.248,592
triumph,0.992,25,171,1,1,0.969,0.798,0.926,196
plantation,0.99,7,52,1,1,0.573,0.585,0.575,59
energetic,0.99,31,211,1,1,0.847,0.868,0.902,242
crank,0.99,15,105,1,1,0.448,0.275,0.417,120
obligation,0.989,40,271,1,1,0.222,0.596,0.718,311
path,0.989,799,5307,1,1,0.59,0.245,0.421,6106
redundant,0.989,10,72,1,1,0.21,0.5,0.527,82
muffled,0.989,10,72,1,1,0.479,0.33,0.421,82
acknowledgment,0.989,10,72,1,1,0.796,0.528,0.777,82
abysmal,0.989,10,72,1,1,0.25,0.71,0.598,82
impromptu,0.989,10,72,1,1,0.541,0.729,0.415,82
intentionally,0.988,69,464,1,1,0.45,0.676,0.696,533
private,0.988,507,3374,1,1,0.661,0.422,0.644,3881
language,0.987,379,2524,1,1,0.677,0.337,0.704,2903
generosity,0.987,19,132,1,1,0.958,0.443,0.692,151
deceit,0.987,19,132,1,1,0.02,0.696,0.343,151
portal,0.987,19,132,1,1,0.583,0.347,0.547,151
redemption,0.986,42,285,1,1,0.376,0.408,0.545,327
aggression,0.986,25,172,1,1,0.094,0.929,0.533,197
agony,0.986,86,578,1,1,0.083,0.775,0.393,664
unscathed,0.984,5,39,1,1,0.625,0.308,0.611,44
expire,0.984,8,59,1,1,0.573,0.745,0.702,67
elevate,0.984,23,159,1,1,0.812,0.5,0.804,182
relevance,0.984,14,99,1,1,0.71,0.599,0.791,113
canine,0.984,5,39,1,1,0.573,0.569,0.425,44
lamenting,0.984,11,79,1,1,0.156,0.39,0.254,90
stifle,0.984,5,39,1,1,0.24,0.764,0.427,44
cautiously,0.984,8,59,1,1,0.51,0.388,0.525,67
sequence,0.984,20,139,1,1,0.543,0.35,0.529,159
loathing,0.984,47,319,1,1,0.083,0.796,0.368,366
observation,0.984,65,439,1,1,0.633,0.433,0.667,504
nexus,0.984,5,39,1,1,0.496,0.368,0.412,44
fascinated,0.984,26,179,1,1,0.812,0.714,0.788,205
optics,0.984,11,79,1,1,0.562,0.286,0.58,90
review,0.984,135,906,1,1,0.667,0.408,0.636,1041
weight,0.984,683,4561,1,1,0.45,0.38,0.577,5244
reminiscing,0.982,30,206,1,1,0.688,0.431,0.418,236
unhappiness,0.982,24,166,1,1,0.083,0.63,0.222,190
comfort,0.982,2528,16897,1,1,0.863,0.231,0.67,19425
lethal,0.981,18,126,1,1,0.156,0.8,0.745,144
land,0.981,344,2306,1,1,0.582,0.26,0.616,2650
treadmill,0.981,15,106,1,1,0.459,0.636,0.436,121
genie,0.98,12,86,1,1,0.76,0.6,0.908,98
myth,0.98,51,347,1,1,0.458,0.432,0.338,398
redhead,0.98,12,86,1,1,0.677,0.549,0.518,98
pseudo,0.98,12,86,1,1,0.367,0.389,0.282,98
watcher,0.98,12,86,1,1,0.562,0.401,0.702,98
heavenly,0.98,78,528,1,1,0.844,0.452,0.712,606
drift,0.98,65,441,1,1,0.316,0.52,0.375,506
paddy,0.979,9,66,1,1,0.653,0.33,0.33,75
infectious,0.979,9,66,1,1,0.142,0.76,0.422,75
sharpen,0.979,9,66,1,1,0.582,0.694,0.611,75
pry,0.978,16,113,1,1,0.406,0.482,0.5,129
fertility,0.978,23,160,1,1,0.885,0.529,0.726,183
finding,0.978,1383,9286,1,1,0.796,0.469,0.664,10669
retirement,0.977,79,536,1,1,0.25,0.324,0.255,615
agile,0.977,6,46,1,1,0.8,0.657,0.775,52
grouchy,0.977,6,46,1,1,0.143,0.708,0.407,52
mesa,0.977,6,46,1,1,0.604,0.191,0.319,52
agriculture,0.977,6,46,1,1,0.64,0.357,0.465,52
astray,0.977,13,93,1,1,0.098,0.676,0.308,106
monogamy,0.977,13,93,1,1,0.542,0.38,0.455,106
tortoise,0.977,6,46,1,1,0.673,0.078,0.25,52
contrived,0.977,6,46,1,1,0.408,0.53,0.458,52
utilize,0.976,17,120,1,1,0.694,0.445,0.545,137
noose,0.975,10,73,1,1,0.356,0.3,0.33,83
aesthetics,0.975,10,73,1,1,0.847,0.327,0.549,83
hawk,0.974,14,100,1,1,0.583,0.53,0.631,114
colony,0.974,14,100,1,1,0.716,0.353,0.593,114
noble,0.974,48,329,1,1,0.906,0.345,0.61,377
subtle,0.974,67,457,1,1,0.708,0.167,0.228,524
concrete,0.974,56,383,1,1,0.633,0.42,0.547,439
spirit,0.973,834,5626,1,1,0.786,0.37,0.621,6460
contain,0.973,45,309,1,1,0.542,0.49,0.658,354
quote,0.973,334,2258,1,1,0.68,0.55,0.43,2592
glum,0.972,3,26,1,1,0.244,0.337,0.123,29
propagate,0.972,3,26,1,1,0.561,0.609,0.63,29
bulletin,0.972,3,26,1,1,0.573,0.294,0.361,29
quagmire,0.972,3,26,1,1,0.318,0.48,0.413,29
battalion,0.972,3,26,1,1,0.333,0.818,0.795,29
revolver,0.972,3,26,1,1,0.194,0.796,0.75,29
adaptable,0.972,3,26,1,1,0.735,0.423,0.641,29
bouncy,0.972,3,26,1,1,0.562,0.565,0.429,29
corrupting,0.972,3,26,1,1,0.062,0.804,0.38,29
flaring,0.972,3,26,1,1,0.625,0.771,0.509,29
rue,0.972,7,53,1,1,0.323,0.394,0.246,60
vessel,0.972,27,188,1,1,0.49,0.398,0.538,215
flamingo,0.972,3,26,1,1,0.667,0.451,0.482,29
camper,0.972,11,80,1,1,0.573,0.529,0.482,91
cattle,0.972,11,80,1,1,0.622,0.34,0.445,91
crass,0.972,7,53,1,1,0.223,0.49,0.466,60
golfer,0.972,3,26,1,1,0.602,0.402,0.578,29
bulge,0.972,3,26,1,1,0.26,0.487,0.4,29
dibs,0.972,3,26,1,1,0.51,0.41,0.391,29
prescribe,0.972,7,53,1,1,0.459,0.55,0.618,60
whimper,0.972,7,53,1,1,0.271,0.545,0.308,60
quarters,0.972,19,134,1,1,0.51,0.412,0.48,153
ninety,0.972,3,26,1,1,0.479,0.349,0.436,29
palatable,0.972,3,26,1,1,0.823,0.5,0.594,29
glossy,0.972,3,26,1,1,0.802,0.519,0.807,29
rosy,0.972,7,53,1,1,0.94,0.528,0.755,60
averse,0.972,3,26,1,1,0.253,0.569,0.492,29
eavesdrop,0.972,3,26,1,1,0.375,0.71,0.368,29
location,0.971,137,931,1,1,0.615,0.375,0.546,1068
hollow,0.971,73,499,1,1,0.3,0.337,0.222,572
shunned,0.971,36,249,1,1,0.271,0.464,0.367,285
coupled,0.97,28,195,1,1,0.612,0.286,0.65,223
extended,0.97,137,932,1,1,0.57,0.304,0.649,1069
innovative,0.969,16,114,1,1,0.88,0.64,0.83,130
essay,0.969,84,574,1,1,0.559,0.411,0.53,658
indicator,0.969,12,87,1,1,0.573,0.451,0.67,99
thoughtful,0.969,77,527,1,1,0.667,0.29,0.527,604
unannounced,0.969,12,87,1,1,0.24,0.588,0.291,99
concentrate,0.968,78,534,1,1,0.75,0.439,0.743,612
sinking,0.968,101,690,1,1,0.135,0.439,0.342,791
advancing,0.968,8,60,1,1,0.929,0.608,0.812,68
feeble,0.968,8,60,1,1,0.157,0.28,0.109,68
hare,0.968,8,60,1,1,0.62,0.41,0.345,68
faction,0.968,8,60,1,1,0.469,0.43,0.448,68
decaying,0.968,8,60,1,1,0.073,0.51,0.214,68
sag,0.967,22,155,1,1,0.153,0.578,0.445,177
tormented,0.967,22,155,1,1,0.071,0.855,0.323,177
resemble,0.966,13,94,1,1,0.602,0.388,0.463,107
mat,0.966,37,257,1,1,0.459,0.221,0.304,294
rival,0.966,18,128,1,1,0.286,0.605,0.574,146
com,0.966,85,583,1,1,0.396,0.382,0.382,668
climb,0.965,110,753,1,1,0.615,0.66,0.604,863
recover,0.965,179,1222,1,1,0.918,0.51,0.647,1401
remarkable,0.965,38,264,1,1,0.88,0.573,0.72,302
retrieve,0.964,9,67,1,1,0.74,0.576,0.705,76
reproduction,0.964,4,33,1,1,0.8,0.736,0.713,37
query,0.964,14,101,1,1,0.521,0.42,0.467,115
mustang,0.964,4,33,1,1,0.635,0.642,0.708,37
simmer,0.964,4,33,1,1,0.65,0.293,0.393,37
helplessness,0.964,24,169,1,1,0.087,0.48,0.25,193
substantive,0.964,4,33,1,1,0.5,0.35,0.455,37
regulated,0.964,4,33,1,1,0.531,0.269,0.483,37
dragon,0.964,129,883,1,1,0.541,0.821,0.712,1012
traps,0.963,20,142,1,1,0.235,0.673,0.481,162
triangle,0.962,15,108,1,1,0.562,0.269,0.352,123
unbearable,0.962,125,858,1,1,0.125,0.798,0.447,983
nuance,0.962,10,74,1,1,0.408,0.282,0.411,84
orgasm,0.962,21,149,1,1,0.844,0.863,0.676,170
remain,0.961,516,3526,1,1,0.709,0.365,0.731,4042
violin,0.961,16,115,1,1,0.823,0.396,0.389,131
storytelling,0.96,22,156,1,1,0.643,0.375,0.472,178
processing,0.96,52,361,1,1,0.726,0.774,0.711,413
mire,0.959,5,40,1,1,0.344,0.376,0.298,45
chow,0.959,5,40,1,1,0.573,0.49,0.39,45
retaliate,0.959,5,40,1,1,0.111,0.812,0.595,45
tart,0.959,5,40,1,1,0.719,0.38,0.219,45
courtroom,0.959,5,40,1,1,0.385,0.67,0.887,45
freight,0.959,5,40,1,1,0.411,0.528,0.49,45
syndicate,0.959,5,40,1,1,0.439,0.491,0.673,45
comatose,0.959,5,40,1,1,0.143,0.438,0.433,45
rink,0.959,5,40,1,1,0.551,0.392,0.392,45
seminary,0.959,5,40,1,1,0.594,0.367,0.589,45
reappear,0.959,5,40,1,1,0.688,0.625,0.632,45
manifested,0.959,11,81,1,1,0.58,0.618,0.667,92
distort,0.959,5,40,1,1,0.1,0.74,0.366,45
talkative,0.959,42,293,1,1,0.562,0.673,0.535,335
submission,0.958,24,170,1,1,0.531,0.58,0.633,194
fifty,0.958,24,170,1,1,0.571,0.368,0.439,194
rugby,0.958,18,129,1,1,0.677,0.82,0.708,147
nudity,0.958,12,88,1,1,0.438,0.853,0.415,100
ruth,0.957,32,225,1,1,0.469,0.427,0.444,257
ideal,0.957,151,1040,1,1,0.802,0.437,0.736,1191
flame,0.957,73,506,1,1,0.448,0.574,0.615,579
discourse,0.957,33,232,1,1,0.41,0.55,0.803,265
postcard,0.956,6,47,1,1,0.822,0.292,0.39,53
profess,0.956,6,47,1,1,0.633,0.42,0.643,53
unacknowledged,0.956,6,47,1,1,0.24,0.269,0.116,53
slope,0.956,13,95,1,1,0.347,0.438,0.279,108
flowery,0.956,6,47,1,1,0.792,0.332,0.446,53
summarize,0.956,6,47,1,1,0.59,0.323,0.471,53
faint,0.955,57,397,1,1,0.063,0.429,0.167,454
brotherhood,0.955,28,198,1,1,0.99,0.471,0.76,226
calm,0.955,729,5010,1,1,0.875,0.1,0.282,5739
hone,0.955,14,102,1,1,0.688,0.392,0.473,116
introduction,0.954,22,157,1,1,0.612,0.413,0.64,179
lamp,0.954,46,322,1,1,0.51,0.26,0.309,368
menace,0.953,15,109,1,1,0.125,0.894,0.759,124
dual,0.953,15,109,1,1,0.573,0.33,0.384,124
swan,0.952,16,116,1,1,0.781,0.225,0.357,132
exercise,0.952,166,1149,1,1,0.75,0.789,0.625,1315
extreme,0.951,241,1666,1,1,0.318,0.8,0.721,1907
advancement,0.951,8,61,1,1,0.776,0.65,0.839,69
sickly,0.951,8,61,1,1,0.188,0.55,0.191,69
fiddle,0.951,8,61,1,1,0.571,0.449,0.391,69
endangered,0.951,8,61,1,1,0.083,0.885,0.43,69
shack,0.951,27,192,1,1,0.396,0.425,0.339,219
pollution,0.95,18,130,1,1,0.062,0.694,0.445,148
righteousness,0.95,18,130,1,1,0.802,0.66,0.897,148
habit,0.95,279,1931,1,1,0.625,0.226,0.585,2210
unfriendly,0.95,9,68,1,1,0.173,0.67,0.458,77
hybrid,0.949,20,144,1,1,0.5,0.365,0.57,164
wine,0.949,497,3438,1,1,0.792,0.417,0.457,3935
lawn,0.949,31,220,1,1,0.686,0.153,0.192,251
intersection,0.948,10,75,1,1,0.344,0.541,0.658,85
barge,0.948,10,75,1,1,0.469,0.388,0.465,85
excel,0.948,22,158,1,1,0.561,0.363,0.466,180
voluntarily,0.947,23,165,1,1,0.847,0.46,0.527,188
develop,0.946,154,1072,1,1,0.771,0.67,0.821,1226
dopamine,0.946,12,89,1,1,0.548,0.469,0.426,101
shovel,0.946,13,96,1,1,0.427,0.308,0.267,109
arrogance,0.945,43,304,1,1,0.143,0.75,0.62,347
frequency,0.945,30,214,1,1,0.561,0.557,0.537,244
harbor,0.944,16,117,1,1,0.594,0.356,0.634,133
periodically,0.944,16,117,1,1,0.48,0.314,0.515,133
beloved,0.943,213,1485,1,1,0.969,0.613,0.708,1698
annoyance,0.943,35,249,1,1,0.167,0.718,0.342,284
starter,0.943,54,381,1,1,0.667,0.461,0.827,435
operate,0.943,37,263,1,1,0.582,0.69,0.691,300
owl,0.943,56,395,1,1,0.52,0.27,0.321,451
protective,0.943,57,402,1,1,0.844,0.459,0.86,459
grill,0.942,19,138,1,1,0.755,0.491,0.546,157
consist,0.942,22,159,1,1,0.823,0.386,0.58,181
epitome,0.941,23,166,1,1,0.51,0.5,0.667,189
decay,0.941,25,180,1,1,0.143,0.312,0.17,205
curse,0.94,245,1713,1,1,0.033,0.72,0.375,1958
stem,0.939,39,278,1,1,0.615,0.191,0.336,317
buzz,0.938,44,313,1,1,0.333,0.686,0.375,357
energy,0.936,1599,11192,1,1,0.944,0.725,0.868,12791
estrogen,0.935,3,27,1,1,0.58,0.5,0.425,30
unprovoked,0.935,3,27,1,1,0.565,0.327,0.385,30
quill,0.935,5,41,1,1,0.521,0.216,0.263,46
remarkably,0.935,9,69,1,1,0.688,0.618,0.868,78
sic,0.935,6,48,1,1,0.37,0.459,0.38,54
demos,0.935,5,41,1,1,0.418,0.37,0.368,46
latent,0.935,3,27,1,1,0.469,0.5,0.653,30
rum,0.935,17,125,1,1,0.561,0.377,0.451,142
pasture,0.935,4,34,1,1,0.688,0.145,0.17,38
efficiency,0.935,11,83,1,1,0.802,0.509,0.892,94
sparring,0.935,3,27,1,1,0.292,0.87,0.704,30
bandwidth,0.935,4,34,1,1,0.714,0.337,0.548,38
blowjob,0.935,3,27,1,1,0.46,0.784,0.387,30
repetition,0.935,12,90,1,1,0.375,0.519,0.396,102
notoriety,0.935,3,27,1,1,0.552,0.633,0.769,30
persuasive,0.935,4,34,1,1,0.74,0.7,0.657,38
plum,0.935,4,34,1,1,0.724,0.306,0.17,38
censure,0.935,3,27,1,1,0.219,0.653,0.417,30
mammal,0.935,4,34,1,1,0.618,0.449,0.421,38
columnist,0.935,3,27,1,1,0.646,0.365,0.648,30
modesty,0.935,4,34,1,1,0.778,0.24,0.5,38
troop,0.935,5,41,1,1,0.375,0.696,0.75,46
shaken,0.935,32,230,1,1,0.344,0.657,0.333,262
pear,0.935,3,27,1,1,0.677,0.158,0.241,30
barbarian,0.935,4,34,1,1,0.323,0.896,0.713,38
fixer,0.935,4,34,1,1,0.633,0.375,0.606,38
ruffle,0.935,4,34,1,1,0.443,0.561,0.518,38
earrings,0.935,8,62,1,1,0.676,0.346,0.517,70
extinguish,0.935,3,27,1,1,0.24,0.576,0.482,30
mimicking,0.935,4,34,1,1,0.316,0.433,0.364,38
shitfaced,0.935,3,27,1,1,0.214,0.695,0.38,30
modeling,0.935,10,76,1,1,0.684,0.404,0.49,86
preacher,0.935,13,97,1,1,0.551,0.388,0.741,110
lac,0.935,3,27,1,1,0.408,0.418,0.331,30
cruising,0.935,8,62,1,1,0.886,0.58,0.56,70
portable,0.935,8,62,1,1,0.615,0.356,0.582,70
wavering,0.935,5,41,1,1,0.375,0.43,0.384,46
procreation,0.935,3,27,1,1,0.792,0.714,0.787,30
influx,0.935,4,34,1,1,0.622,0.635,0.575,38
bewilderment,0.935,5,41,1,1,0.312,0.716,0.216,46
rodent,0.935,3,27,1,1,0.323,0.577,0.279,30
spacing,0.935,6,48,1,1,0.621,0.425,0.507,54
apocalyptic,0.935,11,83,1,1,0.173,0.88,0.75,94
extensive,0.935,16,118,1,1,0.635,0.52,0.76,134
socket,0.935,4,34,1,1,0.583,0.469,0.377,38
pagan,0.935,10,76,1,1,0.292,0.578,0.542,86
plethora,0.935,12,90,1,1,0.646,0.602,0.547,102
soc,0.935,7,55,1,1,0.427,0.431,0.38,62
dissent,0.935,7,55,1,1,0.3,0.655,0.407,62
fiesta,0.935,4,34,1,1,0.927,0.779,0.655,38
inhumane,0.935,22,160,1,1,0.104,0.587,0.402,182
congestion,0.935,4,34,1,1,0.271,0.654,0.491,38
spoils,0.935,10,76,1,1,0.388,0.76,0.481,86
ordinary,0.934,85,602,1,1,0.375,0.312,0.286,687
frame,0.934,82,581,1,1,0.469,0.333,0.42,663
science,0.933,189,1332,1,1,0.588,0.429,0.741,1521
balcony,0.933,52,371,1,1,0.562,0.392,0.38,423
inability,0.932,95,673,1,1,0.15,0.529,0.25,768
resilience,0.932,38,273,1,1,0.531,0.44,0.667,311
tolerance,0.931,65,463,1,1,0.875,0.206,0.649,528
newspaper,0.931,30,217,1,1,0.602,0.283,0.444,247
resolve,0.93,74,527,1,1,0.71,0.472,0.75,601
arrow,0.929,23,168,1,1,0.439,0.39,0.454,191
exceptional,0.929,23,168,1,1,0.806,0.74,0.933,191
nightly,0.929,21,154,1,1,0.673,0.41,0.474,175
copy,0.929,153,1084,1,1,0.46,0.24,0.263,1237
timely,0.929,21,154,1,1,0.865,0.387,0.591,175
biblical,0.928,20,147,1,1,0.635,0.304,0.712,167
reign,0.927,35,253,1,1,0.806,0.567,0.873,288
bounds,0.927,16,119,1,1,0.378,0.426,0.604,135
conflict,0.926,94,670,1,1,0.335,0.906,0.471,764
self,0.926,3593,25388,1,1,0.704,0.37,0.5,28981
modest,0.925,13,98,1,1,0.76,0.13,0.412,111
lust,0.925,65,466,1,1,0.469,0.944,0.518,531
imply,0.924,25,183,1,1,0.542,0.67,0.533,208
condemn,0.924,36,261,1,1,0.102,0.793,0.625,297
nameless,0.923,11,84,1,1,0.344,0.28,0.164,95
bush,0.923,80,573,1,1,0.413,0.22,0.315,653
upward,0.922,10,77,1,1,0.792,0.481,0.62,87
mushy,0.922,10,77,1,1,0.52,0.2,0.182,87
rising,0.922,134,957,1,1,0.75,0.602,0.696,1091
unrest,0.921,9,70,1,1,0.102,0.577,0.231,79
object,0.921,59,425,1,1,0.531,0.356,0.375,484
unrelenting,0.921,9,70,1,1,0.5,0.79,0.875,79
fortnight,0.921,9,70,1,1,0.77,0.65,0.397,79
silver,0.921,98,702,1,1,0.684,0.451,0.615,800
tin,0.921,28,205,1,1,0.469,0.37,0.217,233
musician,0.92,37,269,1,1,0.816,0.509,0.618,306
unfinished,0.92,18,134,1,1,0.188,0.368,0.264,152
keen,0.92,44,319,1,1,0.823,0.719,0.806,363
cubicle,0.92,17,127,1,1,0.479,0.343,0.417,144
roe,0.92,8,63,1,1,0.49,0.382,0.398,71
sinister,0.92,17,127,1,1,0.125,0.896,0.581,144
thrice,0.92,8,63,1,1,0.469,0.442,0.462,71
alphabet,0.92,8,63,1,1,0.562,0.204,0.672,71
charade,0.92,8,63,1,1,0.458,0.55,0.346,71
assimilate,0.92,8,63,1,1,0.559,0.391,0.683,71
dynamic,0.919,43,312,1,1,0.724,0.75,0.836,355
upwards,0.919,16,120,1,1,0.724,0.439,0.638,136
involvement,0.919,16,120,1,1,0.76,0.62,0.696,136
medium,0.918,49,355,1,1,0.559,0.356,0.358,404
mending,0.918,7,56,1,1,0.5,0.633,0.657,63
melodrama,0.918,7,56,1,1,0.378,0.83,0.446,63
lsd,0.918,7,56,1,1,0.375,0.471,0.39,63
hover,0.918,7,56,1,1,0.51,0.431,0.404,63
bookmark,0.918,7,56,1,1,0.543,0.441,0.415,63
midway,0.918,7,56,1,1,0.459,0.316,0.304,63
motherless,0.918,7,56,1,1,0.163,0.541,0.337,63
eliminate,0.917,38,277,1,1,0.265,0.67,0.324,315
porch,0.917,53,384,1,1,0.535,0.324,0.388,437
nighttime,0.917,45,327,1,1,0.735,0.385,0.439,372
mourn,0.917,91,655,1,1,0.056,0.583,0.15,746
welcoming,0.916,74,534,1,1,0.905,0.527,0.636,608
whim,0.916,14,106,1,1,0.378,0.68,0.467,120
sunrise,0.916,155,1112,1,1,0.823,0.347,0.64,1267
terrific,0.916,21,156,1,1,0.859,0.65,0.821,177
meteor,0.915,6,49,1,1,0.398,0.714,0.737,55
rinse,0.915,13,99,1,1,0.663,0.168,0.409,112
collision,0.915,6,49,1,1,0.245,0.848,0.585,55
anticipate,0.915,13,99,1,1,0.622,0.469,0.667,112
stump,0.915,6,49,1,1,0.449,0.51,0.34,55
radiate,0.915,13,99,1,1,0.719,0.735,0.738,112
dose,0.915,88,635,1,1,0.458,0.49,0.427,723
gate,0.914,66,478,1,1,0.51,0.235,0.426,544
praises,0.914,19,142,1,1,0.878,0.491,0.75,161
rocks,0.914,118,850,1,1,0.365,0.209,0.543,968
ominous,0.914,12,92,1,1,0.255,0.73,0.51,104
undeniable,0.914,12,92,1,1,0.552,0.473,0.778,104
savage,0.912,54,393,1,1,0.204,0.931,0.605,447
incarnate,0.912,5,42,1,1,0.552,0.651,0.593,47
babble,0.912,5,42,1,1,0.552,0.441,0.204,47
libido,0.912,5,42,1,1,0.77,0.602,0.571,47
bookshop,0.912,5,42,1,1,0.688,0.291,0.389,47
pounce,0.912,5,42,1,1,0.49,0.657,0.518,47
biker,0.912,5,42,1,1,0.604,0.71,0.567,47
dynamite,0.912,5,42,1,1,0.344,0.86,0.783,47
floral,0.912,5,42,1,1,0.833,0.235,0.264,47
wavelength,0.912,11,85,1,1,0.604,0.442,0.516,96
anus,0.912,5,42,1,1,0.347,0.644,0.35,47
sincerity,0.912,29,214,1,1,0.908,0.351,0.686,243
precarious,0.912,5,42,1,1,0.107,0.54,0.273,47
detect,0.912,11,85,1,1,0.531,0.52,0.565,96
bond,0.912,213,1533,1,1,0.667,0.519,0.63,1746
precisely,0.911,46,336,1,1,0.816,0.388,0.714,382
statue,0.911,22,164,1,1,0.542,0.153,0.57,186
slavery,0.91,33,243,1,1,0.052,0.783,0.218,276
description,0.91,61,444,1,1,0.582,0.425,0.596,505
rejoin,0.91,10,78,1,1,0.655,0.548,0.556,88
psychic,0.91,32,236,1,1,0.49,0.559,0.726,268
scarce,0.91,10,78,1,1,0.292,0.324,0.218,88
orthodox,0.91,10,78,1,1,0.388,0.471,0.647,88
madman,0.91,10,78,1,1,0.135,0.88,0.312,88
treasure,0.91,191,1378,1,1,0.927,0.592,0.821,1569
disappearing,0.909,48,351,1,1,0.167,0.427,0.379,399
superhero,0.909,42,308,1,1,0.91,0.82,0.893,350
scattered,0.909,52,380,1,1,0.208,0.38,0.238,432
sole,0.907,74,539,1,1,0.427,0.194,0.279,613
styling,0.907,4,35,1,1,0.823,0.378,0.652,39
perfectionist,0.907,9,71,1,1,0.667,0.704,0.905,80
autopsy,0.907,4,35,1,1,0.252,0.65,0.538,39
conserve,0.907,4,35,1,1,0.69,0.347,0.573,39
unresponsive,0.907,4,35,1,1,0.108,0.282,0.244,39
breeding,0.907,14,107,1,1,0.667,0.481,0.61,121
reciprocal,0.907,4,35,1,1,0.677,0.52,0.66,39
seal,0.907,24,179,1,1,0.49,0.218,0.518,203
regrettable,0.907,4,35,1,1,0.104,0.374,0.245,39
microscopic,0.907,4,35,1,1,0.36,0.327,0.433,39
sightseeing,0.907,4,35,1,1,0.875,0.552,0.697,39
untimely,0.907,4,35,1,1,0.245,0.676,0.233,39
perfume,0.906,33,244,1,1,0.74,0.472,0.463,277
retain,0.906,18,136,1,1,0.367,0.451,0.63,154
barn,0.906,18,136,1,1,0.51,0.452,0.425,154
select,0.905,41,302,1,1,0.615,0.406,0.602,343
captive,0.905,13,100,1,1,0.235,0.558,0.411,113
proverb,0.905,13,100,1,1,0.714,0.26,0.518,113
minimal,0.904,40,295,1,1,0.448,0.147,0.206,335
solidified,0.904,8,64,1,1,0.633,0.415,0.745,72
indicating,0.904,8,64,1,1,0.745,0.339,0.555,72
embassy,0.904,17,129,1,1,0.622,0.333,0.758,146
clay,0.904,26,194,1,1,0.542,0.25,0.267,220
sobriety,0.904,35,259,1,1,0.68,0.31,0.583,294
butcher,0.904,8,64,1,1,0.5,0.575,0.608,72
selective,0.903,43,317,1,1,0.612,0.347,0.706,360
despair,0.903,268,1944,1,1,0.115,0.794,0.245,2212
conceal,0.903,12,93,1,1,0.312,0.436,0.306,105
affirm,0.902,16,122,1,1,0.745,0.509,0.731,138
desperation,0.902,71,520,1,1,0.125,0.904,0.419,591
inhale,0.902,20,151,1,1,0.427,0.34,0.492,171
fulfilled,0.901,56,412,1,1,0.896,0.48,0.676,468
intro,0.901,60,441,1,1,0.51,0.331,0.657,501
tedious,0.9,19,144,1,1,0.104,0.406,0.241,163
rigging,0.9,3,28,1,1,0.51,0.518,0.44,31
sedation,0.9,3,28,1,1,0.51,0.27,0.398,31
entail,0.9,3,28,1,1,0.484,0.63,0.645,31
unconnected,0.9,3,28,1,1,0.188,0.265,0.213,31
subliminal,0.9,3,28,1,1,0.41,0.528,0.464,31
ninth,0.9,3,28,1,1,0.49,0.212,0.396,31
measurable,0.9,3,28,1,1,0.604,0.41,0.602,31
periphery,0.9,3,28,1,1,0.469,0.36,0.366,31
thrash,0.9,3,28,1,1,0.26,0.51,0.472,31
readiness,0.9,3,28,1,1,0.708,0.531,0.7,31
mutt,0.9,3,28,1,1,0.418,0.408,0.387,31
radar,0.9,23,173,1,1,0.521,0.615,0.579,196
addendum,0.9,3,28,1,1,0.392,0.37,0.418,31
acid,0.9,31,231,1,1,0.265,0.642,0.566,262
disloyalty,0.9,3,28,1,1,0.187,0.716,0.267,31
interchangeable,0.9,3,28,1,1,0.615,0.459,0.526,31
reins,0.9,3,28,1,1,0.48,0.448,0.545,31
voucher,0.9,3,28,1,1,0.622,0.416,0.601,31
flock,0.9,31,231,1,1,0.5,0.546,0.543,262
librarian,0.9,11,86,1,1,0.625,0.135,0.509,97
mercenary,0.9,3,28,1,1,0.245,0.837,0.673,31
cavity,0.9,3,28,1,1,0.466,0.385,0.379,31
yacht,0.9,7,57,1,1,0.823,0.67,0.66,64
joys,0.9,86,630,1,1,0.981,0.643,0.651,716
teamwork,0.899,22,166,1,1,0.918,0.49,0.773,188
gathering,0.899,91,667,1,1,0.854,0.657,0.667,758
exposure,0.899,45,333,1,1,0.57,0.83,0.63,378
naturally,0.899,152,1110,1,1,0.854,0.276,0.549,1262
unread,0.898,14,108,1,1,0.458,0.24,0.214,122
slayer,0.897,10,79,1,1,0.041,0.93,0.661,89
hurried,0.897,10,79,1,1,0.314,0.806,0.393,89
villa,0.896,24,181,1,1,0.698,0.29,0.345,205
invaluable,0.896,24,181,1,1,0.74,0.5,0.745,205
unpack,0.895,13,101,1,1,0.531,0.528,0.445,114
grasshopper,0.895,6,50,1,1,0.5,0.462,0.287,56
cater,0.895,20,152,1,1,0.802,0.5,0.509,172
inception,0.895,6,50,1,1,0.604,0.425,0.561,56
cynicism,0.895,13,101,1,1,0.104,0.78,0.454,114
splash,0.895,13,101,1,1,0.521,0.412,0.281,114
earl,0.895,13,101,1,1,0.582,0.461,0.794,114
empire,0.895,69,509,1,1,0.688,0.73,0.944,578
measuring,0.893,9,72,1,1,0.448,0.337,0.529,81
nineteen,0.893,9,72,1,1,0.673,0.304,0.375,81
dunk,0.892,12,94,1,1,0.406,0.333,0.475,106
theology,0.892,12,94,1,1,0.448,0.33,0.711,106
letters,0.892,115,847,1,1,0.663,0.327,0.364,962
haul,0.891,18,138,1,1,0.551,0.564,0.453,156
sheer,0.891,62,460,1,1,0.604,0.25,0.481,522
dependency,0.891,21,160,1,1,0.429,0.365,0.356,181
napping,0.891,21,160,1,1,0.765,0.046,0.306,181
tension,0.89,51,380,1,1,0.304,0.81,0.529,431
leopard,0.889,11,87,1,1,0.542,0.755,0.611,98
pave,0.889,5,43,1,1,0.594,0.49,0.509,48
texture,0.889,11,87,1,1,0.615,0.215,0.412,98
superficial,0.889,35,263,1,1,0.357,0.407,0.309,298
wool,0.889,8,65,1,1,0.583,0.132,0.345,73
overpowering,0.889,5,43,1,1,0.392,0.779,0.589,48
confront,0.889,62,461,1,1,0.281,0.76,0.746,523
brightness,0.889,14,109,1,1,0.938,0.623,0.66,123
chapman,0.889,5,43,1,1,0.562,0.529,0.465,48
shabby,0.889,5,43,1,1,0.235,0.519,0.259,48
barefoot,0.889,11,87,1,1,0.445,0.373,0.241,98
disobedience,0.889,5,43,1,1,0.051,0.868,0.369,48
gallows,0.889,5,43,1,1,0.167,0.712,0.422,48
beads,0.889,5,43,1,1,0.673,0.388,0.552,48
fickle,0.889,11,87,1,1,0.406,0.481,0.346,98
outweigh,0.889,14,109,1,1,0.486,0.6,0.682,123
famine,0.889,5,43,1,1,0.163,0.679,0.31,48
sociology,0.889,8,65,1,1,0.615,0.439,0.694,73
complimentary,0.889,5,43,1,1,0.823,0.413,0.435,48
uncertain,0.888,49,366,1,1,0.363,0.5,0.164,415
toss,0.887,42,315,1,1,0.418,0.725,0.575,357
rehearsal,0.886,13,102,1,1,0.667,0.47,0.5,115
aspire,0.886,27,205,1,1,0.812,0.469,0.722,232
diva,0.885,10,80,1,1,0.66,0.657,0.596,90
margin,0.885,10,80,1,1,0.5,0.219,0.331,90
daze,0.885,10,80,1,1,0.245,0.735,0.329,90
contradict,0.885,10,80,1,1,0.16,0.598,0.482,90
malicious,0.884,18,139,1,1,0.177,0.765,0.607,157
satanic,0.884,18,139,1,1,0.062,0.843,0.72,157
instruction,0.883,15,117,1,1,0.656,0.434,0.736,132
acute,0.883,15,117,1,1,0.427,0.652,0.534,132
booming,0.883,7,58,1,1,0.688,0.554,0.661,65
boulder,0.883,7,58,1,1,0.461,0.309,0.531,65
errand,0.883,7,58,1,1,0.385,0.519,0.482,65
expendable,0.883,7,58,1,1,0.479,0.49,0.423,65
glance,0.883,47,353,1,1,0.625,0.357,0.454,400
arise,0.883,36,272,1,1,0.75,0.582,0.725,308
legendary,0.883,36,272,1,1,0.857,0.537,0.863,308
heading,0.882,136,1010,1,1,0.551,0.292,0.642,1146
vow,0.882,41,309,1,1,0.56,0.51,0.664,350
comics,0.882,77,575,1,1,0.69,0.556,0.384,652
island,0.881,629,4655,1,1,0.745,0.347,0.432,5284
flavor,0.881,27,206,1,1,0.885,0.479,0.392,233
thriving,0.881,65,487,1,1,0.865,0.521,0.779,552
visitor,0.88,24,184,1,1,0.646,0.48,0.461,208
casualty,0.88,4,36,1,1,0.235,0.274,0.132,40
resignation,0.88,19,147,1,1,0.145,0.392,0.31,166
newcomer,0.88,4,36,1,1,0.622,0.38,0.396,40
adrenaline,0.88,19,147,1,1,0.765,0.965,0.825,166
telescope,0.88,4,36,1,1,0.531,0.34,0.5,40
challenger,0.88,4,36,1,1,0.417,0.755,0.652,40
constellation,0.88,4,36,1,1,0.719,0.533,0.775,40
unholy,0.88,9,73,1,1,0.327,0.56,0.445,82
collected,0.88,29,221,1,1,0.57,0.402,0.588,250
starfish,0.88,4,36,1,1,0.68,0.32,0.421,40
yen,0.88,14,110,1,1,0.51,0.435,0.508,124
validity,0.88,9,73,1,1,0.646,0.47,0.706,82
objectivity,0.88,4,36,1,1,0.765,0.431,0.711,40
onslaught,0.88,9,73,1,1,0.198,0.939,0.717,82
mule,0.88,4,36,1,1,0.32,0.337,0.254,40
undefeated,0.88,9,73,1,1,0.833,0.752,0.825,82
uncanny,0.88,9,73,1,1,0.469,0.461,0.43,82
ambush,0.88,4,36,1,1,0.281,0.83,0.5,40
tribe,0.879,118,880,1,1,0.664,0.486,0.516,998
structure,0.879,53,399,1,1,0.562,0.356,0.712,452
seemingly,0.878,79,592,1,1,0.49,0.41,0.356,671
cultural,0.877,63,474,1,1,0.802,0.39,0.623,537
notebook,0.876,39,296,1,1,0.449,0.167,0.442,335
determination,0.876,53,400,1,1,0.776,0.725,0.795,453
supplement,0.876,6,51,1,1,0.745,0.406,0.491,57
distrust,0.876,20,155,1,1,0.06,0.67,0.276,175
versatile,0.876,6,51,1,1,0.906,0.625,0.714,57
instrumental,0.876,27,207,1,1,0.74,0.472,0.647,234
antisocial,0.876,148,1106,1,1,0.146,0.686,0.391,1254
mingle,0.875,43,326,1,1,0.561,0.48,0.434,369
futile,0.875,22,170,1,1,0.122,0.332,0.158,192
relaxed,0.874,81,609,1,1,0.865,0.09,0.382,690
submit,0.874,44,334,1,1,0.635,0.448,0.5,378
goddamned,0.874,8,66,1,1,0.042,0.758,0.42,74
aurora,0.874,17,133,1,1,0.817,0.306,0.537,150
recognition,0.873,64,483,1,1,0.833,0.587,0.726,547
gentle,0.873,213,1593,1,1,0.847,0.353,0.589,1806
tread,0.873,19,148,1,1,0.51,0.52,0.426,167
peril,0.871,12,96,1,1,0.052,0.91,0.518,108
materialistic,0.871,14,111,1,1,0.42,0.506,0.589,125
inflict,0.871,14,111,1,1,0.167,0.76,0.609,125
spend,0.871,2171,16219,1,1,0.672,0.745,0.429,18390
staggering,0.87,16,126,1,1,0.52,0.657,0.683,142
wax,0.87,16,126,1,1,0.436,0.245,0.309,142
raven,0.87,35,268,1,1,0.479,0.446,0.426,303
freelance,0.87,18,141,1,1,0.833,0.577,0.736,159
soundtrack,0.869,74,560,1,1,0.63,0.559,0.518,634
vanished,0.869,24,186,1,1,0.208,0.566,0.255,210
wooden,0.868,30,231,1,1,0.5,0.196,0.318,261
collective,0.868,106,800,1,1,0.583,0.458,0.698,906
candle,0.867,76,576,1,1,0.602,0.221,0.344,652
heathen,0.866,7,59,1,1,0.194,0.529,0.491,66
swarming,0.866,3,29,1,1,0.375,0.6,0.435,32
delinquent,0.866,3,29,1,1,0.051,0.904,0.5,32
unwavering,0.866,9,74,1,1,0.74,0.63,0.858,83
hugger,0.866,3,29,1,1,0.52,0.48,0.412,32
shitload,0.866,5,44,1,1,0.02,0.606,0.161,49
institute,0.866,17,134,1,1,0.604,0.48,0.807,151
rehabilitation,0.866,7,59,1,1,0.406,0.528,0.606,66
raspberry,0.866,7,59,1,1,0.735,0.336,0.291,66
crispy,0.866,7,59,1,1,0.656,0.55,0.509,66
zebra,0.866,5,44,1,1,0.567,0.448,0.314,49
damsel,0.866,3,29,1,1,0.719,0.475,0.4,32
dependable,0.866,9,74,1,1,0.88,0.357,0.741,83
jaws,0.866,9,74,1,1,0.385,0.528,0.455,83
java,0.866,5,44,1,1,0.459,0.321,0.343,49
ebony,0.866,7,59,1,1,0.49,0.317,0.4,66
reluctant,0.866,25,194,1,1,0.292,0.63,0.432,219
neutrality,0.866,3,29,1,1,0.469,0.205,0.434,32
playtime,0.866,3,29,1,1,0.76,0.596,0.566,32
mope,0.866,7,59,1,1,0.406,0.309,0.345,66
agitated,0.866,13,104,1,1,0.444,0.882,0.491,117
fusion,0.866,11,89,1,1,0.635,0.561,0.741,100
ambiguity,0.866,7,59,1,1,0.164,0.46,0.37,66
hamper,0.866,3,29,1,1,0.204,0.711,0.473,32
cheetah,0.866,5,44,1,1,0.469,0.77,0.667,49
churn,0.866,3,29,1,1,0.316,0.491,0.407,32
attic,0.866,27,209,1,1,0.521,0.259,0.377,236
futon,0.866,3,29,1,1,0.429,0.351,0.343,32
civics,0.866,3,29,1,1,0.7,0.279,0.72,32
ineptitude,0.866,7,59,1,1,0.177,0.471,0.25,66
radius,0.866,9,74,1,1,0.521,0.324,0.5,83
ore,0.866,7,59,1,1,0.5,0.333,0.356,66
sanctioned,0.866,3,29,1,1,0.323,0.696,0.391,32
jugular,0.866,5,44,1,1,0.271,0.573,0.426,49
exert,0.866,7,59,1,1,0.694,0.735,0.806,66
croak,0.866,3,29,1,1,0.337,0.346,0.298,32
powerfully,0.866,5,44,1,1,0.854,0.724,0.935,49
neurosis,0.866,3,29,1,1,0.122,0.766,0.418,32
livestock,0.866,3,29,1,1,0.729,0.42,0.519,32
shrunk,0.866,5,44,1,1,0.163,0.354,0.218,49
revolve,0.866,29,224,1,1,0.592,0.546,0.402,253
steaming,0.866,9,74,1,1,0.592,0.553,0.402,83
conqueror,0.866,7,59,1,1,0.604,0.809,0.93,66
ewe,0.866,3,29,1,1,0.429,0.216,0.277,32
foundation,0.866,94,712,1,1,0.771,0.385,0.73,806
launch,0.865,52,397,1,1,0.684,0.814,0.598,449
envy,0.865,81,615,1,1,0.24,0.704,0.427,696
unconscious,0.864,26,202,1,1,0.24,0.356,0.195,228
capital,0.864,51,390,1,1,0.52,0.5,0.798,441
entertainment,0.863,118,894,1,1,0.847,0.75,0.569,1012
avenue,0.863,22,172,1,1,0.677,0.36,0.377,194
coding,0.863,22,172,1,1,0.442,0.344,0.667,194
reader,0.863,56,428,1,1,0.776,0.224,0.602,484
bay,0.862,86,654,1,1,0.719,0.365,0.569,740
willpower,0.862,14,112,1,1,0.823,0.776,0.897,126
gaining,0.862,55,421,1,1,0.837,0.618,0.883,476
mare,0.861,12,97,1,1,0.541,0.32,0.417,109
ribbon,0.861,12,97,1,1,0.719,0.288,0.357,109
thirst,0.86,43,331,1,1,0.298,0.519,0.307,374
continually,0.86,43,331,1,1,0.646,0.438,0.698,374
formula,0.86,21,165,1,1,0.521,0.45,0.585,186
cage,0.86,98,746,1,1,0.316,0.333,0.352,844
amusement,0.86,21,165,1,1,0.929,0.837,0.803,186
prefer,0.86,2078,15688,1,1,0.76,0.385,0.536,17766
celebration,0.86,85,648,1,1,0.939,0.824,0.88,733
fare,0.86,19,150,1,1,0.49,0.425,0.645,169
epic,0.859,105,800,1,1,0.857,0.713,0.83,905
grasp,0.859,87,664,1,1,0.56,0.623,0.57,751
backward,0.858,15,120,1,1,0.309,0.367,0.25,135
intolerable,0.857,13,105,1,1,0.146,0.66,0.439,118
surly,0.857,6,52,1,1,0.221,0.469,0.493,58
brunt,0.857,6,52,1,1,0.204,0.75,0.349,58
eggnog,0.857,6,52,1,1,0.635,0.36,0.259,58
lute,0.857,6,52,1,1,0.459,0.407,0.5,58
gather,0.857,132,1006,1,1,0.648,0.51,0.546,1138
southeast,0.857,6,52,1,1,0.51,0.283,0.413,58
turbulence,0.857,6,52,1,1,0.062,0.922,0.532,58
crawl,0.857,123,938,1,1,0.479,0.519,0.467,1061
kindred,0.856,25,196,1,1,0.76,0.418,0.517,221
hum,0.856,44,340,1,1,0.49,0.296,0.276,384
hellish,0.856,18,143,1,1,0.125,0.86,0.545,161
tide,0.855,50,386,1,1,0.541,0.556,0.42,436
charming,0.854,51,394,1,1,0.917,0.66,0.764,445
form,0.853,585,4452,1,1,0.51,0.302,0.436,5037
beck,0.853,19,151,1,1,0.58,0.375,0.418,170
hemisphere,0.853,4,37,1,1,0.531,0.367,0.598,41
cauliflower,0.853,4,37,1,1,0.448,0.255,0.231,41
inmate,0.853,4,37,1,1,0.235,0.663,0.398,41
crummy,0.853,4,37,1,1,0.125,0.531,0.224,41
tempt,0.853,9,75,1,1,0.21,0.677,0.5,84
flour,0.853,4,37,1,1,0.53,0.235,0.239,41
blip,0.853,4,37,1,1,0.529,0.461,0.418,41
vigilance,0.853,4,37,1,1,0.49,0.615,0.724,41
wobbly,0.853,4,37,1,1,0.208,0.759,0.225,41
overdue,0.853,19,151,1,1,0.125,0.427,0.259,170
successor,0.853,4,37,1,1,0.729,0.531,0.648,41
calorie,0.853,4,37,1,1,0.333,0.54,0.427,41
bass,0.852,32,250,1,1,0.427,0.206,0.268,282
eastern,0.852,32,250,1,1,0.521,0.42,0.48,282
acoustic,0.852,27,212,1,1,0.542,0.462,0.536,239
raising,0.851,214,1636,1,1,0.735,0.519,0.643,1850
rusty,0.851,12,98,1,1,0.271,0.345,0.231,110
recreate,0.851,12,98,1,1,0.724,0.545,0.616,110
resentment,0.85,28,220,1,1,0.163,0.745,0.528,248
sunny,0.85,81,624,1,1,0.74,0.348,0.481,705
apocalypse,0.85,44,342,1,1,0.05,0.867,0.736,386
watery,0.85,7,60,1,1,0.367,0.461,0.292,67
multiplied,0.85,7,60,1,1,0.802,0.559,0.729,67
gossip,0.849,42,327,1,1,0.173,0.765,0.245,369
mango,0.849,18,144,1,1,0.765,0.327,0.29,162
spec,0.848,10,83,1,1,0.583,0.426,0.691,93
build,0.847,586,4485,1,1,0.771,0.546,0.806,5071
slippery,0.847,13,106,1,1,0.219,0.74,0.343,119
mechanics,0.847,13,106,1,1,0.542,0.5,0.761,119
faraway,0.847,13,106,1,1,0.365,0.356,0.285,119
recipe,0.847,44,343,1,1,0.698,0.271,0.415,387
facade,0.847,30,236,1,1,0.52,0.333,0.518,266
burning,0.846,170,1308,1,1,0.229,0.76,0.412,1478
cure,0.845,219,1684,1,1,0.719,0.377,0.623,1903
sustain,0.845,43,336,1,1,0.635,0.358,0.593,379
stamp,0.844,11,91,1,1,0.438,0.327,0.441,102
chaser,0.844,5,45,1,1,0.375,0.83,0.645,50
diligent,0.844,5,45,1,1,0.76,0.426,0.759,50
journalistic,0.844,5,45,1,1,0.696,0.449,0.495,50
binding,0.844,8,68,1,1,0.438,0.425,0.64,76
shiver,0.844,14,114,1,1,0.26,0.765,0.236,128
semblance,0.844,14,114,1,1,0.5,0.471,0.442,128
sitcom,0.844,5,45,1,1,0.562,0.537,0.407,50
pendulum,0.844,8,68,1,1,0.542,0.368,0.434,76
submitting,0.844,8,68,1,1,0.667,0.61,0.611,76
disoriented,0.844,5,45,1,1,0.227,0.643,0.227,50
daydream,0.843,24,191,1,1,0.75,0.337,0.456,215
testament,0.843,24,191,1,1,0.594,0.42,0.806,215
sheep,0.842,100,775,1,1,0.604,0.206,0.161,875
lone,0.842,252,1943,1,1,0.198,0.204,0.367,2195
connection,0.842,452,3480,1,1,0.729,0.56,0.655,3932
character,0.842,674,5187,1,1,0.667,0.373,0.686,5861
strategic,0.842,15,122,1,1,0.786,0.708,0.861,137
juicy,0.841,12,99,1,1,0.823,0.529,0.49,111
planner,0.841,12,99,1,1,0.76,0.469,0.868,111
endure,0.841,188,1453,1,1,0.32,0.61,0.574,1641
therapeutic,0.841,143,1107,1,1,0.625,0.275,0.68,1250
premier,0.841,22,176,1,1,0.755,0.519,0.792,198
map,0.84,98,761,1,1,0.561,0.229,0.463,859
detriment,0.84,9,76,1,1,0.281,0.538,0.263,85
crunchy,0.84,9,76,1,1,0.625,0.56,0.539,85
boast,0.84,9,76,1,1,0.52,0.586,0.569,85
weights,0.84,19,153,1,1,0.458,0.5,0.722,172
subsequently,0.84,9,76,1,1,0.38,0.337,0.336,85
entirety,0.84,36,284,1,1,0.854,0.46,0.804,320
revenge,0.839,70,546,1,1,0.23,0.94,0.627,616
borrow,0.839,43,338,1,1,0.398,0.573,0.282,381
moon,0.839,843,6502,1,1,0.673,0.233,0.547,7345
rhyme,0.839,16,130,1,1,0.667,0.249,0.481,146
decor,0.839,16,130,1,1,0.734,0.311,0.573,146
departure,0.839,16,130,1,1,0.573,0.5,0.426,146
clan,0.839,40,315,1,1,0.562,0.491,0.686,355
exhibit,0.839,23,184,1,1,0.688,0.633,0.708,207
blur,0.839,23,184,1,1,0.268,0.471,0.205,207
colorful,0.839,23,184,1,1,0.85,0.52,0.519,207
iron,0.839,92,716,1,1,0.448,0.351,0.679,808
prospect,0.839,44,346,1,1,0.733,0.442,0.698,390
fungus,0.838,6,53,1,1,0.388,0.337,0.173,59
vengeful,0.838,6,53,1,1,0.15,0.84,0.561,59
nefarious,0.838,6,53,1,1,0.184,0.72,0.528,59
pyramid,0.838,6,53,1,1,0.74,0.39,0.635,59
spear,0.838,6,53,1,1,0.51,0.601,0.5,59
optimism,0.837,28,223,1,1,0.949,0.565,0.814,251
chant,0.836,21,169,1,1,0.771,0.698,0.65,190
tilting,0.836,10,84,1,1,0.459,0.384,0.34,94
abound,0.836,10,84,1,1,0.704,0.49,0.681,94
inferiority,0.836,10,84,1,1,0.177,0.43,0.205,94
combination,0.835,83,649,1,1,0.708,0.48,0.726,732
series,0.834,452,3508,1,1,0.622,0.431,0.42,3960
disjointed,0.833,3,30,1,1,0.323,0.518,0.365,33
padre,0.833,3,30,1,1,0.684,0.407,0.647,33
heave,0.833,3,30,1,1,0.716,0.588,0.664,33
dissonance,0.833,11,92,1,1,0.173,0.471,0.336,103
correspondence,0.833,3,30,1,1,0.663,0.423,0.491,33
stardom,0.833,3,30,1,1,0.844,0.786,0.689,33
weakling,0.833,3,30,1,1,0.194,0.294,0.087,33
aspen,0.833,3,30,1,1,0.479,0.28,0.395,33
tightrope,0.833,3,30,1,1,0.354,0.653,0.279,33
shroud,0.833,7,61,1,1,0.417,0.457,0.389,68
veneer,0.833,3,30,1,1,0.49,0.265,0.289,33
jackpot,0.833,3,30,1,1,0.95,0.75,0.786,33
unmarked,0.833,3,30,1,1,0.416,0.294,0.433,33
exemption,0.833,3,30,1,1,0.531,0.578,0.627,33
thirds,0.833,3,30,1,1,0.402,0.327,0.345,33
mouthful,0.833,3,30,1,1,0.609,0.565,0.389,33
watered,0.833,7,61,1,1,0.615,0.29,0.377,68
neon,0.833,27,216,1,1,0.594,0.48,0.38,243
infantile,0.833,3,30,1,1,0.604,0.382,0.259,33
bal,0.833,3,30,1,1,0.49,0.412,0.432,33
strut,0.833,3,30,1,1,0.58,0.48,0.464,33
begun,0.833,55,433,1,1,0.677,0.5,0.404,488
recount,0.833,3,30,1,1,0.479,0.402,0.509,33
beggar,0.833,3,30,1,1,0.24,0.402,0.116,33
collide,0.833,7,61,1,1,0.271,0.892,0.557,68
development,0.833,125,976,1,1,0.827,0.5,0.796,1101
relation,0.833,52,410,1,1,0.857,0.604,0.625,462
bend,0.833,48,379,1,1,0.571,0.324,0.368,427
horn,0.832,20,162,1,1,0.385,0.51,0.366,182
chess,0.832,20,162,1,1,0.656,0.363,0.518,182
whale,0.832,41,325,1,1,0.582,0.398,0.509,366
bash,0.832,33,263,1,1,0.385,0.546,0.463,296
palm,0.831,47,372,1,1,0.531,0.194,0.34,419
interference,0.831,21,170,1,1,0.396,0.736,0.357,191
tune,0.83,174,1360,1,1,0.708,0.479,0.426,1534
gangster,0.83,8,69,1,1,0.292,0.833,0.655,77
shifting,0.83,26,209,1,1,0.518,0.548,0.546,235
hush,0.83,26,209,1,1,0.471,0.231,0.312,235
mature,0.83,126,987,1,1,0.625,0.347,0.6,1113
adversity,0.83,40,318,1,1,0.276,0.76,0.538,358
prey,0.83,40,318,1,1,0.378,0.5,0.306,358
dreaded,0.829,22,178,1,1,0.122,0.706,0.46,200
twelve,0.829,27,217,1,1,0.49,0.298,0.412,244
dynamics,0.828,18,147,1,1,0.745,0.682,0.774,165
insight,0.828,90,708,1,1,0.613,0.363,0.649,798
superb,0.828,23,186,1,1,0.98,0.708,0.852,209
necessarily,0.828,221,1729,1,1,0.667,0.423,0.598,1950
thorn,0.827,9,77,1,1,0.296,0.541,0.427,86
significance,0.827,19,155,1,1,0.82,0.46,0.644,174
pronto,0.827,4,38,1,1,0.646,0.5,0.468,42
override,0.827,4,38,1,1,0.316,0.491,0.529,42
template,0.827,4,38,1,1,0.479,0.311,0.411,42
climax,0.827,9,77,1,1,0.735,0.853,0.667,86
uproar,0.827,4,38,1,1,0.271,0.902,0.462,42
clench,0.827,4,38,1,1,0.438,0.618,0.58,42
underestimate,0.827,59,467,1,1,0.413,0.464,0.193,526
twig,0.827,4,38,1,1,0.378,0.288,0.236,42
auditory,0.827,4,38,1,1,0.531,0.481,0.57,42
prerogative,0.827,4,38,1,1,0.521,0.442,0.538,42
harper,0.827,19,155,1,1,0.417,0.454,0.435,174
stench,0.827,9,77,1,1,0.104,0.57,0.298,86
youth,0.827,327,2558,1,1,0.938,0.608,0.736,2885
bound,0.826,122,959,1,1,0.417,0.667,0.31,1081
reveal,0.826,92,725,1,1,0.493,0.637,0.526,817
differ,0.826,25,202,1,1,0.23,0.398,0.396,227
penthouse,0.825,10,85,1,1,0.592,0.43,0.395,95
vale,0.825,10,85,1,1,0.592,0.276,0.387,95
revisit,0.824,16,132,1,1,0.552,0.53,0.509,148
haunt,0.824,85,672,1,1,0.288,0.676,0.576,757
sting,0.823,29,234,1,1,0.163,0.651,0.373,263
thoughtless,0.823,5,46,1,1,0.194,0.58,0.452,51
weekday,0.823,11,93,1,1,0.49,0.469,0.52,104
trunk,0.823,11,93,1,1,0.271,0.167,0.404,104
merit,0.823,17,140,1,1,0.854,0.5,0.722,157
collage,0.823,11,93,1,1,0.68,0.321,0.375,104
calculating,0.823,5,46,1,1,0.458,0.43,0.625,51
express,0.822,545,4280,1,1,0.76,0.623,0.691,4825
core,0.822,151,1191,1,1,0.721,0.378,0.54,1342
heavens,0.822,50,399,1,1,0.806,0.273,0.683,449
nutrition,0.821,12,101,1,1,0.885,0.42,0.579,113
blues,0.82,75,596,1,1,0.469,0.22,0.287,671
recommend,0.82,262,2065,1,1,0.812,0.439,0.672,2327
munch,0.82,6,54,1,1,0.541,0.277,0.434,60
cellular,0.82,6,54,1,1,0.643,0.398,0.517,60
oyster,0.82,6,54,1,1,0.5,0.311,0.327,60
confrontation,0.82,20,164,1,1,0.177,0.87,0.658,184
convoluted,0.82,6,54,1,1,0.323,0.614,0.433,60
charitable,0.82,6,54,1,1,0.865,0.38,0.593,60
banker,0.82,6,54,1,1,0.586,0.588,0.792,60
deathly,0.82,20,164,1,1,0.073,0.771,0.682,184
outbreak,0.82,6,54,1,1,0.26,0.632,0.472,60
sequel,0.819,28,227,1,1,0.65,0.48,0.574,255
equation,0.819,21,172,1,1,0.479,0.384,0.608,193
romance,0.818,181,1431,1,1,0.98,0.682,0.587,1612
intensely,0.818,30,243,1,1,0.694,0.846,0.75,273
orgy,0.817,7,62,1,1,0.346,0.962,0.536,69
fatigued,0.817,7,62,1,1,0.146,0.433,0.245,69
buried,0.817,107,850,1,1,0.133,0.53,0.37,957
washed,0.817,75,598,1,1,0.542,0.314,0.392,673
ram,0.816,26,212,1,1,0.406,0.452,0.388,238
proverbial,0.816,8,70,1,1,0.583,0.43,0.697,78
fallacy,0.814,9,78,1,1,0.112,0.561,0.43,87
continuous,0.814,29,236,1,1,0.625,0.509,0.58,265
foam,0.814,9,78,1,1,0.698,0.23,0.204,87
persuasion,0.813,10,86,1,1,0.612,0.67,0.537,96
technology,0.813,120,956,1,1,0.776,0.49,0.825,1076
tangible,0.813,22,181,1,1,0.646,0.35,0.679,203
outing,0.812,23,189,1,1,0.771,0.672,0.634,212
barber,0.812,23,189,1,1,0.543,0.459,0.356,212
prime,0.812,125,997,1,1,0.708,0.275,0.446,1122
congregation,0.811,12,102,1,1,0.561,0.49,0.7,114
salmon,0.811,12,102,1,1,0.76,0.25,0.444,114
muster,0.811,25,205,1,1,0.635,0.46,0.548,230
caffeine,0.811,26,213,1,1,0.562,0.759,0.5,239
applause,0.811,13,110,1,1,0.953,0.857,0.621,123
unrequited,0.811,13,110,1,1,0.143,0.441,0.179,123
exclusive,0.81,46,372,1,1,0.792,0.63,0.653,418
individual,0.809,308,2453,1,1,0.627,0.327,0.533,2761
glass,0.809,269,2144,1,1,0.49,0.404,0.322,2413
goose,0.808,18,150,1,1,0.479,0.283,0.265,168
miracle,0.808,116,929,1,1,0.917,0.607,0.806,1045
shade,0.808,58,468,1,1,0.388,0.265,0.278,526
oil,0.807,94,755,1,1,0.521,0.278,0.306,849
progression,0.807,23,190,1,1,0.74,0.562,0.8,213
dusty,0.807,25,206,1,1,0.406,0.294,0.255,231
dessert,0.807,25,206,1,1,0.755,0.491,0.404,231
painful,0.806,565,4506,1,1,0.05,0.742,0.33,5071
roam,0.806,57,461,1,1,0.51,0.55,0.444,518
whiskey,0.804,57,462,1,1,0.612,0.706,0.441,519
vandalism,0.802,2,23,1,1,0.083,0.904,0.509,25
finalized,0.802,2,23,1,1,0.245,0.21,0.608,25
brothel,0.802,2,23,1,1,0.255,0.886,0.418,25
seduce,0.802,9,79,1,1,0.462,0.864,0.689,88
expanded,0.802,8,71,1,1,0.76,0.406,0.689,79
natal,0.802,6,55,1,1,0.755,0.462,0.481,61
asserting,0.802,2,23,1,1,0.694,0.531,0.736,25
externally,0.802,7,63,1,1,0.643,0.521,0.568,70
escalation,0.802,2,23,1,1,0.571,0.807,0.582,25
usefulness,0.802,2,23,1,1,0.806,0.519,0.741,25
blower,0.802,2,23,1,1,0.564,0.55,0.536,25
tile,0.802,3,31,1,1,0.429,0.245,0.348,34
baffle,0.802,2,23,1,1,0.344,0.442,0.482,25
tote,0.802,3,31,1,1,0.51,0.398,0.625,34
incensed,0.802,2,23,1,1,0.338,0.643,0.392,25
aggravates,0.802,2,23,1,1,0.108,0.778,0.357,25
fanatical,0.802,2,23,1,1,0.555,0.83,0.714,25
sled,0.802,2,23,1,1,0.635,0.547,0.446,25
immobile,0.802,2,23,1,1,0.225,0.217,0.298,25
undressed,0.802,4,39,1,1,0.375,0.755,0.356,43
hazardous,0.802,3,31,1,1,0.061,0.75,0.67,34
feminine,0.802,26,215,1,1,0.802,0.52,0.394,241
acceleration,0.802,2,23,1,1,0.704,0.905,0.843,25
glazed,0.802,3,31,1,1,0.622,0.41,0.491,34
obstruct,0.802,5,47,1,1,0.115,0.66,0.458,52
perky,0.802,2,23,1,1,0.896,0.792,0.673,25
sax,0.802,3,31,1,1,0.573,0.465,0.409,34
tumour,0.802,2,23,1,1,0.092,0.627,0.464,25
rhino,0.802,3,31,1,1,0.531,0.549,0.555,34
angered,0.802,11,95,1,1,0.01,0.86,0.547,106
drawback,0.802,3,31,1,1,0.302,0.422,0.148,34
hydra,0.802,5,47,1,1,0.406,0.598,0.534,52
producing,0.802,26,215,1,1,0.632,0.616,0.7,241
chivalry,0.802,2,23,1,1,0.857,0.38,0.848,25
launcher,0.802,3,31,1,1,0.677,0.745,0.808,34
tights,0.802,5,47,1,1,0.583,0.343,0.269,52
treasury,0.802,5,47,1,1,0.812,0.541,0.736,52
emphasize,0.802,20,167,1,1,0.51,0.605,0.769,187
grating,0.802,5,47,1,1,0.512,0.337,0.282,52
tidal,0.802,7,63,1,1,0.592,0.539,0.519,70
mambo,0.802,2,23,1,1,0.808,0.622,0.445,25
hemp,0.802,2,23,1,1,0.469,0.439,0.422,25
flannel,0.802,4,39,1,1,0.49,0.25,0.327,43
promoter,0.802,2,23,1,1,0.646,0.573,0.817,25
recurring,0.802,18,151,1,1,0.37,0.56,0.445,169
redesign,0.802,4,39,1,1,0.622,0.46,0.396,43
fallout,0.802,34,279,1,1,0.428,0.356,0.373,313
signpost,0.802,2,23,1,1,0.51,0.4,0.446,25
politeness,0.802,4,39,1,1,0.875,0.353,0.618,43
parasitic,0.802,4,39,1,1,0.037,0.6,0.364,43
continuum,0.802,3,31,1,1,0.677,0.39,0.491,34
oddity,0.802,2,23,1,1,0.312,0.557,0.386,25
topple,0.802,2,23,1,1,0.198,0.82,0.573,25
truce,0.802,8,71,1,1,0.688,0.441,0.453,79
doer,0.802,2,23,1,1,0.724,0.55,0.728,25
brazen,0.802,4,39,1,1,0.292,0.64,0.518,43
rhetorical,0.802,8,71,1,1,0.417,0.569,0.635,79
beaver,0.802,5,47,1,1,0.49,0.344,0.393,52
tram,0.802,6,55,1,1,0.667,0.628,0.492,61
announcer,0.802,4,39,1,1,0.602,0.57,0.732,43
payoff,0.802,6,55,1,1,0.74,0.644,0.673,61
wedge,0.802,5,47,1,1,0.49,0.29,0.278,52
woeful,0.802,3,31,1,1,0.135,0.555,0.255,34
overkill,0.802,3,31,1,1,0.379,0.861,0.678,34
martyrdom,0.802,3,31,1,1,0.323,0.745,0.442,34
expiry,0.802,2,23,1,1,0.194,0.434,0.382,25
dainty,0.802,2,23,1,1,0.604,0.284,0.424,25
syllabus,0.802,3,31,1,1,0.736,0.37,0.643,34
rooted,0.802,35,287,1,1,0.51,0.527,0.718,322
tenacity,0.802,6,55,1,1,0.74,0.657,0.889,61
rumored,0.802,2,23,1,1,0.427,0.604,0.318,25
lifeboat,0.802,2,23,1,1,0.724,0.425,0.533,25
degradation,0.802,3,31,1,1,0.16,0.608,0.315,34
blessing,0.801,359,2880,1,1,0.929,0.264,0.8,3239
key,0.801,569,4561,1,1,0.615,0.275,0.519,5130
sacrifice,0.801,190,1528,1,1,0.208,0.833,0.534,1718
cloud,0.801,110,888,1,1,0.74,0.133,0.342,998
tea,0.8,475,3813,1,1,0.698,0.163,0.37,4288
consequence,0.799,44,360,1,1,0.24,0.721,0.593,404
academy,0.798,36,296,1,1,0.704,0.473,0.792,332
accessible,0.798,32,264,1,1,0.796,0.41,0.645,296
training,0.797,217,1751,1,1,0.714,0.776,0.788,1968
designer,0.797,25,208,1,1,0.875,0.519,0.67,233
create,0.797,646,5200,1,1,0.786,0.588,0.789,5846
stir,0.797,24,200,1,1,0.448,0.773,0.453,224
encounter,0.796,92,747,1,1,0.865,0.702,0.689,839
deep,0.796,1599,12868,1,1,0.49,0.473,0.657,14467
bittersweet,0.796,63,514,1,1,0.469,0.569,0.474,577
abandonment,0.795,90,732,1,1,0.128,0.43,0.202,822
procrastination,0.795,17,144,1,1,0.323,0.43,0.491,161
soar,0.794,16,136,1,1,0.79,0.74,0.718,152
axe,0.794,15,128,1,1,0.296,0.69,0.536,143
overrated,0.794,106,862,1,1,0.312,0.63,0.482,968
improves,0.793,14,120,1,1,0.929,0.625,0.727,134
conditioned,0.793,27,225,1,1,0.49,0.417,0.616,252
southern,0.793,55,451,1,1,0.552,0.269,0.37,506
lifestyle,0.793,135,1097,1,1,0.75,0.472,0.645,1232
frozen,0.792,132,1073,1,1,0.344,0.346,0.375,1205
dodging,0.792,12,104,1,1,0.396,0.654,0.382,116
commonly,0.792,12,104,1,1,0.604,0.17,0.574,116
preoccupied,0.792,12,104,1,1,0.265,0.7,0.235,116
hysteria,0.792,12,104,1,1,0.224,0.906,0.482,116
comfy,0.792,111,904,1,1,0.93,0.241,0.625,1015
slash,0.791,11,96,1,1,0.26,0.5,0.509,107
drones,0.791,11,96,1,1,0.398,0.577,0.588,107
workaholic,0.79,10,88,1,1,0.344,0.657,0.557,98
crunch,0.79,20,169,1,1,0.292,0.63,0.406,189
geek,0.79,20,169,1,1,0.479,0.392,0.39,189
groom,0.789,9,80,1,1,0.698,0.5,0.605,89
retro,0.789,9,80,1,1,0.65,0.276,0.321,89
refreshing,0.789,159,1296,1,1,0.936,0.52,0.571,1455
muscular,0.788,8,72,1,1,0.531,0.434,0.577,80
dubious,0.788,8,72,1,1,0.414,0.48,0.198,80
unattainable,0.788,8,72,1,1,0.22,0.635,0.571,80
distance,0.787,520,4230,1,1,0.233,0.317,0.418,4750
raider,0.786,7,64,1,1,0.302,0.86,0.525,71
exempt,0.786,7,64,1,1,0.588,0.455,0.664,71
murderous,0.786,15,129,1,1,0.017,0.94,0.682,144
respective,0.786,15,129,1,1,0.625,0.413,0.721,144
mascot,0.786,7,64,1,1,0.75,0.337,0.337,71
repair,0.786,46,381,1,1,0.583,0.46,0.589,427
flesh,0.786,99,812,1,1,0.604,0.39,0.475,911
reading,0.785,1883,15320,1,1,0.781,0.183,0.415,17203
avid,0.785,14,121,1,1,0.582,0.459,0.593,135
unlimited,0.785,29,243,1,1,0.75,0.623,0.679,272
notion,0.785,50,414,1,1,0.612,0.284,0.667,464
starry,0.784,49,406,1,1,0.438,0.643,0.434,455
punishing,0.784,13,113,1,1,0.094,0.898,0.471,126
salesman,0.784,6,56,1,1,0.643,0.559,0.664,62
pester,0.784,6,56,1,1,0.143,0.78,0.385,62
vanish,0.783,26,219,1,1,0.236,0.48,0.347,245
conviction,0.782,31,260,1,1,0.615,0.704,0.826,291
blond,0.781,11,97,1,1,0.59,0.49,0.49,108
stifling,0.781,5,48,1,1,0.163,0.858,0.608,53
thumping,0.781,5,48,1,1,0.214,0.755,0.566,53
grin,0.781,41,342,1,1,0.885,0.57,0.491,383
flea,0.781,5,48,1,1,0.286,0.353,0.218,53
swine,0.781,5,48,1,1,0.34,0.519,0.277,53
restricted,0.781,17,146,1,1,0.276,0.5,0.407,163
sentencing,0.781,5,48,1,1,0.12,0.782,0.561,53
alleviate,0.781,17,146,1,1,0.869,0.27,0.528,163
hitch,0.781,5,48,1,1,0.512,0.48,0.554,53
arduous,0.781,5,48,1,1,0.344,0.783,0.605,53
impossibility,0.781,5,48,1,1,0.17,0.625,0.306,53
caveat,0.781,5,48,1,1,0.344,0.629,0.484,53
coexist,0.781,11,97,1,1,0.708,0.46,0.536,108
laughter,0.781,160,1314,1,1,0.959,0.654,0.588,1474
pursue,0.781,88,726,1,1,0.417,0.783,0.536,814
absurd,0.781,52,432,1,1,0.188,0.656,0.284,484
found,0.78,2959,24188,1,1,0.833,0.446,0.49,27147
chilling,0.78,159,1307,1,1,0.208,0.85,0.358,1466
pinch,0.78,16,138,1,1,0.34,0.632,0.339,154
combine,0.78,16,138,1,1,0.663,0.442,0.533,154
perfect,0.78,1381,11299,1,1,0.98,0.471,0.87,12680
specialty,0.779,10,89,1,1,0.724,0.479,0.783,99
passion,0.779,245,2012,1,1,0.854,0.865,0.728,2257
sunshine,0.779,197,1620,1,1,0.885,0.297,0.769,1817
unnatural,0.779,15,130,1,1,0.153,0.587,0.434,145
stall,0.778,41,343,1,1,0.37,0.245,0.292,384
tool,0.778,119,982,1,1,0.49,0.35,0.594,1101
brunch,0.778,25,212,1,1,0.406,0.363,0.343,237
source,0.778,219,1802,1,1,0.74,0.318,0.684,2021
shed,0.777,130,1073,1,1,0.427,0.402,0.47,1203
definite,0.777,19,163,1,1,0.708,0.292,0.741,182
unresolved,0.777,9,81,1,1,0.135,0.441,0.173,90
retrospect,0.777,9,81,1,1,0.406,0.5,0.538,90
devious,0.777,4,40,1,1,0.25,0.519,0.259,44
narrate,0.777,4,40,1,1,0.541,0.48,0.473,44
unplugged,0.777,19,163,1,1,0.367,0.375,0.318,182
astronomical,0.777,4,40,1,1,0.6,0.632,0.726,44
unnamed,0.777,4,40,1,1,0.316,0.189,0.284,44
doorknob,0.777,4,40,1,1,0.406,0.553,0.462,44
adage,0.777,4,40,1,1,0.517,0.415,0.566,44
dialect,0.777,4,40,1,1,0.635,0.422,0.526,44
butler,0.777,19,163,1,1,0.469,0.225,0.438,182
sire,0.777,4,40,1,1,0.854,0.452,0.808,44
upright,0.777,9,81,1,1,0.667,0.373,0.6,90
oldie,0.777,4,40,1,1,0.363,0.363,0.342,44
theatrical,0.777,4,40,1,1,0.72,0.69,0.546,44
skim,0.777,4,40,1,1,0.418,0.328,0.322,44
bridal,0.777,4,40,1,1,0.823,0.655,0.596,44
pertinent,0.777,4,40,1,1,0.58,0.333,0.723,44
gadget,0.777,4,40,1,1,0.635,0.559,0.382,44
masochist,0.777,4,40,1,1,0.164,0.784,0.353,44
golfing,0.777,9,81,1,1,0.625,0.427,0.455,90
trivial,0.777,19,163,1,1,0.406,0.387,0.337,182
rejoice,0.776,38,319,1,1,0.827,0.65,0.698,357
aqua,0.776,23,196,1,1,0.656,0.292,0.359,219
expectation,0.775,55,459,1,1,0.771,0.69,0.707,514
manner,0.775,68,566,1,1,0.618,0.25,0.32,634
hub,0.775,22,188,1,1,0.479,0.399,0.433,210
unavailable,0.775,31,262,1,1,0.323,0.281,0.159,293
mediocrity,0.774,17,147,1,1,0.073,0.398,0.225,164
appease,0.774,8,73,1,1,0.633,0.278,0.434,81
mating,0.774,8,73,1,1,0.755,0.84,0.759,81
satire,0.774,8,73,1,1,0.458,0.655,0.472,81
grain,0.774,17,147,1,1,0.39,0.198,0.302,164
tearful,0.774,8,73,1,1,0.208,0.5,0.184,81
satisfying,0.774,84,698,1,1,0.89,0.606,0.814,782
reject,0.774,79,657,1,1,0.06,0.647,0.37,736
liquid,0.774,21,180,1,1,0.562,0.235,0.307,201
bench,0.773,73,608,1,1,0.571,0.289,0.544,681
surge,0.773,12,106,1,1,0.449,0.684,0.5,118
ability,0.773,361,2979,1,1,0.875,0.51,0.816,3340
patron,0.773,16,139,1,1,0.583,0.451,0.87,155
surroundings,0.772,129,1070,1,1,0.6,0.346,0.492,1199
route,0.772,85,708,1,1,0.583,0.353,0.518,793
arrange,0.771,31,263,1,1,0.74,0.49,0.571,294
autograph,0.771,3,32,1,1,0.735,0.565,0.473,35
complicate,0.771,7,65,1,1,0.21,0.657,0.404,72
terminate,0.771,3,32,1,1,0.171,0.41,0.441,35
finesse,0.771,7,65,1,1,0.74,0.387,0.412,72
ubiquitous,0.771,3,32,1,1,0.635,0.571,0.884,35
region,0.771,43,362,1,1,0.54,0.295,0.712,405
chit,0.771,11,98,1,1,0.49,0.352,0.321,109
bedding,0.771,7,65,1,1,0.704,0.276,0.377,72
regimen,0.771,3,32,1,1,0.428,0.538,0.84,35
sergeant,0.771,3,32,1,1,0.408,0.6,0.833,35
veterinary,0.771,3,32,1,1,0.656,0.45,0.603,35
unwashed,0.771,3,32,1,1,0.365,0.427,0.36,35
sly,0.771,11,98,1,1,0.573,0.69,0.75,109
bishop,0.77,26,222,1,1,0.594,0.184,0.725,248
bird,0.77,207,1717,1,1,0.729,0.357,0.364,1924
design,0.768,146,1215,1,1,0.796,0.327,0.632,1361
perverted,0.768,10,90,1,1,0.062,0.918,0.436,100
chopping,0.768,10,90,1,1,0.56,0.625,0.362,100
insect,0.768,10,90,1,1,0.276,0.633,0.242,100
opportunity,0.768,416,3450,1,1,0.938,0.745,0.833,3866
searching,0.768,260,2159,1,1,0.534,0.657,0.466,2419
water,0.767,808,6697,1,1,0.812,0.123,0.429,7505
violet,0.767,24,206,1,1,0.688,0.272,0.401,230
write,0.767,1033,8565,1,1,0.612,0.387,0.534,9598
wallflower,0.767,6,57,1,1,0.667,0.298,0.342,63
falter,0.767,6,57,1,1,0.421,0.65,0.346,63
pained,0.767,13,115,1,1,0.112,0.5,0.25,128
inventory,0.767,6,57,1,1,0.594,0.463,0.49,63
mow,0.767,6,57,1,1,0.42,0.559,0.393,63
forced,0.767,506,4200,1,1,0.18,0.721,0.458,4706
beer,0.766,230,1915,1,1,0.592,0.654,0.5,2145
appreciation,0.766,121,1011,1,1,0.917,0.529,0.588,1132
ice,0.765,385,3201,1,1,0.44,0.265,0.219,3586
disservice,0.765,9,82,1,1,0.25,0.794,0.48,91
faithfulness,0.765,9,82,1,1,0.833,0.426,0.602,91
piano,0.765,79,663,1,1,0.704,0.343,0.438,742
frank,0.765,99,829,1,1,0.625,0.358,0.604,928
whereabouts,0.765,9,82,1,1,0.439,0.382,0.356,91
green,0.765,294,2448,1,1,0.63,0.306,0.333,2742
social,0.765,2543,21121,1,1,0.806,0.37,0.614,23664
construction,0.765,32,273,1,1,0.848,0.612,0.759,305
ungodly,0.764,12,107,1,1,0.296,0.423,0.388,119
civilian,0.764,12,107,1,1,0.7,0.229,0.598,119
masked,0.764,12,107,1,1,0.375,0.549,0.518,119
programming,0.764,28,240,1,1,0.6,0.435,0.732,268
interactive,0.763,15,132,1,1,0.727,0.811,0.77,147
suburban,0.763,15,132,1,1,0.439,0.45,0.453,147
surreal,0.763,49,415,1,1,0.55,0.529,0.67,464
relax,0.763,374,3119,1,1,0.927,0.25,0.375,3493
mile,0.762,70,590,1,1,0.521,0.417,0.456,660
image,0.762,228,1906,1,1,0.653,0.241,0.453,2134
humanity,0.761,277,2315,1,1,0.75,0.36,0.727,2592
ell,0.761,2,24,1,1,0.469,0.418,0.373,26
quantify,0.761,2,24,1,1,0.719,0.459,0.721,26
stylish,0.761,5,49,1,1,0.885,0.49,0.689,54
allied,0.761,5,49,1,1,0.714,0.245,0.642,54
ballpark,0.761,2,24,1,1,0.724,0.694,0.529,26
rioting,0.761,2,24,1,1,0.156,0.949,0.56,26
hilarity,0.761,2,24,1,1,0.745,0.48,0.575,26
menial,0.761,2,24,1,1,0.49,0.42,0.352,26
lopsided,0.761,2,24,1,1,0.125,0.5,0.272,26
converted,0.761,14,124,1,1,0.663,0.418,0.686,138
experimentation,0.761,2,24,1,1,0.637,0.769,0.767,26
tricycle,0.761,2,24,1,1,0.633,0.402,0.368,26
slippers,0.761,8,74,1,1,0.573,0.413,0.236,82
demise,0.761,26,224,1,1,0.104,0.596,0.456,250
overlook,0.761,17,149,1,1,0.292,0.418,0.415,166
gladiator,0.761,2,24,1,1,0.5,0.833,0.866,26
grievous,0.761,2,24,1,1,0.146,0.64,0.179,26
undergraduate,0.761,2,24,1,1,0.583,0.5,0.559,26
lodging,0.761,2,24,1,1,0.713,0.286,0.527,26
modify,0.761,2,24,1,1,0.458,0.584,0.625,26
infatuated,0.761,8,74,1,1,0.729,0.764,0.417,82
shortness,0.761,2,24,1,1,0.459,0.28,0.272,26
peddle,0.761,2,24,1,1,0.539,0.549,0.538,26
popper,0.761,2,24,1,1,0.42,0.509,0.411,26
frisk,0.761,2,24,1,1,0.49,0.547,0.377,26
matrimony,0.761,2,24,1,1,0.85,0.637,0.843,26
tirade,0.761,2,24,1,1,0.378,0.587,0.532,26
summation,0.761,2,24,1,1,0.766,0.337,0.594,26
radiator,0.761,2,24,1,1,0.385,0.452,0.475,26
rematch,0.761,2,24,1,1,0.469,0.798,0.627,26
duress,0.761,2,24,1,1,0.302,0.569,0.612,26
adherence,0.761,2,24,1,1,0.76,0.307,0.63,26
conscience,0.761,71,599,1,1,0.663,0.375,0.721,670
snippy,0.761,2,24,1,1,0.418,0.491,0.481,26
underdog,0.761,5,49,1,1,0.25,0.41,0.226,54
theatrics,0.761,2,24,1,1,0.694,0.539,0.486,26
volition,0.761,2,24,1,1,0.48,0.587,0.578,26
elder,0.76,40,341,1,1,0.448,0.153,0.462,381
unforgettable,0.759,22,191,1,1,0.833,0.561,0.66,213
sync,0.759,22,191,1,1,0.802,0.44,0.67,213
recommendation,0.759,22,191,1,1,0.912,0.388,0.664,213
deadlines,0.759,19,166,1,1,0.406,0.769,0.411,185
sweet,0.759,1066,8910,1,1,0.668,0.418,0.382,9976
colors,0.759,115,968,1,1,0.875,0.349,0.34,1083
scientific,0.758,27,233,1,1,0.653,0.51,0.836,260
onward,0.758,13,116,1,1,0.667,0.538,0.741,129
blaze,0.758,13,116,1,1,0.698,0.467,0.658,129
mode,0.758,189,1587,1,1,0.531,0.185,0.367,1776
television,0.758,66,559,1,1,0.633,0.391,0.547,625
present,0.758,469,3929,1,1,0.724,0.286,0.634,4398
scales,0.757,10,91,1,1,0.439,0.33,0.491,101
mindless,0.757,21,183,1,1,0.184,0.333,0.153,204
wounds,0.757,105,886,1,1,0.102,0.735,0.345,991
maker,0.757,45,384,1,1,0.698,0.544,0.706,429
various,0.757,126,1062,1,1,0.5,0.296,0.342,1188
oral,0.756,15,133,1,1,0.53,0.448,0.375,148
benevolent,0.756,7,66,1,1,0.786,0.407,0.651,73
grotesque,0.756,7,66,1,1,0.135,0.788,0.5,73
stiff,0.756,15,133,1,1,0.158,0.459,0.569,148
lowly,0.756,7,66,1,1,0.562,0.294,0.417,73
discreet,0.756,7,66,1,1,0.552,0.216,0.532,73
inseparable,0.756,7,66,1,1,0.7,0.52,0.571,73
tap,0.755,65,552,1,1,0.461,0.37,0.349,617
grim,0.755,28,242,1,1,0.31,0.483,0.298,270
sketch,0.755,28,242,1,1,0.704,0.276,0.42,270
shall,0.755,577,4844,1,1,0.51,0.385,0.412,5421
productive,0.755,237,1994,1,1,0.847,0.677,0.773,2231
estate,0.755,38,326,1,1,0.653,0.385,0.647,364
flickering,0.755,12,108,1,1,0.49,0.444,0.289,120
grace,0.754,270,2273,1,1,0.906,0.304,0.462,2543
knight,0.754,60,511,1,1,0.78,0.441,0.835,571
gray,0.754,93,788,1,1,0.335,0.153,0.189,881
trek,0.754,32,276,1,1,0.469,0.53,0.535,308
crushing,0.753,110,931,1,1,0.219,0.755,0.411,1041
finished,0.753,404,3400,1,1,0.51,0.387,0.57,3804
sling,0.753,4,41,1,1,0.417,0.423,0.404,45
decrepit,0.753,4,41,1,1,0.156,0.49,0.225,45
fearfully,0.753,4,41,1,1,0.112,0.567,0.271,45
lace,0.753,9,83,1,1,0.625,0.2,0.293,92
lotto,0.753,4,41,1,1,0.76,0.635,0.475,45
chaps,0.753,4,41,1,1,0.35,0.462,0.35,45
hull,0.753,4,41,1,1,0.542,0.265,0.353,45
obi,0.753,4,41,1,1,0.469,0.442,0.414,45
dock,0.753,9,83,1,1,0.49,0.409,0.481,92
delegate,0.753,4,41,1,1,0.612,0.491,0.658,45
despairing,0.753,9,83,1,1,0.073,0.735,0.286,92
alias,0.753,4,41,1,1,0.541,0.353,0.333,45
appoint,0.753,4,41,1,1,0.565,0.33,0.509,45
grievance,0.753,4,41,1,1,0.092,0.635,0.364,45
skateboard,0.753,4,41,1,1,0.677,0.55,0.353,45
admiring,0.753,19,167,1,1,0.867,0.578,0.629,186
designated,0.753,14,125,1,1,0.5,0.412,0.616,139
roulette,0.753,4,41,1,1,0.326,0.69,0.422,45
lucrative,0.753,4,41,1,1,0.729,0.519,0.798,45
written,0.752,358,3018,1,1,0.6,0.231,0.52,3376
prioritize,0.752,33,285,1,1,0.671,0.594,0.784,318
daring,0.752,16,142,1,1,0.583,0.84,0.711,158
lifeless,0.751,23,201,1,1,0.042,0.333,0.163,224
occupying,0.751,11,100,1,1,0.573,0.462,0.519,111
alas,0.751,83,706,1,1,0.571,0.31,0.279,789
ledge,0.751,11,100,1,1,0.406,0.235,0.339,111
fascination,0.751,11,100,1,1,0.885,0.773,0.835,111
intelligence,0.751,85,723,1,1,0.833,0.587,0.885,808
rot,0.75,77,656,1,1,0.031,0.558,0.301,733
victory,0.75,135,1145,1,1,0.938,0.735,0.931,1280
weaken,0.75,6,58,1,1,0.112,0.25,0.223,64
zoning,0.75,6,58,1,1,0.417,0.4,0.578,64
icing,0.75,13,117,1,1,0.688,0.452,0.411,130
tombstone,0.75,6,58,1,1,0.204,0.441,0.311,64
conservation,0.75,6,58,1,1,0.832,0.401,0.606,64
organ,0.75,13,117,1,1,0.51,0.469,0.538,130
animosity,0.75,6,58,1,1,0.51,0.724,0.545,64
bridge,0.748,124,1054,1,1,0.625,0.324,0.519,1178
elite,0.748,51,438,1,1,0.688,0.704,0.737,489
railway,0.748,8,75,1,1,0.613,0.615,0.623,83
overtake,0.748,8,75,1,1,0.573,0.62,0.718,83
color,0.748,210,1781,1,1,0.786,0.28,0.402,1991
secret,0.747,456,3861,1,1,0.479,0.58,0.509,4317
enthusiasm,0.747,30,261,1,1,0.938,0.816,0.798,291
greatest,0.747,494,4183,1,1,0.847,0.627,0.922,4677
lunacy,0.746,10,92,1,1,0.132,0.847,0.33,102
release,0.746,275,2333,1,1,0.74,0.606,0.741,2608
company,0.746,3875,32783,1,1,0.906,0.425,0.798,36658
heroine,0.746,12,109,1,1,0.729,0.755,0.833,121
environment,0.746,265,2250,1,1,0.646,0.194,0.528,2515
simultaneously,0.746,79,676,1,1,0.656,0.49,0.609,755
misery,0.745,305,2589,1,1,0.146,0.378,0.158,2894
trance,0.745,14,126,1,1,0.469,0.481,0.382,140
kneel,0.745,16,143,1,1,0.426,0.417,0.217,159
zoo,0.744,35,304,1,1,0.76,0.52,0.58,339
bizarre,0.743,55,474,1,1,0.379,0.62,0.392,529
earth,0.743,932,7914,1,1,0.75,0.225,0.614,8846
limit,0.743,118,1009,1,1,0.427,0.453,0.5,1127
burden,0.742,502,4272,1,1,0.367,0.583,0.697,4774
void,0.741,327,2786,1,1,0.135,0.163,0.13,3113
irregular,0.741,5,50,1,1,0.312,0.548,0.321,55
produce,0.741,71,611,1,1,0.908,0.737,0.836,682
claustrophobic,0.741,13,118,1,1,0.092,0.755,0.4,131
monumental,0.741,11,101,1,1,0.656,0.594,0.955,112
residential,0.741,9,84,1,1,0.72,0.21,0.589,93
disconcerting,0.741,5,50,1,1,0.106,0.549,0.269,55
hellfire,0.741,3,33,1,1,0.143,0.89,0.618,36
precedence,0.741,3,33,1,1,0.594,0.52,0.598,36
mural,0.741,3,33,1,1,0.551,0.265,0.454,36
subtext,0.741,3,33,1,1,0.635,0.276,0.412,36
fated,0.741,21,186,1,1,0.582,0.472,0.692,207
marker,0.741,7,67,1,1,0.5,0.333,0.605,74
alligator,0.741,3,33,1,1,0.354,0.704,0.645,36
tracker,0.741,5,50,1,1,0.398,0.744,0.731,55
proportional,0.741,3,33,1,1,0.729,0.38,0.621,36
rebels,0.741,7,67,1,1,0.135,0.86,0.609,74
lieutenant,0.741,3,33,1,1,0.594,0.612,0.92,36
installment,0.741,3,33,1,1,0.619,0.396,0.483,36
carousel,0.741,7,67,1,1,0.704,0.5,0.412,74
blunder,0.741,3,33,1,1,0.135,0.635,0.145,36
makeover,0.741,3,33,1,1,0.771,0.51,0.596,36
trooper,0.741,7,67,1,1,0.458,0.694,0.713,74
backpack,0.741,23,203,1,1,0.729,0.278,0.333,226
hasty,0.741,3,33,1,1,0.188,0.885,0.424,36
bathrobe,0.741,3,33,1,1,0.531,0.442,0.394,36
magnify,0.741,3,33,1,1,0.729,0.561,0.839,36
accord,0.741,9,84,1,1,0.898,0.264,0.382,93
nudist,0.741,5,50,1,1,0.44,0.796,0.483,55
buzzed,0.741,7,67,1,1,0.583,0.549,0.448,74
evergreen,0.741,5,50,1,1,0.729,0.471,0.546,55
cynic,0.741,3,33,1,1,0.135,0.632,0.473,36
indirect,0.741,7,67,1,1,0.385,0.402,0.33,74
film,0.74,347,2959,1,1,0.823,0.491,0.566,3306
enormous,0.74,36,314,1,1,0.677,0.665,0.886,350
wired,0.74,36,314,1,1,0.398,0.42,0.537,350
landing,0.739,32,280,1,1,0.552,0.696,0.596,312
prison,0.739,375,3201,1,1,0.112,0.677,0.491,3576
sip,0.739,57,493,1,1,0.375,0.38,0.213,550
adore,0.739,151,1294,1,1,0.854,0.438,0.657,1445
emphasis,0.739,24,212,1,1,0.653,0.745,0.816,236
loo,0.738,16,144,1,1,0.385,0.357,0.283,160
pi,0.738,16,144,1,1,0.469,0.265,0.4,160
qualities,0.738,48,417,1,1,0.844,0.51,0.731,465
lane,0.737,95,818,1,1,0.449,0.49,0.451,913
booth,0.737,61,528,1,1,0.531,0.4,0.31,589
rear,0.737,14,127,1,1,0.459,0.52,0.284,141
submissive,0.737,14,127,1,1,0.48,0.217,0.173,141
accidental,0.737,14,127,1,1,0.319,0.784,0.307,141
hairy,0.737,14,127,1,1,0.542,0.38,0.343,141
doodle,0.737,12,110,1,1,0.604,0.402,0.376,122
peaked,0.736,10,93,1,1,0.677,0.704,0.857,103
midday,0.736,10,93,1,1,0.658,0.25,0.403,103
attentive,0.736,10,93,1,1,0.812,0.52,0.724,103
zone,0.735,483,4138,1,1,0.531,0.349,0.382,4621
servant,0.735,26,230,1,1,0.34,0.408,0.331,256
realist,0.735,17,153,1,1,0.72,0.572,0.809,170
view,0.734,469,4021,1,1,0.896,0.292,0.555,4490
heroic,0.734,15,136,1,1,0.89,0.77,0.912,151
coconut,0.734,15,136,1,1,0.622,0.265,0.227,151
fade,0.734,109,941,1,1,0.354,0.333,0.245,1050
poop,0.734,61,530,1,1,0.163,0.43,0.172,591
provided,0.733,82,710,1,1,0.871,0.353,0.648,792
attitude,0.733,323,2776,1,1,0.76,0.644,0.861,3099
lime,0.733,13,119,1,1,0.594,0.24,0.415,132
chops,0.733,6,59,1,1,0.612,0.42,0.269,65
retards,0.733,6,59,1,1,0.362,0.434,0.218,65
instill,0.733,6,59,1,1,0.562,0.49,0.618,65
worsening,0.733,6,59,1,1,0.115,0.685,0.202,65
husk,0.733,6,59,1,1,0.378,0.173,0.147,65
welcomed,0.733,67,582,1,1,0.927,0.585,0.7,649
unpredictable,0.732,32,282,1,1,0.429,0.769,0.515,314
irony,0.732,65,565,1,1,0.39,0.587,0.508,630
contagious,0.731,23,205,1,1,0.184,0.725,0.4,228
hunting,0.731,76,660,1,1,0.448,0.713,0.714,736
column,0.731,16,145,1,1,0.48,0.25,0.67,161
spin,0.731,60,523,1,1,0.551,0.422,0.345,583
restore,0.73,63,549,1,1,0.765,0.49,0.625,612
porridge,0.729,4,42,1,1,0.573,0.229,0.274,46
limitation,0.729,4,42,1,1,0.19,0.431,0.225,46
ape,0.729,14,128,1,1,0.548,0.389,0.336,142
radioactive,0.729,4,42,1,1,0.19,0.798,0.741,46
seventh,0.729,9,85,1,1,0.5,0.245,0.288,94
credited,0.729,4,42,1,1,0.781,0.39,0.691,46
commuter,0.729,4,42,1,1,0.646,0.52,0.512,46
interrogation,0.729,4,42,1,1,0.302,0.827,0.657,46
dependant,0.729,14,128,1,1,0.357,0.404,0.451,142
chainsaw,0.729,4,42,1,1,0.367,0.804,0.636,46
marrow,0.729,4,42,1,1,0.398,0.422,0.472,46
lawful,0.729,4,42,1,1,0.66,0.394,0.78,46
fruit,0.729,92,799,1,1,0.896,0.291,0.312,891
infinitely,0.729,27,240,1,1,0.688,0.643,0.829,267
friendship,0.728,651,5612,1,1,0.958,0.343,0.694,6263
faded,0.728,43,378,1,1,0.302,0.275,0.194,421
popularity,0.727,33,292,1,1,0.896,0.784,0.861,325
respecting,0.727,33,292,1,1,0.837,0.321,0.72,325
early,0.727,866,7472,1,1,0.633,0.373,0.426,8338
impulse,0.727,28,249,1,1,0.53,0.84,0.611,277
final,0.727,331,2862,1,1,0.276,0.575,0.508,3193
ranger,0.727,23,206,1,1,0.526,0.545,0.705,229
jog,0.727,15,137,1,1,0.51,0.708,0.519,152
memorable,0.727,31,275,1,1,0.939,0.51,0.769,306
turf,0.727,7,68,1,1,0.531,0.192,0.295,75
torture,0.726,130,1129,1,1,0.115,0.878,0.555,1259
find,0.726,8881,76626,1,1,0.774,0.555,0.58,85507
liability,0.726,18,163,1,1,0.646,0.5,0.802,181
mud,0.726,29,258,1,1,0.333,0.26,0.185,287
hunt,0.726,89,776,1,1,0.327,0.806,0.588,865
thrilling,0.725,10,94,1,1,0.93,0.827,0.782,104
wound,0.725,54,474,1,1,0.15,0.717,0.31,528
snowing,0.725,10,94,1,1,0.586,0.49,0.387,104
declaration,0.725,10,94,1,1,0.551,0.59,0.714,104
sherry,0.724,13,120,1,1,0.594,0.477,0.315,133
willow,0.724,16,146,1,1,0.604,0.245,0.4,162
cigarette,0.724,56,492,1,1,0.219,0.528,0.304,548
greeted,0.724,19,172,1,1,0.781,0.317,0.454,191
blanket,0.723,150,1306,1,1,0.74,0.132,0.391,1456
infinity,0.722,73,640,1,1,0.516,0.459,0.805,713
roost,0.722,2,25,1,1,0.5,0.41,0.345,27
imperfection,0.722,8,77,1,1,0.19,0.567,0.321,85
illustrate,0.722,5,51,1,1,0.75,0.43,0.69,56
explosion,0.722,11,103,1,1,0.167,0.96,0.767,114
remedial,0.722,2,25,1,1,0.369,0.418,0.509,27
stereo,0.722,11,103,1,1,0.617,0.519,0.5,114
snob,0.722,8,77,1,1,0.296,0.52,0.309,85
outgoing,0.722,83,727,1,1,0.65,0.472,0.538,810
argumentative,0.722,2,25,1,1,0.45,0.531,0.679,27
retainer,0.722,2,25,1,1,0.396,0.422,0.356,27
overestimate,0.722,2,25,1,1,0.367,0.796,0.444,27
investor,0.722,5,51,1,1,0.794,0.655,0.791,56
clarinet,0.722,2,25,1,1,0.592,0.453,0.411,27
bear,0.722,389,3379,1,1,0.448,0.57,0.475,3768
identification,0.722,5,51,1,1,0.714,0.451,0.692,56
tango,0.722,8,77,1,1,0.622,0.56,0.43,85
ravioli,0.722,2,25,1,1,0.656,0.281,0.308,27
insistence,0.722,5,51,1,1,0.418,0.704,0.645,56
competence,0.722,5,51,1,1,0.615,0.802,0.823,56
astute,0.722,2,25,1,1,0.776,0.658,0.827,27
saturate,0.722,2,25,1,1,0.281,0.68,0.467,27
accordance,0.722,2,25,1,1,0.659,0.349,0.6,27
discernible,0.722,2,25,1,1,0.427,0.441,0.481,27
susceptible,0.722,8,77,1,1,0.438,0.449,0.304,85
wench,0.722,2,25,1,1,0.469,0.519,0.352,27
ait,0.722,2,25,1,1,0.385,0.39,0.402,27
paternal,0.722,2,25,1,1,0.776,0.353,0.755,27
defrost,0.722,2,25,1,1,0.427,0.317,0.389,27
magenta,0.722,2,25,1,1,0.635,0.275,0.415,27
albino,0.722,2,25,1,1,0.5,0.24,0.358,27
avert,0.722,2,25,1,1,0.51,0.388,0.465,27
gibberish,0.722,5,51,1,1,0.375,0.51,0.36,56
rotting,0.72,27,242,1,1,0.188,0.462,0.255,269
grasping,0.719,15,138,1,1,0.327,0.561,0.561,153
stew,0.719,15,138,1,1,0.667,0.373,0.25,153
outstanding,0.719,28,251,1,1,0.898,0.76,0.896,279
banana,0.718,45,399,1,1,0.612,0.23,0.241,444
temporarily,0.718,42,373,1,1,0.5,0.365,0.373,415
accommodate,0.718,19,173,1,1,0.844,0.375,0.566,192
outlaw,0.718,9,86,1,1,0.255,0.662,0.482,95
redeemed,0.718,9,86,1,1,0.625,0.378,0.434,95
woe,0.717,23,208,1,1,0.34,0.606,0.204,231
comfortable,0.716,2014,17556,1,1,0.927,0.163,0.473,19570
notify,0.716,6,60,1,1,0.643,0.471,0.573,66
sever,0.716,6,60,1,1,0.156,0.635,0.451,66
migrate,0.716,6,60,1,1,0.415,0.58,0.454,66
warrants,0.716,6,60,1,1,0.562,0.431,0.881,66
displeasure,0.716,6,60,1,1,0.115,0.559,0.25,66
remorse,0.716,20,182,1,1,0.103,0.673,0.377,202
attest,0.716,13,121,1,1,0.439,0.71,0.685,134
briefly,0.715,35,313,1,1,0.686,0.314,0.33,348
sap,0.715,10,95,1,1,0.47,0.298,0.258,105
enduring,0.715,32,287,1,1,0.633,0.459,0.768,319
masks,0.714,36,322,1,1,0.51,0.472,0.241,358
recess,0.714,14,130,1,1,0.646,0.51,0.367,144
aching,0.713,45,401,1,1,0.053,0.88,0.348,446
hinder,0.713,22,200,1,1,0.276,0.537,0.47,222
perspective,0.712,260,2282,1,1,0.688,0.47,0.704,2542
artist,0.712,312,2737,1,1,0.802,0.442,0.732,3049
granola,0.712,3,34,1,1,0.625,0.24,0.281,37
invasive,0.712,11,104,1,1,0.194,0.73,0.598,115
panel,0.712,51,454,1,1,0.469,0.321,0.425,505
unwillingly,0.712,3,34,1,1,0.204,0.548,0.182,37
spice,0.712,23,209,1,1,0.594,0.439,0.384,232
patent,0.712,3,34,1,1,0.724,0.391,0.609,37
incoming,0.712,15,139,1,1,0.66,0.509,0.596,154
quarantine,0.712,3,34,1,1,0.16,0.577,0.589,37
elastic,0.712,3,34,1,1,0.656,0.518,0.385,37
illogical,0.712,11,104,1,1,0.208,0.63,0.251,115
initiated,0.712,7,69,1,1,0.76,0.49,0.65,76
occupancy,0.712,3,34,1,1,0.625,0.471,0.721,37
statute,0.712,3,34,1,1,0.592,0.33,0.673,37
rouge,0.712,7,69,1,1,0.562,0.4,0.382,76
cleanup,0.712,3,34,1,1,0.729,0.314,0.451,37
persecute,0.712,3,34,1,1,0.281,0.873,0.509,37
fraction,0.712,15,139,1,1,0.417,0.33,0.4,154
impatiently,0.712,3,34,1,1,0.194,0.75,0.539,37
soapbox,0.712,3,34,1,1,0.5,0.415,0.393,37
ska,0.712,3,34,1,1,0.458,0.575,0.245,37
offing,0.712,3,34,1,1,0.49,0.412,0.447,37
bike,0.711,83,735,1,1,0.708,0.5,0.333,818
socialize,0.71,161,1420,1,1,0.907,0.683,0.726,1581
surprises,0.709,30,271,1,1,0.875,0.769,0.632,301
achieve,0.709,200,1763,1,1,0.816,0.545,0.843,1963
ballet,0.709,8,78,1,1,0.656,0.48,0.358,86
diary,0.708,78,693,1,1,0.698,0.292,0.464,771
aspiring,0.708,13,122,1,1,0.844,0.582,0.604,135
exploit,0.708,13,122,1,1,0.312,0.878,0.66,135
starvation,0.708,13,122,1,1,0.24,0.592,0.284,135
supplies,0.708,32,289,1,1,0.698,0.39,0.595,321
nod,0.707,52,465,1,1,0.59,0.367,0.427,517
aftermath,0.707,28,254,1,1,0.312,0.449,0.444,282
burned,0.707,96,852,1,1,0.163,0.603,0.347,948
trademark,0.706,4,43,1,1,0.667,0.344,0.75,47
crux,0.706,4,43,1,1,0.469,0.558,0.519,47
newsletter,0.706,9,87,1,1,0.622,0.385,0.49,96
plaza,0.706,9,87,1,1,0.69,0.346,0.529,96
succession,0.706,4,43,1,1,0.698,0.481,0.587,47
domesticated,0.706,4,43,1,1,0.635,0.36,0.294,47
housekeeping,0.706,4,43,1,1,0.604,0.5,0.445,47
inadvertently,0.706,9,87,1,1,0.302,0.541,0.549,96
flaming,0.706,9,87,1,1,0.406,0.645,0.558,96
approval,0.706,54,483,1,1,0.854,0.46,0.889,537
competitor,0.706,4,43,1,1,0.612,0.959,0.861,47
creamy,0.706,4,43,1,1,0.823,0.337,0.345,47
evolutionary,0.706,4,43,1,1,0.796,0.673,0.825,47
village,0.706,120,1064,1,1,0.684,0.367,0.336,1184
shepherd,0.706,25,228,1,1,0.656,0.304,0.61,253
wee,0.706,72,642,1,1,0.663,0.452,0.315,714
uncertainty,0.705,57,510,1,1,0.064,0.494,0.282,567
place,0.705,4914,43305,1,1,0.573,0.261,0.398,48219
swell,0.705,15,140,1,1,0.36,0.679,0.348,155
glow,0.705,90,801,1,1,0.918,0.5,0.745,891
mourning,0.705,64,572,1,1,0.177,0.49,0.266,636
drained,0.705,140,1242,1,1,0.31,0.441,0.352,1382
cafe,0.705,97,863,1,1,0.781,0.392,0.358,960
distorted,0.704,10,96,1,1,0.25,0.521,0.28,106
meaning,0.704,453,4003,1,1,0.663,0.395,0.625,4456
vacation,0.704,268,2372,1,1,0.84,0.49,0.598,2640
untold,0.703,22,202,1,1,0.24,0.367,0.191,224
altogether,0.703,34,308,1,1,0.833,0.324,0.644,342
unity,0.703,75,670,1,1,0.837,0.288,0.658,745
echo,0.703,88,785,1,1,0.573,0.373,0.345,873
meddling,0.703,5,52,1,1,0.245,0.6,0.461,57
completing,0.703,17,158,1,1,0.614,0.5,0.769,175
liable,0.703,5,52,1,1,0.656,0.519,0.821,57
extract,0.703,5,52,1,1,0.565,0.402,0.519,57
ulterior,0.703,5,52,1,1,0.375,0.509,0.49,57
pokes,0.703,5,52,1,1,0.365,0.48,0.538,57
decidedly,0.703,5,52,1,1,0.75,0.48,0.843,57
aspiration,0.703,5,52,1,1,0.704,0.724,0.675,57
loveless,0.703,23,211,1,1,0.102,0.365,0.216,234
macaroni,0.703,5,52,1,1,0.816,0.41,0.382,57
northeast,0.703,5,52,1,1,0.562,0.26,0.375,57
godless,0.703,5,52,1,1,0.316,0.557,0.358,57
religious,0.702,153,1360,1,1,0.74,0.238,0.696,1513
established,0.702,36,326,1,1,0.796,0.394,0.694,362
lobster,0.701,12,114,1,1,0.571,0.356,0.291,126
enrich,0.701,12,114,1,1,0.896,0.731,0.705,126
unwilling,0.701,19,176,1,1,0.302,0.316,0.179,195
evaluate,0.701,26,238,1,1,0.663,0.64,0.649,264
imagination,0.7,221,1965,1,1,0.802,0.491,0.547,2186
overpower,0.7,6,61,1,1,0.448,0.859,0.783,67
aquarium,0.7,6,61,1,1,0.663,0.327,0.393,67
programmer,0.7,6,61,1,1,0.562,0.426,0.759,67
obsolete,0.7,6,61,1,1,0.337,0.321,0.25,67
hurricanes,0.7,6,61,1,1,0.286,0.898,0.784,67
apprehensive,0.7,6,61,1,1,0.406,0.592,0.431,67
tie,0.7,63,566,1,1,0.663,0.464,0.431,629
sovereign,0.699,14,132,1,1,0.698,0.5,0.885,146
playful,0.699,29,265,1,1,0.892,0.688,0.463,294
sunday,0.699,506,4495,1,1,0.776,0.196,0.394,5001
jealousy,0.699,60,540,1,1,0.146,0.783,0.481,600
nodding,0.698,30,274,1,1,0.694,0.294,0.426,304
experiment,0.698,38,345,1,1,0.479,0.72,0.675,383
sentence,0.698,124,1108,1,1,0.625,0.265,0.548,1232
rejection,0.698,124,1108,1,1,0.08,0.704,0.33,1232
unfounded,0.698,7,70,1,1,0.271,0.52,0.41,77
inevitable,0.698,96,860,1,1,0.316,0.419,0.623,956
fitness,0.697,34,310,1,1,0.875,0.529,0.81,344
hoard,0.696,8,79,1,1,0.506,0.412,0.518,87
conscious,0.696,113,1013,1,1,0.74,0.333,0.705,1126
temp,0.695,19,177,1,1,0.49,0.44,0.314,196
treacherous,0.695,9,88,1,1,0.112,0.815,0.402,97
stingy,0.695,9,88,1,1,0.094,0.548,0.283,97
paint,0.695,105,943,1,1,0.667,0.343,0.413,1048
wick,0.694,10,97,1,1,0.337,0.481,0.309,107
inanimate,0.694,10,97,1,1,0.281,0.143,0.224,107
understanding,0.694,525,4687,1,1,0.865,0.304,0.689,5212
victoria,0.694,34,311,1,1,0.896,0.811,0.837,345
defined,0.693,106,953,1,1,0.67,0.214,0.646,1059
mining,0.693,11,106,1,1,0.633,0.598,0.554,117
operations,0.693,11,106,1,1,0.48,0.549,0.798,117
director,0.693,49,445,1,1,0.688,0.58,0.912,494
startled,0.693,12,115,1,1,0.333,0.865,0.526,127
limited,0.693,129,1159,1,1,0.229,0.273,0.38,1288
avenger,0.693,12,115,1,1,0.337,0.865,0.67,127
destructive,0.692,66,597,1,1,0.177,0.87,0.713,663
cracking,0.692,41,374,1,1,0.327,0.557,0.286,415
apathetic,0.692,13,124,1,1,0.188,0.292,0.333,137
trader,0.692,13,124,1,1,0.562,0.632,0.854,137
pamper,0.691,14,133,1,1,0.792,0.321,0.348,147
afar,0.691,48,437,1,1,0.396,0.373,0.358,485
fin,0.69,17,160,1,1,0.333,0.34,0.377,177
widowed,0.69,17,160,1,1,0.205,0.439,0.333,177
forgiveness,0.69,90,813,1,1,0.667,0.43,0.471,903
features,0.69,55,500,1,1,0.667,0.433,0.509,555
abba,0.69,18,169,1,1,0.562,0.5,0.48,187
uninterested,0.69,18,169,1,1,0.365,0.24,0.328,187
purge,0.689,21,196,1,1,0.125,0.566,0.327,217
engine,0.689,22,205,1,1,0.615,0.644,0.676,227
length,0.689,46,420,1,1,0.479,0.308,0.533,466
root,0.689,71,644,1,1,0.602,0.279,0.508,715
hail,0.689,23,214,1,1,0.459,0.627,0.411,237
upcoming,0.688,73,662,1,1,0.688,0.46,0.55,735
state,0.688,1165,10448,1,1,0.562,0.32,0.604,11613
halo,0.688,25,232,1,1,0.49,0.37,0.441,257
envious,0.688,27,250,1,1,0.11,0.754,0.341,277
solo,0.688,539,4841,1,1,0.438,0.19,0.325,5380
city,0.686,1123,10098,1,1,0.847,0.531,0.508,11221
word,0.685,1082,9739,1,1,0.552,0.255,0.482,10821
ego,0.684,249,2248,1,1,0.328,0.576,0.593,2497
death,0.684,1247,11227,1,1,0.031,0.72,0.472,12474
muddled,0.684,3,35,1,1,0.25,0.615,0.263,38
entity,0.684,23,215,1,1,0.542,0.402,0.67,238
devastate,0.684,2,26,1,1,0.021,0.796,0.509,28
sensational,0.684,6,62,1,1,0.938,0.827,0.858,68
bloodshed,0.684,2,26,1,1,0.048,0.942,0.525,28
linear,0.684,13,125,1,1,0.646,0.25,0.472,138
attractiveness,0.684,3,35,1,1,0.938,0.667,0.755,38
trophy,0.684,27,251,1,1,0.947,0.643,0.676,278
displaced,0.684,6,62,1,1,0.281,0.472,0.291,68
legion,0.684,33,305,1,1,0.469,0.57,0.852,338
superstition,0.684,2,26,1,1,0.177,0.64,0.418,28
unusually,0.684,5,53,1,1,0.385,0.406,0.358,58
stag,0.684,3,35,1,1,0.594,0.25,0.389,38
drip,0.684,17,161,1,1,0.392,0.193,0.175,178
publisher,0.684,6,62,1,1,0.571,0.392,0.691,68
springtime,0.684,8,80,1,1,0.837,0.439,0.722,88
perpetuate,0.684,7,71,1,1,0.397,0.588,0.788,78
foresee,0.684,5,53,1,1,0.583,0.452,0.522,58
plead,0.684,13,125,1,1,0.177,0.596,0.195,138
diseased,0.684,4,44,1,1,0.123,0.51,0.134,48
irritability,0.684,3,35,1,1,0.146,0.853,0.283,38
gazette,0.684,2,26,1,1,0.469,0.39,0.604,28
cautionary,0.684,2,26,1,1,0.51,0.541,0.519,28
garner,0.684,6,62,1,1,0.479,0.46,0.5,68
turtle,0.684,26,242,1,1,0.291,0.102,0.271,268
wad,0.684,5,53,1,1,0.333,0.318,0.259,58
vested,0.684,4,44,1,1,0.663,0.415,0.648,48
tractor,0.684,4,44,1,1,0.449,0.58,0.619,48
flap,0.684,4,44,1,1,0.275,0.385,0.344,48
blindfold,0.684,4,44,1,1,0.448,0.684,0.337,48
eyelash,0.684,3,35,1,1,0.48,0.25,0.278,38
scorned,0.684,5,53,1,1,0.062,0.529,0.226,58
distortion,0.684,3,35,1,1,0.299,0.57,0.38,38
customized,0.684,2,26,1,1,0.625,0.504,0.59,28
unwarranted,0.684,6,62,1,1,0.091,0.5,0.345,68
gloat,0.684,3,35,1,1,0.5,0.637,0.603,38
crucifix,0.684,2,26,1,1,0.469,0.48,0.51,28
comical,0.684,8,80,1,1,0.844,0.737,0.327,88
forcibly,0.684,6,62,1,1,0.365,0.704,0.647,68
forwarding,0.684,2,26,1,1,0.583,0.537,0.51,28
aide,0.684,9,89,1,1,0.724,0.342,0.434,98
pooch,0.684,4,44,1,1,0.355,0.36,0.347,48
crayons,0.684,3,35,1,1,0.684,0.366,0.405,38
vinegar,0.684,5,53,1,1,0.276,0.37,0.356,58
checkers,0.684,2,26,1,1,0.676,0.451,0.437,28
millennium,0.684,6,62,1,1,0.573,0.398,0.76,68
tenure,0.684,7,71,1,1,0.615,0.472,0.611,78
quack,0.684,3,35,1,1,0.53,0.451,0.625,38
malaria,0.684,2,26,1,1,0.125,0.653,0.304,28
infatuation,0.684,8,80,1,1,0.844,0.745,0.53,88
brink,0.684,20,188,1,1,0.375,0.413,0.356,208
aiding,0.684,5,53,1,1,0.643,0.533,0.569,58
primer,0.684,2,26,1,1,0.625,0.363,0.688,28
pubic,0.684,2,26,1,1,0.406,0.57,0.509,28
dissociative,0.684,3,35,1,1,0.281,0.615,0.397,38
pajamas,0.684,21,197,1,1,0.719,0.17,0.264,218
premise,0.684,17,161,1,1,0.531,0.519,0.517,178
palpable,0.684,11,107,1,1,0.552,0.343,0.611,118
toolbox,0.684,2,26,1,1,0.531,0.316,0.472,28
inherit,0.684,7,71,1,1,0.745,0.546,0.694,78
showy,0.684,2,26,1,1,0.698,0.657,0.661,28
conceive,0.684,9,89,1,1,0.708,0.538,0.7,98
read,0.684,2780,25038,1,1,0.74,0.283,0.611,27818
occasion,0.682,60,549,1,1,0.7,0.451,0.398,609
partly,0.681,40,369,1,1,0.415,0.41,0.396,409
happiness,0.681,1652,14919,1,1,0.96,0.732,0.85,16571
fortune,0.68,51,469,1,1,0.926,0.731,0.873,520
become,0.68,1770,16008,1,1,0.641,0.583,0.643,17778
eye,0.68,527,4772,1,1,0.531,0.265,0.425,5299
combined,0.68,49,451,1,1,0.622,0.37,0.5,500
producer,0.68,24,225,1,1,0.559,0.561,0.917,249
perception,0.679,72,659,1,1,0.653,0.481,0.655,731
overwhelm,0.679,23,216,1,1,0.25,0.823,0.462,239
draining,0.679,163,1482,1,1,0.337,0.396,0.304,1645
creeping,0.679,44,406,1,1,0.292,0.613,0.282,450
instinct,0.679,43,397,1,1,0.771,0.602,0.642,440
ought,0.678,39,361,1,1,0.438,0.511,0.434,400
fuel,0.678,57,524,1,1,0.445,0.528,0.644,581
hardy,0.678,18,171,1,1,0.571,0.569,0.81,189
shield,0.678,53,488,1,1,0.51,0.373,0.663,541
hall,0.678,122,1113,1,1,0.51,0.34,0.424,1235
forming,0.678,34,316,1,1,0.729,0.343,0.8,350
penguin,0.677,15,144,1,1,0.615,0.296,0.307,159
lore,0.677,15,144,1,1,0.719,0.373,0.768,159
chapter,0.677,172,1567,1,1,0.58,0.308,0.461,1739
interpretation,0.677,30,280,1,1,0.677,0.594,0.62,310
err,0.677,14,135,1,1,0.146,0.66,0.236,149
dripping,0.677,14,135,1,1,0.302,0.257,0.267,149
material,0.676,96,879,1,1,0.521,0.363,0.439,975
beard,0.676,39,362,1,1,0.49,0.261,0.371,401
generate,0.675,12,117,1,1,0.771,0.423,0.772,129
steady,0.675,64,589,1,1,0.68,0.186,0.763,653
invent,0.675,12,117,1,1,0.719,0.689,0.833,129
power,0.675,1256,11412,1,1,0.719,0.67,0.953,12668
inhuman,0.675,11,108,1,1,0.107,0.66,0.492,119
dealer,0.675,11,108,1,1,0.799,0.615,0.683,119
embodiment,0.675,11,108,1,1,0.562,0.69,0.663,119
custom,0.675,23,217,1,1,0.552,0.382,0.688,240
reckless,0.674,34,317,1,1,0.262,0.788,0.279,351
stadium,0.674,55,508,1,1,0.635,0.679,0.611,563
enthusiast,0.674,10,99,1,1,0.867,0.81,0.875,109
attraction,0.674,53,490,1,1,0.906,0.774,0.712,543
deception,0.673,20,190,1,1,0.09,0.745,0.37,210
conform,0.673,20,190,1,1,0.479,0.38,0.375,210
invest,0.673,81,745,1,1,0.65,0.663,0.682,826
deceitful,0.673,9,90,1,1,0.071,0.788,0.371,99
opposed,0.673,59,545,1,1,0.092,0.46,0.606,604
edge,0.673,183,1674,1,1,0.439,0.47,0.468,1857
gauge,0.672,8,81,1,1,0.438,0.646,0.518,89
locate,0.672,8,81,1,1,0.583,0.52,0.786,89
dining,0.671,52,482,1,1,0.724,0.35,0.459,534
dangerous,0.671,631,5761,1,1,0.02,0.941,0.658,6392
effective,0.671,74,683,1,1,0.844,0.632,0.891,757
heaviness,0.67,7,72,1,1,0.219,0.549,0.318,79
fifteen,0.67,23,218,1,1,0.49,0.29,0.443,241
twinkle,0.67,7,72,1,1,0.719,0.724,0.61,79
mercury,0.669,35,328,1,1,0.337,0.312,0.475,363
invincible,0.668,20,191,1,1,0.867,0.853,0.914,211
cleanliness,0.668,6,63,1,1,0.816,0.363,0.609,69
astonished,0.668,6,63,1,1,0.51,0.775,0.574,69
lack,0.668,488,4472,1,1,0.25,0.365,0.242,4960
efficient,0.667,19,182,1,1,0.959,0.604,0.83,201
collapse,0.667,38,356,1,1,0.208,0.689,0.342,394
seed,0.666,35,329,1,1,0.656,0.135,0.306,364
conflicting,0.666,17,164,1,1,0.173,0.738,0.553,181
dictionary,0.666,17,164,1,1,0.62,0.25,0.598,181
satisfactory,0.666,5,54,1,1,0.959,0.569,0.702,59
confidant,0.666,5,54,1,1,0.837,0.633,0.631,59
charter,0.666,5,54,1,1,0.677,0.382,0.518,59
dedication,0.666,41,384,1,1,0.867,0.471,0.682,425
diplomacy,0.666,5,54,1,1,0.74,0.396,0.774,59
farming,0.665,16,155,1,1,0.58,0.414,0.568,171
elaborate,0.665,16,155,1,1,0.561,0.367,0.68,171
pipe,0.664,21,201,1,1,0.541,0.34,0.33,222
merciful,0.664,10,100,1,1,0.854,0.346,0.5,110
reproduce,0.664,10,100,1,1,0.823,0.622,0.76,110
peek,0.663,15,146,1,1,0.486,0.36,0.411,161
praised,0.663,15,146,1,1,0.95,0.441,0.721,161
battery,0.663,73,679,1,1,0.48,0.425,0.442,752
impressionable,0.662,4,45,1,1,0.827,0.72,0.645,49
sadistic,0.662,9,91,1,1,0.031,0.906,0.618,100
undermined,0.662,4,45,1,1,0.365,0.409,0.394,49
dissect,0.662,4,45,1,1,0.367,0.75,0.595,49
inhumanity,0.662,4,45,1,1,0.143,0.54,0.405,49
bungalow,0.662,4,45,1,1,0.562,0.352,0.406,49
accumulate,0.662,4,45,1,1,0.573,0.536,0.607,49
unison,0.662,9,91,1,1,0.51,0.439,0.583,100
substitute,0.662,29,275,1,1,0.427,0.406,0.398,304
weepy,0.662,4,45,1,1,0.068,0.615,0.116,49
accomplice,0.662,4,45,1,1,0.408,0.58,0.51,49
celebratory,0.662,4,45,1,1,0.857,0.653,0.845,49
hypnotized,0.662,9,91,1,1,0.449,0.434,0.38,100
childlike,0.662,4,45,1,1,0.656,0.372,0.293,49
ignition,0.662,4,45,1,1,0.365,0.72,0.657,49
routine,0.661,140,1297,1,1,0.365,0.219,0.333,1437
search,0.661,342,3157,1,1,0.635,0.58,0.462,3499
couch,0.661,274,2531,1,1,0.594,0.082,0.198,2805
guitar,0.661,90,837,1,1,0.844,0.542,0.469,927
stripped,0.66,27,257,1,1,0.255,0.615,0.278,284
calendar,0.66,35,331,1,1,0.48,0.212,0.473,366
unjust,0.66,8,82,1,1,0.115,0.625,0.278,90
coin,0.659,34,322,1,1,0.677,0.574,0.445,356
function,0.659,151,1402,1,1,0.694,0.296,0.618,1553
approaching,0.659,68,636,1,1,0.74,0.557,0.491,704
meaningful,0.658,140,1301,1,1,0.77,0.5,0.802,1441
gorgeous,0.658,158,1468,1,1,0.92,0.56,0.741,1626
fierce,0.657,32,304,1,1,0.281,0.877,0.759,336
deploy,0.657,3,36,1,1,0.5,0.52,0.585,39
enforce,0.657,11,110,1,1,0.583,0.644,0.836,121
extraction,0.657,3,36,1,1,0.418,0.74,0.526,39
study,0.657,359,3329,1,1,0.653,0.361,0.768,3688
reproach,0.657,3,36,1,1,0.24,0.755,0.384,39
launches,0.657,3,36,1,1,0.49,0.663,0.602,39
sod,0.657,7,73,1,1,0.427,0.383,0.333,80
cube,0.657,19,184,1,1,0.469,0.226,0.274,203
mediterranean,0.657,3,36,1,1,0.663,0.454,0.545,39
freeman,0.657,3,36,1,1,0.823,0.454,0.618,39
bind,0.657,15,147,1,1,0.398,0.462,0.448,162
chipper,0.657,3,36,1,1,0.418,0.588,0.5,39
overactive,0.657,3,36,1,1,0.667,0.885,0.592,39
mansion,0.657,59,554,1,1,0.847,0.49,0.717,613
slag,0.657,3,36,1,1,0.266,0.6,0.254,39
compliant,0.657,3,36,1,1,0.677,0.31,0.519,39
enslave,0.657,3,36,1,1,0.073,0.8,0.481,39
counteract,0.657,3,36,1,1,0.378,0.542,0.688,39
visual,0.656,50,471,1,1,0.813,0.462,0.462,521
speech,0.655,199,1851,1,1,0.656,0.47,0.688,2050
bent,0.655,29,277,1,1,0.375,0.453,0.298,306
muted,0.655,29,277,1,1,0.26,0.167,0.162,306
western,0.655,74,694,1,1,0.573,0.5,0.689,768
filling,0.654,69,648,1,1,0.51,0.382,0.525,717
feared,0.654,61,574,1,1,0.24,0.733,0.509,635
print,0.654,46,435,1,1,0.521,0.384,0.482,481
throbbing,0.653,6,64,1,1,0.645,0.808,0.491,70
vigil,0.653,13,129,1,1,0.521,0.48,0.491,142
trajectory,0.653,6,64,1,1,0.653,0.558,0.779,70
playboy,0.653,6,64,1,1,0.646,0.9,0.519,70
regretful,0.653,6,64,1,1,0.167,0.48,0.188,70
bonds,0.651,46,436,1,1,0.74,0.472,0.583,482
king,0.651,408,3802,1,1,0.677,0.69,0.892,4210
dismay,0.651,9,92,1,1,0.314,0.681,0.459,101
chunk,0.651,22,213,1,1,0.365,0.287,0.214,235
witch,0.65,87,818,1,1,0.292,0.71,0.473,905
pending,0.65,12,120,1,1,0.396,0.441,0.473,132
revert,0.65,15,148,1,1,0.38,0.451,0.519,163
translate,0.65,34,325,1,1,0.604,0.423,0.462,359
supply,0.649,49,465,1,1,0.708,0.519,0.603,514
mechanism,0.649,58,549,1,1,0.573,0.583,0.664,607
mob,0.649,67,633,1,1,0.296,0.788,0.567,700
travel,0.648,508,4746,1,1,0.931,0.689,0.535,5254
frontal,0.648,2,27,1,1,0.459,0.434,0.526,29
hiatus,0.648,32,307,1,1,0.479,0.294,0.352,339
cranium,0.648,2,27,1,1,0.439,0.491,0.725,29
festival,0.648,74,699,1,1,0.87,0.706,0.714,773
collie,0.648,2,27,1,1,0.562,0.308,0.328,29
invader,0.648,2,27,1,1,0.2,0.827,0.618,29
mailing,0.648,2,27,1,1,0.688,0.324,0.375,29
unpleasant,0.648,29,279,1,1,0.122,0.612,0.185,308
beau,0.648,8,83,1,1,0.612,0.44,0.432,91
soggy,0.648,5,55,1,1,0.312,0.35,0.241,60
twirl,0.648,2,27,1,1,0.552,0.647,0.409,29
notable,0.648,8,83,1,1,0.76,0.45,0.696,91
boxing,0.648,32,307,1,1,0.427,0.854,0.645,339
dung,0.648,2,27,1,1,0.104,0.549,0.149,29
housekeeper,0.648,5,55,1,1,0.694,0.279,0.52,60
respiratory,0.648,2,27,1,1,0.5,0.45,0.552,29
erratic,0.648,5,55,1,1,0.271,0.503,0.217,60
feverish,0.648,2,27,1,1,0.385,0.696,0.436,29
automobile,0.648,2,27,1,1,0.753,0.625,0.534,29
scramble,0.648,5,55,1,1,0.469,0.744,0.5,60
prefect,0.648,2,27,1,1,0.698,0.451,0.809,29
omnipresent,0.648,5,55,1,1,0.688,0.452,0.825,60
measurement,0.648,2,27,1,1,0.622,0.418,0.491,29
goggles,0.648,2,27,1,1,0.667,0.36,0.278,29
disparage,0.648,2,27,1,1,0.092,0.663,0.336,29
wishful,0.648,11,111,1,1,0.885,0.712,0.606,122
warfare,0.648,14,139,1,1,0.062,0.885,0.845,153
width,0.648,2,27,1,1,0.583,0.28,0.518,29
narrow,0.647,34,326,1,1,0.26,0.368,0.356,360
inclusion,0.646,22,214,1,1,0.774,0.404,0.712,236
valuable,0.646,156,1467,1,1,0.899,0.547,0.798,1623
appreciate,0.646,1340,12539,1,1,0.885,0.422,0.741,13879
blurry,0.645,16,158,1,1,0.059,0.385,0.218,174
west,0.645,162,1524,1,1,0.562,0.337,0.414,1686
mill,0.645,13,130,1,1,0.531,0.382,0.347,143
win,0.645,876,8207,1,1,0.927,0.694,0.888,9083
burnout,0.645,24,233,1,1,0.219,0.445,0.24,257
marble,0.645,24,233,1,1,0.604,0.212,0.667,257
titled,0.645,35,336,1,1,0.677,0.24,0.658,371
pigeon,0.644,10,102,1,1,0.688,0.224,0.276,112
performer,0.644,10,102,1,1,0.541,0.53,0.708,112
adequate,0.643,15,149,1,1,0.854,0.264,0.705,164
capitol,0.643,7,74,1,1,0.535,0.375,0.705,81
machine,0.643,164,1546,1,1,0.51,0.5,0.707,1710
seize,0.642,12,121,1,1,0.656,0.644,0.673,133
eager,0.641,37,356,1,1,0.521,0.812,0.306,393
fatal,0.64,19,187,1,1,0.061,0.775,0.509,206
malevolent,0.64,4,46,1,1,0.094,0.854,0.613,50
conjure,0.64,4,46,1,1,0.385,0.679,0.645,50
cohabitation,0.64,4,46,1,1,0.646,0.526,0.598,50
cooperative,0.64,4,46,1,1,0.816,0.461,0.67,50
peripheral,0.64,4,46,1,1,0.406,0.406,0.549,50
checklist,0.64,4,46,1,1,0.561,0.521,0.552,50
premises,0.64,4,46,1,1,0.5,0.306,0.285,50
incidentally,0.64,4,46,1,1,0.479,0.5,0.5,50
jock,0.64,4,46,1,1,0.592,0.656,0.473,50
cordial,0.64,4,46,1,1,0.823,0.312,0.482,50
hiding,0.64,308,2904,1,1,0.25,0.567,0.364,3212
range,0.64,76,723,1,1,0.49,0.472,0.615,799
distracted,0.639,99,940,1,1,0.194,0.392,0.213,1039
whisper,0.638,122,1158,1,1,0.49,0.225,0.265,1280
prep,0.638,39,376,1,1,0.688,0.509,0.555,415
defiance,0.637,6,65,1,1,0.333,0.78,0.76,71
pirate,0.637,13,131,1,1,0.156,0.74,0.559,144
developer,0.636,15,150,1,1,0.844,0.653,0.864,165
greed,0.636,49,471,1,1,0.173,0.78,0.528,520
mush,0.636,8,84,1,1,0.5,0.311,0.125,92
songwriter,0.636,8,84,1,1,0.844,0.558,0.713,92
optional,0.636,17,169,1,1,0.755,0.35,0.44,186
unimaginable,0.636,17,169,1,1,0.573,0.634,0.589,186
unprecedented,0.636,8,84,1,1,0.5,0.491,0.658,92
refrain,0.635,19,188,1,1,0.314,0.373,0.277,207
shivering,0.635,10,103,1,1,0.122,0.663,0.373,113
annual,0.635,43,415,1,1,0.552,0.236,0.5,458
exaggerated,0.635,10,103,1,1,0.224,0.885,0.732,113
sit,0.634,1429,13522,1,1,0.561,0.23,0.368,14951
puzzle,0.634,36,349,1,1,0.537,0.471,0.525,385
determine,0.634,42,406,1,1,0.612,0.368,0.776,448
implement,0.633,14,141,1,1,0.72,0.573,0.792,155
pumped,0.632,22,217,1,1,0.615,0.7,0.528,239
appreciative,0.632,26,255,1,1,0.857,0.38,0.654,281
john,0.632,393,3736,1,1,0.562,0.382,0.327,4129
occupied,0.631,56,540,1,1,0.337,0.546,0.441,596
shallow,0.631,64,616,1,1,0.427,0.298,0.351,680
index,0.63,11,113,1,1,0.448,0.268,0.342,124
reinforcements,0.63,3,37,1,1,0.646,0.719,0.875,40
scrutiny,0.63,11,113,1,1,0.5,0.653,0.658,124
steamy,0.63,3,37,1,1,0.479,0.538,0.445,40
module,0.63,5,56,1,1,0.582,0.388,0.571,61
rebuttal,0.63,3,37,1,1,0.312,0.69,0.54,40
occur,0.63,41,398,1,1,0.451,0.561,0.51,439
ambivalent,0.63,5,56,1,1,0.51,0.404,0.482,61
capability,0.63,13,132,1,1,0.833,0.571,0.73,145
belligerent,0.63,3,37,1,1,0.344,0.68,0.594,40
medal,0.63,9,94,1,1,0.854,0.555,0.746,103
initiate,0.63,17,170,1,1,0.719,0.48,0.553,187
disable,0.63,5,56,1,1,0.115,0.43,0.269,61
assertive,0.63,7,75,1,1,0.719,0.412,0.77,82
spoiling,0.63,17,170,1,1,0.135,0.678,0.306,187
carols,0.63,3,37,1,1,0.847,0.42,0.491,40
ambitious,0.63,17,170,1,1,0.484,0.821,0.717,187
sensor,0.63,5,56,1,1,0.571,0.377,0.542,61
lightweight,0.63,3,37,1,1,0.67,0.3,0.358,40
obtuse,0.63,3,37,1,1,0.281,0.46,0.345,40
rejoicing,0.63,5,56,1,1,0.811,0.637,0.592,61
loath,0.63,3,37,1,1,0.135,0.714,0.445,40
cuckoo,0.63,3,37,1,1,0.42,0.459,0.284,40
volumes,0.63,31,303,1,1,0.552,0.452,0.52,334
sponge,0.63,9,94,1,1,0.551,0.192,0.219,103
sky,0.63,614,5842,1,1,0.958,0.234,0.401,6456
collect,0.629,76,731,1,1,0.635,0.481,0.491,807
moment,0.629,2515,23923,1,1,0.604,0.435,0.509,26438
fancy,0.629,112,1074,1,1,0.854,0.673,0.534,1186
favorite,0.628,1125,10711,1,1,0.885,0.59,0.691,11836
possessed,0.628,22,218,1,1,0.327,0.884,0.611,240
amusing,0.627,20,199,1,1,0.96,0.829,0.632,219
electric,0.627,56,542,1,1,0.458,0.708,0.512,598
flashing,0.627,16,161,1,1,0.604,0.574,0.438,177
womb,0.627,33,323,1,1,0.375,0.385,0.591,356
foe,0.627,16,161,1,1,0.071,0.827,0.459,177
closure,0.627,31,304,1,1,0.229,0.22,0.412,335
narcissism,0.626,14,142,1,1,0.214,0.639,0.54,156
ease,0.626,217,2078,1,1,0.796,0.385,0.491,2295
brilliant,0.626,183,1754,1,1,0.939,0.575,0.923,1937
timid,0.626,12,123,1,1,0.327,0.276,0.132,135
fantasize,0.625,21,209,1,1,0.771,0.66,0.356,230
leverage,0.625,10,104,1,1,0.459,0.5,0.629,114
resentful,0.625,10,104,1,1,0.12,0.608,0.324,114
engagement,0.625,54,524,1,1,0.906,0.587,0.807,578
civilized,0.625,10,104,1,1,0.792,0.231,0.796,114
verbal,0.625,30,295,1,1,0.52,0.291,0.562,325
serve,0.625,172,1651,1,1,0.622,0.4,0.384,1823
dame,0.625,19,190,1,1,0.694,0.48,0.5,209
lounge,0.624,28,276,1,1,0.592,0.245,0.466,304
arbitrary,0.624,8,85,1,1,0.281,0.702,0.686,93
availability,0.624,8,85,1,1,0.796,0.544,0.6,93
regulation,0.624,8,85,1,1,0.542,0.425,0.667,93
huff,0.624,8,85,1,1,0.388,0.491,0.315,93
talker,0.624,8,85,1,1,0.5,0.604,0.552,93
mug,0.623,31,305,1,1,0.542,0.214,0.382,336
depend,0.623,234,2247,1,1,0.388,0.429,0.358,2481
aspects,0.623,71,688,1,1,0.439,0.48,0.565,759
teller,0.622,6,66,1,1,0.5,0.395,0.443,72
posh,0.622,6,66,1,1,0.823,0.337,0.75,72
glee,0.622,13,133,1,1,0.698,0.58,0.464,146
simplistic,0.622,6,66,1,1,0.49,0.245,0.391,72
clam,0.622,6,66,1,1,0.442,0.302,0.272,72
freely,0.622,88,851,1,1,0.875,0.456,0.716,939
survival,0.622,93,899,1,1,0.541,0.798,0.879,992
concept,0.622,210,2020,1,1,0.573,0.265,0.632,2230
drunken,0.621,30,296,1,1,0.155,0.849,0.25,326
aspect,0.62,116,1121,1,1,0.479,0.469,0.588,1237
sound,0.62,937,8996,1,1,0.765,0.623,0.398,9933
sensation,0.62,36,354,1,1,0.781,0.663,0.673,390
plumbing,0.619,4,47,1,1,0.469,0.427,0.441,51
watchful,0.619,4,47,1,1,0.386,0.49,0.675,51
gripe,0.619,4,47,1,1,0.184,0.526,0.241,51
figment,0.619,4,47,1,1,0.552,0.316,0.533,51
junction,0.619,4,47,1,1,0.49,0.481,0.364,51
fawn,0.619,4,47,1,1,0.626,0.36,0.284,51
segregated,0.619,4,47,1,1,0.164,0.575,0.411,51
gloss,0.619,4,47,1,1,0.757,0.466,0.625,51
deadline,0.619,24,239,1,1,0.214,0.615,0.46,263
feces,0.619,4,47,1,1,0.24,0.407,0.307,51
tramp,0.619,4,47,1,1,0.108,0.51,0.182,51
soft,0.619,352,3388,1,1,0.76,0.179,0.232,3740
penalty,0.619,27,268,1,1,0.062,0.49,0.24,295
menu,0.618,25,249,1,1,0.633,0.333,0.385,274
ticked,0.617,7,76,1,1,0.469,0.386,0.455,83
caste,0.617,7,76,1,1,0.51,0.333,0.374,83
miraculous,0.617,7,76,1,1,0.875,0.706,0.812,83
riddance,0.616,10,105,1,1,0.323,0.562,0.472,115
partake,0.616,10,105,1,1,0.755,0.656,0.629,115
angelic,0.615,13,134,1,1,0.927,0.298,0.668,147
honorable,0.615,27,269,1,1,0.963,0.412,0.83,296
accountability,0.614,36,356,1,1,0.755,0.537,0.833,392
irritable,0.614,19,192,1,1,0.112,0.952,0.462,211
likewise,0.614,31,308,1,1,0.651,0.217,0.312,339
enemy,0.613,230,2230,1,1,0.135,0.794,0.591,2460
secure,0.613,118,1149,1,1,0.844,0.38,0.914,1267
strength,0.613,1209,11695,1,1,0.802,0.682,0.858,12904
heirs,0.613,2,28,1,1,0.796,0.519,0.698,30
dominating,0.613,5,57,1,1,0.427,0.769,0.902,62
precinct,0.613,2,28,1,1,0.375,0.431,0.527,30
paddock,0.613,2,28,1,1,0.48,0.429,0.481,30
hyperactive,0.613,2,28,1,1,0.5,0.921,0.66,30
cookbook,0.613,2,28,1,1,0.602,0.346,0.398,30
begrudge,0.613,2,28,1,1,0.177,0.731,0.377,30
liter,0.613,2,28,1,1,0.573,0.208,0.382,30
flicker,0.613,11,115,1,1,0.635,0.321,0.333,126
iota,0.613,5,57,1,1,0.344,0.385,0.314,62
gizmo,0.613,2,28,1,1,0.51,0.49,0.337,30
deflection,0.613,2,28,1,1,0.188,0.5,0.382,30
outwards,0.613,2,28,1,1,0.44,0.472,0.4,30
undertaking,0.613,2,28,1,1,0.667,0.53,0.696,30
christmastime,0.613,2,28,1,1,0.837,0.588,0.515,30
ramble,0.613,14,144,1,1,0.615,0.464,0.44,158
imperialist,0.613,2,28,1,1,0.284,0.786,0.833,30
swat,0.613,5,57,1,1,0.38,0.694,0.571,62
cobra,0.613,2,28,1,1,0.312,0.712,0.6,30
browse,0.613,8,86,1,1,0.635,0.75,0.592,94
repetitive,0.613,20,202,1,1,0.32,0.438,0.362,222
eighth,0.613,5,57,1,1,0.531,0.226,0.38,62
slurp,0.613,2,28,1,1,0.54,0.528,0.411,30
dissenting,0.613,2,28,1,1,0.208,0.552,0.366,30
disorganized,0.613,2,28,1,1,0.052,0.507,0.184,30
authorized,0.613,2,28,1,1,0.76,0.458,0.815,30
hairless,0.613,2,28,1,1,0.136,0.235,0.139,30
mew,0.613,5,57,1,1,0.418,0.481,0.38,62
saucy,0.613,2,28,1,1,0.25,0.653,0.391,30
janitor,0.613,2,28,1,1,0.51,0.35,0.527,30
facilitate,0.613,8,86,1,1,0.812,0.333,0.509,94
bootleg,0.613,2,28,1,1,0.357,0.519,0.466,30
disconnects,0.613,2,28,1,1,0.256,0.357,0.241,30
parse,0.613,2,28,1,1,0.469,0.456,0.667,30
grumpy,0.612,48,473,1,1,0.198,0.808,0.559,521
advanced,0.612,36,357,1,1,0.844,0.623,0.797,393
birth,0.611,204,1983,1,1,0.896,0.655,0.536,2187
imperfect,0.611,24,241,1,1,0.173,0.527,0.202,265
square,0.611,75,735,1,1,0.509,0.34,0.291,810
musical,0.611,69,677,1,1,0.908,0.63,0.53,746
knit,0.61,12,125,1,1,0.63,0.144,0.295,137
unwelcome,0.61,12,125,1,1,0.115,0.48,0.269,137
exhaustion,0.609,42,416,1,1,0.366,0.633,0.269,458
arrive,0.609,82,804,1,1,0.837,0.406,0.585,886
wording,0.609,9,96,1,1,0.653,0.5,0.588,105
recap,0.609,9,96,1,1,0.602,0.578,0.667,105
conditioning,0.608,16,164,1,1,0.44,0.468,0.617,180
traveling,0.608,197,1922,1,1,0.9,0.75,0.582,2119
rooms,0.608,170,1660,1,1,0.677,0.241,0.386,1830
pew,0.608,6,67,1,1,0.449,0.235,0.664,73
entourage,0.608,6,67,1,1,0.491,0.567,0.467,73
bitterly,0.608,6,67,1,1,0.194,0.685,0.362,73
justification,0.608,13,135,1,1,0.622,0.444,0.661,148
rarely,0.607,234,2283,1,1,0.408,0.367,0.366,2517
witty,0.607,17,174,1,1,0.857,0.707,0.759,191
safety,0.606,285,2781,1,1,0.708,0.491,0.868,3066
skill,0.606,88,865,1,1,0.847,0.701,0.833,953
chair,0.606,140,1371,1,1,0.562,0.082,0.276,1511
scope,0.606,14,145,1,1,0.656,0.386,0.718,159
ale,0.606,14,145,1,1,0.53,0.45,0.358,159
porn,0.606,161,1576,1,1,0.344,0.915,0.421,1737
fantasy,0.605,139,1362,1,1,0.88,0.627,0.474,1501
retrograde,0.605,18,184,1,1,0.208,0.464,0.415,202
spark,0.605,64,632,1,1,0.688,0.745,0.529,696
compassion,0.605,173,1694,1,1,0.735,0.258,0.509,1867
noon,0.605,38,379,1,1,0.531,0.343,0.518,417
freeze,0.605,42,418,1,1,0.191,0.406,0.481,460
sneakers,0.604,7,77,1,1,0.604,0.548,0.349,84
vouch,0.604,7,77,1,1,0.625,0.417,0.746,84
vacuous,0.604,3,38,1,1,0.354,0.267,0.304,41
rightful,0.604,7,77,1,1,0.837,0.358,0.821,84
pointy,0.604,3,38,1,1,0.469,0.651,0.438,41
milky,0.604,11,116,1,1,0.517,0.283,0.311,127
preposterous,0.604,3,38,1,1,0.167,0.827,0.483,41
vase,0.604,3,38,1,1,0.638,0.225,0.215,41
germs,0.604,7,77,1,1,0.135,0.51,0.38,84
inauguration,0.604,3,38,1,1,0.847,0.712,0.769,41
outlandish,0.604,3,38,1,1,0.448,0.737,0.657,41
overreact,0.604,3,38,1,1,0.306,0.912,0.471,41
poser,0.604,3,38,1,1,0.469,0.385,0.316,41
buss,0.604,3,38,1,1,0.469,0.5,0.391,41
silently,0.604,121,1189,1,1,0.448,0.185,0.306,1310
projecting,0.603,24,243,1,1,0.635,0.564,0.786,267
whilst,0.603,200,1961,1,1,0.51,0.302,0.388,2161
haze,0.602,12,126,1,1,0.427,0.327,0.217,138
claws,0.602,12,126,1,1,0.281,0.698,0.562,138
interesting,0.601,481,4710,1,1,0.927,0.726,0.731,5191
vegetable,0.601,8,87,1,1,0.551,0.12,0.289,95
smoothie,0.601,8,87,1,1,0.806,0.333,0.281,95
leather,0.601,17,175,1,1,0.51,0.324,0.341,192
bombing,0.601,8,87,1,1,0.167,0.963,0.732,95
greasy,0.601,8,87,1,1,0.399,0.442,0.294,95
crabby,0.599,4,48,1,1,0.198,0.812,0.37,52
recorder,0.599,4,48,1,1,0.551,0.374,0.481,52
bureaucracy,0.599,4,48,1,1,0.38,0.578,0.74,52
specify,0.599,4,48,1,1,0.656,0.405,0.6,52
buggy,0.599,4,48,1,1,0.5,0.509,0.327,52
paraphrase,0.599,4,48,1,1,0.5,0.375,0.444,52
eventful,0.599,4,48,1,1,0.543,0.837,0.51,52
reactive,0.599,4,48,1,1,0.434,0.817,0.721,52
showcase,0.599,14,146,1,1,0.521,0.255,0.415,160
tingling,0.599,4,48,1,1,0.427,0.615,0.34,52
doze,0.599,4,48,1,1,0.592,0.2,0.405,52
baton,0.599,4,48,1,1,0.272,0.235,0.519,52
pillar,0.599,14,146,1,1,0.583,0.33,0.684,160
lurking,0.599,29,293,1,1,0.421,0.781,0.575,322
prima,0.599,4,48,1,1,0.633,0.406,0.427,52
dedicate,0.598,40,401,1,1,0.823,0.431,0.588,441
horse,0.598,95,941,1,1,0.635,0.51,0.529,1036
sadness,0.597,689,6770,1,1,0.052,0.288,0.164,7459
evaluation,0.597,10,107,1,1,0.542,0.667,0.764,117
mesh,0.597,10,107,1,1,0.429,0.235,0.371,117
retired,0.597,60,598,1,1,0.27,0.259,0.301,658
german,0.596,67,667,1,1,0.438,0.29,0.57,734
spot,0.595,334,3293,1,1,0.51,0.18,0.336,3627
sloppy,0.595,11,117,1,1,0.303,0.441,0.183,128
pepperoni,0.595,5,58,1,1,0.796,0.472,0.358,63
summon,0.595,17,176,1,1,0.521,0.56,0.664,193
chore,0.595,23,235,1,1,0.406,0.462,0.5,258
moth,0.595,11,117,1,1,0.323,0.35,0.196,128
nightstand,0.595,5,58,1,1,0.49,0.13,0.327,63
grope,0.595,5,58,1,1,0.42,0.559,0.358,63
lighting,0.595,42,422,1,1,0.765,0.44,0.75,464
attempt,0.595,195,1928,1,1,0.625,0.491,0.431,2123
deprived,0.595,37,373,1,1,0.354,0.506,0.536,410
scale,0.594,63,629,1,1,0.31,0.35,0.577,692
morality,0.594,25,255,1,1,0.75,0.408,0.759,280
platinum,0.594,12,127,1,1,0.75,0.518,0.702,139
privilege,0.594,97,964,1,1,0.847,0.625,0.821,1061
memory,0.594,263,2599,1,1,0.792,0.378,0.573,2862
sight,0.594,204,2018,1,1,0.684,0.25,0.528,2222
throwback,0.594,19,196,1,1,0.28,0.454,0.356,215
farmer,0.594,19,196,1,1,0.677,0.432,0.464,215
betrayal,0.594,59,590,1,1,0.083,0.719,0.418,649
crazed,0.593,6,68,1,1,0.153,0.877,0.417,74
snooze,0.593,6,68,1,1,0.235,0.357,0.282,74
essentially,0.593,69,689,1,1,0.75,0.373,0.802,758
stubbornness,0.593,6,68,1,1,0.156,0.673,0.508,74
repressed,0.593,13,137,1,1,0.188,0.337,0.311,150
definition,0.592,97,966,1,1,0.573,0.375,0.579,1063
production,0.591,46,463,1,1,0.694,0.594,0.781,509
baron,0.591,7,78,1,1,0.52,0.358,0.709,85
cab,0.591,31,315,1,1,0.438,0.49,0.421,346
potter,0.591,48,483,1,1,0.573,0.417,0.482,531
smell,0.59,196,1946,1,1,0.51,0.52,0.33,2142
internally,0.59,45,454,1,1,0.615,0.4,0.616,499
coma,0.589,18,187,1,1,0.219,0.255,0.302,205
jolly,0.589,18,187,1,1,0.959,0.705,0.708,205
exciting,0.589,118,1177,1,1,0.95,0.792,0.789,1295
worn,0.588,52,524,1,1,0.35,0.482,0.189,576
daytime,0.588,21,217,1,1,0.75,0.324,0.454,238
sour,0.588,32,326,1,1,0.276,0.594,0.373,358
glimpse,0.587,47,475,1,1,0.646,0.48,0.455,522
panther,0.587,11,118,1,1,0.303,0.594,0.682,129
extinction,0.587,11,118,1,1,0.104,0.75,0.611,129
spite,0.587,61,614,1,1,0.08,0.6,0.317,675
competition,0.586,78,783,1,1,0.58,0.79,0.798,861
virtually,0.586,40,406,1,1,0.594,0.521,0.625,446
fragile,0.586,96,962,1,1,0.302,0.163,0.126,1058
irreplaceable,0.585,14,148,1,1,0.479,0.58,0.833,162
thousand,0.585,203,2026,1,1,0.663,0.355,0.48,2229
kink,0.585,31,317,1,1,0.337,0.634,0.321,348
span,0.585,32,327,1,1,0.521,0.33,0.528,359
outlook,0.585,33,337,1,1,0.83,0.525,0.625,370
masturbation,0.584,18,188,1,1,0.542,0.961,0.509,206
celibate,0.584,19,198,1,1,0.419,0.387,0.391,217
shape,0.583,122,1223,1,1,0.592,0.24,0.422,1345
dull,0.583,49,497,1,1,0.194,0.12,0.185,546
fashion,0.582,66,667,1,1,0.827,0.616,0.589,733
respects,0.581,38,388,1,1,0.84,0.387,0.824,426
include,0.581,140,1406,1,1,0.729,0.449,0.702,1546
guardian,0.58,69,698,1,1,0.656,0.686,0.789,767
mind,0.58,5001,49963,1,1,0.65,0.388,0.627,54964
gifts,0.579,126,1268,1,1,0.865,0.755,0.509,1394
septum,0.579,2,29,1,1,0.276,0.423,0.41,31
ludicrous,0.579,7,79,1,1,0.137,0.553,0.274,86
varying,0.579,12,129,1,1,0.552,0.471,0.385,141
stricken,0.579,4,49,1,1,0.163,0.72,0.368,53
champagne,0.579,26,269,1,1,0.76,0.6,0.454,295
trapping,0.579,4,49,1,1,0.333,0.621,0.491,53
replica,0.579,3,39,1,1,0.48,0.52,0.493,42
bullock,0.579,3,39,1,1,0.281,0.402,0.375,42
glider,0.579,2,29,1,1,0.618,0.548,0.59,31
placebo,0.579,3,39,1,1,0.52,0.306,0.365,42
abdomen,0.579,2,29,1,1,0.469,0.462,0.471,31
apron,0.579,2,29,1,1,0.582,0.208,0.245,31
marsh,0.579,4,49,1,1,0.302,0.358,0.277,53
conditions,0.579,100,1009,1,1,0.551,0.441,0.593,1109
bulb,0.579,8,89,1,1,0.562,0.208,0.3,97
confidentiality,0.579,3,39,1,1,0.667,0.431,0.718,42
fenced,0.579,2,29,1,1,0.323,0.43,0.429,31
inaction,0.579,7,79,1,1,0.323,0.225,0.325,86
deem,0.579,11,119,1,1,0.594,0.529,0.69,130
wickedness,0.579,5,59,1,1,0.031,0.727,0.443,64
rearrange,0.579,8,89,1,1,0.656,0.51,0.729,97
excrement,0.579,2,29,1,1,0.041,0.558,0.221,31
causal,0.579,2,29,1,1,0.562,0.367,0.491,31
jeopardize,0.579,3,39,1,1,0.26,0.877,0.582,42
cracker,0.579,6,69,1,1,0.604,0.343,0.346,75
exec,0.579,3,39,1,1,0.64,0.352,0.769,42
bis,0.579,3,39,1,1,0.44,0.42,0.345,42
sludge,0.579,2,29,1,1,0.354,0.396,0.229,31
administer,0.579,2,29,1,1,0.635,0.425,0.86,31
bending,0.579,10,109,1,1,0.448,0.565,0.455,119
designing,0.579,7,79,1,1,0.792,0.355,0.552,86
lethargic,0.579,4,49,1,1,0.214,0.245,0.375,53
anecdote,0.579,3,39,1,1,0.583,0.529,0.5,42
hindering,0.579,4,49,1,1,0.26,0.654,0.435,53
deterrent,0.579,3,39,1,1,0.292,0.461,0.385,42
rancid,0.579,3,39,1,1,0.156,0.451,0.214,42
thirteen,0.579,9,99,1,1,0.459,0.385,0.331,108
trickster,0.579,2,29,1,1,0.375,0.68,0.446,31
arch,0.579,23,239,1,1,0.5,0.354,0.468,262
pub,0.579,47,479,1,1,0.592,0.637,0.446,526
headphones,0.579,169,1699,1,1,0.6,0.357,0.336,1868
pedal,0.579,3,39,1,1,0.5,0.32,0.342,42
lifeguard,0.579,2,29,1,1,0.87,0.606,0.786,31
supremely,0.579,3,39,1,1,0.833,0.725,0.897,42
activation,0.579,2,29,1,1,0.781,0.8,0.754,31
remark,0.579,11,119,1,1,0.561,0.325,0.716,130
quell,0.579,3,39,1,1,0.388,0.696,0.434,42
rabbi,0.579,9,99,1,1,0.459,0.362,0.723,108
hijack,0.579,4,49,1,1,0.042,0.908,0.594,53
decorum,0.579,2,29,1,1,0.802,0.327,0.462,31
booze,0.579,27,279,1,1,0.265,0.745,0.431,306
barricade,0.579,8,89,1,1,0.323,0.667,0.673,97
shrill,0.579,3,39,1,1,0.312,0.721,0.64,42
rounded,0.579,6,69,1,1,0.592,0.391,0.396,75
compact,0.579,3,39,1,1,0.458,0.417,0.673,42
standby,0.579,7,79,1,1,0.26,0.224,0.386,86
taker,0.579,7,79,1,1,0.375,0.521,0.618,86
inferior,0.579,18,189,1,1,0.26,0.254,0.106,207
recruits,0.579,2,29,1,1,0.396,0.653,0.593,31
wellness,0.579,35,359,1,1,0.969,0.441,0.73,394
unofficial,0.579,4,49,1,1,0.26,0.302,0.255,53
ongoing,0.579,50,509,1,1,0.674,0.484,0.556,559
curriculum,0.579,8,89,1,1,0.708,0.306,0.62,97
engraved,0.579,4,49,1,1,0.542,0.375,0.473,53
unforgiving,0.579,8,89,1,1,0.406,0.63,0.793,97
eater,0.579,13,139,1,1,0.459,0.337,0.51,152
outlive,0.579,10,109,1,1,0.565,0.769,0.724,119
inserted,0.579,3,39,1,1,0.479,0.402,0.476,42
kickboxing,0.579,2,29,1,1,0.427,0.882,0.651,31
virginity,0.579,13,139,1,1,0.691,0.676,0.576,152
ripper,0.579,3,39,1,1,0.219,0.887,0.642,42
healthy,0.578,678,6795,1,1,0.938,0.319,0.818,7473
attract,0.577,64,650,1,1,0.796,0.663,0.769,714
familiar,0.576,179,1803,1,1,0.906,0.33,0.615,1982
relieve,0.576,35,360,1,1,0.813,0.183,0.536,395
gain,0.575,243,2447,1,1,0.917,0.64,0.822,2690
product,0.575,84,852,1,1,0.646,0.417,0.648,936
constant,0.575,496,4987,1,1,0.74,0.296,0.686,5483
simply,0.574,640,6437,1,1,0.535,0.148,0.393,7077
cleaner,0.574,20,210,1,1,0.604,0.556,0.375,230
tequila,0.574,19,200,1,1,0.612,0.71,0.536,219
prior,0.574,59,602,1,1,0.468,0.35,0.417,661
founder,0.574,19,200,1,1,0.76,0.465,0.891,219
named,0.573,144,1457,1,1,0.562,0.396,0.565,1601
circle,0.573,248,2503,1,1,0.48,0.29,0.343,2751
layer,0.573,16,170,1,1,0.5,0.208,0.366,186
rejects,0.573,16,170,1,1,0.083,0.637,0.422,186
tongue,0.572,87,885,1,1,0.542,0.432,0.482,972
unanswered,0.571,13,140,1,1,0.276,0.361,0.219,153
talent,0.571,137,1389,1,1,0.959,0.607,0.811,1526
swimming,0.571,79,805,1,1,0.76,0.559,0.524,884
stellar,0.57,11,120,1,1,0.796,0.58,0.769,131
glaring,0.57,10,110,1,1,0.694,0.794,0.798,120
rocket,0.569,31,322,1,1,0.664,0.824,0.774,353
sandwich,0.569,52,534,1,1,0.672,0.314,0.31,586
interviewer,0.569,9,100,1,1,0.552,0.736,0.816,109
improvement,0.568,38,393,1,1,0.786,0.5,0.611,431
notorious,0.568,8,90,1,1,0.366,0.582,0.609,98
warming,0.567,41,424,1,1,0.594,0.637,0.58,465
warlock,0.566,7,80,1,1,0.312,0.558,0.657,87
caramel,0.566,7,80,1,1,0.901,0.363,0.4,87
announce,0.566,47,485,1,1,0.694,0.618,0.611,532
leak,0.566,15,161,1,1,0.378,0.833,0.52,176
fatty,0.566,7,80,1,1,0.286,0.361,0.325,87
suspension,0.566,7,80,1,1,0.288,0.53,0.426,87
slay,0.566,22,232,1,1,0.133,0.92,0.585,254
royal,0.565,44,455,1,1,0.796,0.43,0.759,499
cruelty,0.565,36,374,1,1,0.092,0.836,0.536,410
excitement,0.565,78,800,1,1,0.896,0.684,0.731,878
downright,0.564,13,141,1,1,0.625,0.454,0.679,154
horrors,0.564,20,212,1,1,0.061,0.852,0.409,232
literacy,0.564,6,70,1,1,0.73,0.306,0.638,76
human,0.564,1738,17641,1,1,0.767,0.314,0.605,19379
focus,0.564,784,7963,1,1,0.69,0.382,0.648,8747
preaching,0.564,32,334,1,1,0.646,0.604,0.795,366
piles,0.563,12,131,1,1,0.469,0.423,0.468,143
tolerant,0.563,12,131,1,1,0.765,0.192,0.618,143
snacks,0.563,83,852,1,1,0.781,0.48,0.306,935
satisfied,0.563,112,1147,1,1,0.959,0.51,0.685,1259
martyr,0.562,11,121,1,1,0.281,0.708,0.509,132
queues,0.562,5,60,1,1,0.385,0.479,0.269,65
burdensome,0.562,5,60,1,1,0.229,0.696,0.419,65
micro,0.562,11,121,1,1,0.5,0.27,0.25,132
masculine,0.562,17,182,1,1,0.653,0.54,0.773,199
infidelity,0.562,5,60,1,1,0.062,0.777,0.392,65
tick,0.562,28,294,1,1,0.521,0.386,0.412,322
chilled,0.561,16,172,1,1,0.521,0.34,0.482,188
tow,0.561,10,111,1,1,0.531,0.5,0.508,121
adolescent,0.561,10,111,1,1,0.781,0.68,0.509,121
moot,0.561,10,111,1,1,0.344,0.5,0.615,121
greatly,0.561,76,783,1,1,0.75,0.708,0.877,859
lacking,0.56,57,590,1,1,0.229,0.375,0.121,647
peach,0.56,20,213,1,1,0.704,0.48,0.272,233
east,0.56,103,1059,1,1,0.51,0.25,0.317,1162
challenge,0.559,266,2722,1,1,0.469,0.922,0.713,2988
keyword,0.559,4,50,1,1,0.602,0.52,0.747,54
lackluster,0.559,4,50,1,1,0.25,0.311,0.264,54
compelled,0.559,24,254,1,1,0.333,0.654,0.347,278
glimmer,0.559,9,101,1,1,0.615,0.462,0.427,110
sanctimonious,0.559,4,50,1,1,0.24,0.365,0.327,54
jester,0.559,9,101,1,1,0.388,0.67,0.264,110
rein,0.559,4,50,1,1,0.5,0.357,0.438,54
display,0.559,59,611,1,1,0.677,0.325,0.4,670
dreamer,0.559,19,203,1,1,0.82,0.394,0.455,222
loathe,0.559,29,305,1,1,0.094,0.73,0.429,334
whiplash,0.559,4,50,1,1,0.257,0.76,0.5,54
barf,0.559,4,50,1,1,0.34,0.491,0.394,54
occupy,0.558,32,336,1,1,0.396,0.52,0.589,368
bollocks,0.557,13,142,1,1,0.448,0.471,0.327,155
instance,0.557,41,428,1,1,0.547,0.45,0.558,469
van,0.557,64,663,1,1,0.561,0.378,0.425,727
heavily,0.557,81,837,1,1,0.542,0.679,0.814,918
humble,0.557,99,1021,1,1,0.867,0.236,0.483,1120
athletic,0.557,8,91,1,1,0.857,0.798,0.708,99
reel,0.557,8,91,1,1,0.449,0.332,0.395,99
blackness,0.557,8,91,1,1,0.26,0.48,0.406,99
milkshake,0.557,8,91,1,1,0.796,0.521,0.33,99
allow,0.556,624,6389,1,1,0.698,0.429,0.538,7013
dominate,0.556,12,132,1,1,0.439,0.814,0.953,144
weekend,0.556,1079,11049,1,1,0.844,0.625,0.519,12128
fictional,0.555,41,429,1,1,0.43,0.49,0.34,470
mixed,0.555,116,1197,1,1,0.51,0.346,0.444,1313
editing,0.555,53,552,1,1,0.604,0.404,0.493,605
shadow,0.555,238,2447,1,1,0.302,0.343,0.158,2685
directed,0.555,36,378,1,1,0.542,0.49,0.541,414
subside,0.554,7,81,1,1,0.375,0.308,0.209,88
paving,0.554,7,81,1,1,0.408,0.469,0.545,88
infernal,0.554,3,40,1,1,0.083,0.837,0.571,43
definitive,0.554,7,81,1,1,0.583,0.479,0.787,88
exemplary,0.554,3,40,1,1,0.833,0.343,0.729,43
goodie,0.554,3,40,1,1,0.854,0.327,0.6,43
worthwhile,0.554,39,409,1,1,0.908,0.385,0.538,448
overhear,0.554,3,40,1,1,0.65,0.365,0.58,43
pardon,0.554,19,204,1,1,0.552,0.413,0.542,223
alley,0.554,31,327,1,1,0.347,0.5,0.355,358
biscuit,0.554,11,122,1,1,0.888,0.26,0.231,133
registry,0.554,3,40,1,1,0.573,0.32,0.583,43
outstretched,0.554,3,40,1,1,0.448,0.481,0.519,43
project,0.554,239,2460,1,1,0.725,0.462,0.853,2699
tradition,0.552,48,502,1,1,0.83,0.43,0.75,550
den,0.552,48,502,1,1,0.51,0.347,0.398,550
presume,0.552,14,153,1,1,0.448,0.635,0.635,167
unlock,0.552,21,225,1,1,0.582,0.442,0.592,246
frantically,0.552,10,112,1,1,0.375,0.898,0.735,122
apparent,0.551,42,441,1,1,0.473,0.383,0.398,483
mighty,0.551,49,513,1,1,0.855,0.837,0.936,562
visit,0.551,462,4760,1,1,0.771,0.443,0.445,5222
trio,0.55,13,143,1,1,0.521,0.613,0.473,156
cheeseburger,0.55,6,71,1,1,0.802,0.529,0.336,77
assess,0.55,13,143,1,1,0.698,0.5,0.623,156
manual,0.55,13,143,1,1,0.635,0.245,0.449,156
comprehension,0.55,13,143,1,1,0.908,0.387,0.688,156
bruise,0.55,6,71,1,1,0.133,0.64,0.474,77
cannon,0.55,6,71,1,1,0.529,0.676,0.811,77
otter,0.55,6,71,1,1,0.439,0.216,0.339,77
lords,0.55,13,143,1,1,0.571,0.356,0.781,156
recycled,0.55,6,71,1,1,0.561,0.316,0.409,77
preparing,0.55,82,853,1,1,0.735,0.538,0.585,935
organize,0.55,30,318,1,1,0.802,0.655,0.781,348
velvet,0.55,23,246,1,1,0.663,0.226,0.304,269
cliff,0.55,40,421,1,1,0.361,0.62,0.509,461
extent,0.549,83,864,1,1,0.646,0.451,0.602,947
doomed,0.549,113,1173,1,1,0.041,0.755,0.301,1286
duo,0.549,29,308,1,1,0.51,0.5,0.447,337
interfere,0.549,19,205,1,1,0.323,0.714,0.471,224
quotes,0.548,77,803,1,1,0.625,0.578,0.52,880
resigned,0.548,38,401,1,1,0.24,0.17,0.268,439
nonchalant,0.548,12,133,1,1,0.312,0.314,0.366,145
signature,0.548,15,164,1,1,0.57,0.422,0.657,179
craziness,0.548,31,329,1,1,0.238,0.908,0.255,360
curve,0.548,34,360,1,1,0.48,0.375,0.307,394
creator,0.547,84,876,1,1,0.865,0.592,0.856,960
appreciates,0.547,43,453,1,1,0.765,0.5,0.656,496
partially,0.547,30,319,1,1,0.418,0.368,0.396,349
fish,0.546,151,1569,1,1,0.51,0.28,0.25,1720
decrease,0.546,14,154,1,1,0.125,0.36,0.267,168
softball,0.546,5,61,1,1,0.735,0.63,0.518,66
ecological,0.546,2,30,1,1,0.885,0.29,0.607,32
fern,0.546,2,30,1,1,0.602,0.24,0.29,32
peck,0.546,5,61,1,1,0.202,0.53,0.321,66
tyranny,0.546,14,154,1,1,0.112,0.792,0.705,168
doughnut,0.546,2,30,1,1,0.663,0.38,0.279,32
occupant,0.546,2,30,1,1,0.5,0.417,0.483,32
darken,0.546,2,30,1,1,0.25,0.471,0.382,32
innuendo,0.546,2,30,1,1,0.467,0.67,0.463,32
missiles,0.546,2,30,1,1,0.07,0.922,0.83,32
infamous,0.546,8,92,1,1,0.146,0.58,0.472,100
inspect,0.546,2,30,1,1,0.479,0.603,0.793,32
genital,0.546,2,30,1,1,0.385,0.694,0.453,32
pest,0.546,5,61,1,1,0.188,0.68,0.452,66
jerky,0.546,2,30,1,1,0.233,0.538,0.358,32
erroneous,0.546,2,30,1,1,0.057,0.561,0.245,32
bode,0.546,2,30,1,1,0.344,0.406,0.411,32
luncheon,0.546,2,30,1,1,0.837,0.24,0.441,32
ahhhhhhhh,0.546,2,30,1,1,0.552,0.649,0.288,32
mileage,0.546,2,30,1,1,0.51,0.458,0.562,32
possum,0.546,2,30,1,1,0.408,0.471,0.306,32
geography,0.546,8,92,1,1,0.719,0.15,0.553,100
avatar,0.546,17,185,1,1,0.633,0.41,0.567,202
painless,0.546,5,61,1,1,0.785,0.173,0.491,66
humorous,0.546,8,92,1,1,0.906,0.616,0.665,100
mobility,0.546,11,123,1,1,0.7,0.596,0.654,134
goon,0.546,5,61,1,1,0.312,0.481,0.361,66
rattled,0.546,5,61,1,1,0.354,0.641,0.33,66
jive,0.546,2,30,1,1,0.561,0.551,0.373,32
guise,0.546,8,92,1,1,0.531,0.547,0.324,100
organism,0.546,2,30,1,1,0.457,0.559,0.8,32
junk,0.545,46,485,1,1,0.115,0.481,0.118,531
disturbing,0.545,87,909,1,1,0.146,0.792,0.439,996
learning,0.545,949,9825,1,1,0.833,0.588,0.574,10774
equally,0.545,109,1137,1,1,0.625,0.264,0.436,1246
functional,0.544,19,206,1,1,0.75,0.5,0.72,225
oxygen,0.544,33,351,1,1,0.908,0.31,0.575,384
adolescence,0.544,16,175,1,1,0.487,0.694,0.444,191
noted,0.544,30,320,1,1,0.615,0.382,0.464,350
resonate,0.544,41,434,1,1,0.582,0.61,0.644,475
personal,0.543,1022,10603,1,1,0.75,0.311,0.467,11625
variation,0.542,7,82,1,1,0.635,0.561,0.406,89
draw,0.541,220,2293,1,1,0.704,0.449,0.481,2513
undesirable,0.541,12,134,1,1,0.177,0.644,0.26,146
secretive,0.541,12,134,1,1,0.39,0.25,0.538,146
playoff,0.541,12,134,1,1,0.622,0.716,0.55,146
surveillance,0.541,12,134,1,1,0.365,0.72,0.718,146
dreadful,0.54,35,373,1,1,0.092,0.786,0.348,408
involve,0.54,52,550,1,1,0.694,0.49,0.728,602
superhuman,0.539,4,51,1,1,0.81,0.745,0.895,55
stuffy,0.539,4,51,1,1,0.323,0.615,0.406,55
theft,0.539,14,155,1,1,0.135,0.867,0.394,169
maverick,0.539,4,51,1,1,0.354,0.676,0.409,55
disposal,0.539,9,103,1,1,0.135,0.608,0.396,112
cooperating,0.539,4,51,1,1,0.76,0.39,0.693,55
pike,0.539,4,51,1,1,0.427,0.41,0.452,55
porter,0.539,9,103,1,1,0.571,0.375,0.654,112
dehydration,0.539,4,51,1,1,0.188,0.472,0.259,55
remake,0.539,24,259,1,1,0.583,0.488,0.642,283
purr,0.539,4,51,1,1,0.604,0.46,0.302,55
moderately,0.539,4,51,1,1,0.604,0.264,0.5,55
undress,0.539,4,51,1,1,0.438,0.9,0.336,55
applicable,0.539,9,103,1,1,0.469,0.43,0.667,112
sarcasm,0.539,31,332,1,1,0.125,0.685,0.346,363
rogue,0.539,21,228,1,1,0.334,0.713,0.636,249
sixth,0.538,16,176,1,1,0.521,0.275,0.366,192
vulnerability,0.538,76,801,1,1,0.25,0.51,0.267,877
drifted,0.538,11,124,1,1,0.312,0.542,0.31,135
spotted,0.538,23,249,1,1,0.354,0.472,0.295,272
communism,0.538,11,124,1,1,0.264,0.57,0.623,135
afterlife,0.538,23,249,1,1,0.571,0.567,0.568,272
goals,0.537,307,3210,1,1,0.719,0.49,0.795,3517
soviet,0.537,6,72,1,1,0.347,0.58,0.536,78
torch,0.537,13,145,1,1,0.531,0.63,0.545,158
incoherent,0.537,6,72,1,1,0.122,0.612,0.25,78
unneeded,0.537,6,72,1,1,0.177,0.375,0.245,78
partial,0.537,13,145,1,1,0.429,0.324,0.348,158
mutant,0.537,6,72,1,1,0.337,0.676,0.573,78
blessings,0.536,177,1856,1,1,0.929,0.361,0.623,2033
condition,0.536,207,2169,1,1,0.5,0.469,0.519,2376
plant,0.536,61,646,1,1,0.73,0.18,0.371,707
needle,0.536,15,166,1,1,0.25,0.472,0.36,181
coal,0.536,15,166,1,1,0.36,0.241,0.34,181
nine,0.535,58,615,1,1,0.552,0.255,0.327,673
obscene,0.535,8,93,1,1,0.05,0.745,0.348,101
feasible,0.535,8,93,1,1,0.694,0.388,0.611,101
landed,0.535,28,302,1,1,0.709,0.62,0.48,330
mix,0.535,164,1723,1,1,0.542,0.49,0.472,1887
carefully,0.534,61,647,1,1,0.698,0.33,0.544,708
goal,0.534,326,3417,1,1,0.83,0.356,0.669,3743
complex,0.534,138,1452,1,1,0.388,0.608,0.55,1590
sayonara,0.534,10,114,1,1,0.56,0.398,0.402,124
precise,0.534,10,114,1,1,0.833,0.358,0.769,124
migration,0.534,10,114,1,1,0.492,0.731,0.566,124
greeting,0.534,23,250,1,1,0.854,0.556,0.51,273
mass,0.534,121,1275,1,1,0.458,0.245,0.277,1396
memorial,0.533,25,271,1,1,0.602,0.304,0.6,296
honor,0.533,148,1558,1,1,0.896,0.587,0.857,1706
comparison,0.533,44,470,1,1,0.583,0.456,0.492,514
skate,0.533,14,156,1,1,0.74,0.653,0.508,170
placement,0.533,16,177,1,1,0.643,0.46,0.528,193
robot,0.532,58,617,1,1,0.441,0.337,0.543,675
psychological,0.532,60,638,1,1,0.406,0.449,0.66,698
vicious,0.532,41,439,1,1,0.208,0.694,0.407,480
sucker,0.532,24,261,1,1,0.265,0.393,0.204,285
perform,0.532,80,848,1,1,0.765,0.555,0.773,928
pitch,0.531,61,649,1,1,0.521,0.431,0.465,710
dig,0.531,94,995,1,1,0.367,0.585,0.637,1089
prosper,0.531,32,345,1,1,0.935,0.633,0.857,377
forces,0.53,118,1248,1,1,0.551,0.686,0.886,1366
loopy,0.53,3,41,1,1,0.438,0.52,0.195,44
stumped,0.53,3,41,1,1,0.344,0.604,0.392,44
zillion,0.53,3,41,1,1,0.612,0.559,0.63,44
historic,0.53,13,146,1,1,0.816,0.473,0.784,159
wayward,0.53,5,62,1,1,0.344,0.573,0.409,67
elitist,0.53,9,104,1,1,0.5,0.606,0.656,113
tickle,0.53,5,62,1,1,0.76,0.727,0.342,67
petting,0.53,9,104,1,1,0.812,0.462,0.48,113
jaguar,0.53,3,41,1,1,0.559,0.71,0.654,44
snapshot,0.53,3,41,1,1,0.573,0.578,0.588,44
produced,0.53,33,356,1,1,0.724,0.528,0.693,389
dejected,0.53,7,83,1,1,0.104,0.654,0.347,90
unsustainable,0.53,3,41,1,1,0.255,0.65,0.406,44
chlorine,0.53,3,41,1,1,0.306,0.327,0.332,44
helicopter,0.53,9,104,1,1,0.714,0.806,0.617,113
brackets,0.53,3,41,1,1,0.573,0.281,0.435,44
deviant,0.53,5,62,1,1,0.094,0.589,0.398,67
action,0.53,270,2845,1,1,0.76,0.898,0.802,3115
theme,0.529,155,1638,1,1,0.541,0.176,0.427,1793
fury,0.528,34,367,1,1,0.062,0.875,0.676,401
yard,0.528,57,609,1,1,0.468,0.176,0.349,666
instant,0.528,72,767,1,1,0.766,0.454,0.554,839
unexpected,0.528,70,746,1,1,0.5,0.72,0.333,816
album,0.528,491,5176,1,1,0.635,0.349,0.453,5667
visiting,0.527,105,1115,1,1,0.729,0.44,0.519,1220
paw,0.527,16,178,1,1,0.417,0.36,0.286,194
distracting,0.527,33,357,1,1,0.445,0.583,0.4,390
reduced,0.527,31,336,1,1,0.229,0.365,0.204,367
eleven,0.527,14,157,1,1,0.449,0.25,0.43,171
burrito,0.527,14,157,1,1,0.688,0.294,0.166,171
deed,0.526,12,136,1,1,0.52,0.32,0.592,148
consolation,0.526,71,758,1,1,0.408,0.25,0.304,829
dreams,0.526,675,7126,1,1,0.865,0.415,0.53,7801
blizzard,0.525,10,115,1,1,0.375,0.726,0.417,125
portfolio,0.525,10,115,1,1,0.625,0.28,0.498,125
seminar,0.525,10,115,1,1,0.583,0.36,0.623,125
lynch,0.525,10,115,1,1,0.167,0.885,0.482,125
weed,0.525,152,1613,1,1,0.459,0.294,0.364,1765
nursery,0.525,8,94,1,1,0.894,0.406,0.389,102
intimidated,0.524,33,358,1,1,0.177,0.663,0.208,391
stars,0.524,560,5923,1,1,0.796,0.521,0.484,6483
accompanying,0.524,24,263,1,1,0.787,0.46,0.582,287
consecutive,0.524,15,168,1,1,0.663,0.418,0.643,183
drug,0.524,142,1510,1,1,0.214,0.79,0.453,1652
morning,0.523,1719,18177,1,1,0.688,0.235,0.444,19896
ineffective,0.523,6,73,1,1,0.093,0.422,0.094,79
endearing,0.523,6,73,1,1,0.663,0.434,0.604,79
quantity,0.523,20,221,1,1,0.52,0.472,0.783,241
bead,0.523,6,73,1,1,0.592,0.388,0.381,79
bartender,0.522,18,200,1,1,0.573,0.698,0.585,218
horoscope,0.522,18,200,1,1,0.5,0.36,0.49,218
process,0.522,634,6719,1,1,0.51,0.471,0.615,7353
rail,0.522,11,126,1,1,0.47,0.5,0.526,137
warehouse,0.522,11,126,1,1,0.721,0.365,0.446,137
substance,0.522,52,560,1,1,0.615,0.422,0.528,612
spell,0.521,82,878,1,1,0.385,0.38,0.368,960
aka,0.521,140,1493,1,1,0.459,0.358,0.351,1633
pornography,0.52,4,52,1,1,0.323,0.921,0.481,56
calculator,0.52,4,52,1,1,0.513,0.283,0.588,56
hurrah,0.52,4,52,1,1,0.802,0.74,0.5,56
viking,0.52,4,52,1,1,0.541,0.755,0.605,56
absent,0.52,39,423,1,1,0.177,0.221,0.116,462
wavy,0.52,4,52,1,1,0.52,0.284,0.345,56
denominator,0.52,4,52,1,1,0.45,0.41,0.613,56
subsequent,0.52,9,105,1,1,0.449,0.385,0.4,114
jot,0.52,4,52,1,1,0.406,0.323,0.35,56
melt,0.52,45,487,1,1,0.448,0.615,0.312,532
doorstep,0.519,12,137,1,1,0.531,0.274,0.391,149
gulf,0.519,12,137,1,1,0.52,0.365,0.398,149
dependent,0.518,120,1284,1,1,0.354,0.455,0.404,1404
ultimately,0.518,126,1348,1,1,0.385,0.48,0.558,1474
restraining,0.518,7,84,1,1,0.296,0.702,0.672,91
mechanic,0.518,7,84,1,1,0.571,0.433,0.566,91
revolt,0.518,7,84,1,1,0.343,0.878,0.658,91
imminent,0.518,7,84,1,1,0.49,0.784,0.643,91
capitalism,0.518,34,371,1,1,0.448,0.686,0.848,405
principles,0.517,37,403,1,1,0.698,0.286,0.84,440
tyrant,0.517,10,116,1,1,0.115,0.85,0.683,126
shattered,0.517,57,616,1,1,0.097,0.806,0.309,673
radiance,0.514,2,31,1,1,0.796,0.625,0.719,33
lark,0.514,2,31,1,1,0.57,0.292,0.352,33
grizzly,0.514,2,31,1,1,0.398,0.679,0.657,33
caster,0.514,2,31,1,1,0.604,0.67,0.647,33
chipping,0.514,2,31,1,1,0.354,0.452,0.353,33
proceed,0.514,26,287,1,1,0.729,0.63,0.565,313
plow,0.514,2,31,1,1,0.531,0.56,0.456,33
agricultural,0.514,2,31,1,1,0.686,0.321,0.473,33
pinching,0.514,2,31,1,1,0.25,0.788,0.345,33
concise,0.514,2,31,1,1,0.583,0.298,0.62,33
corona,0.514,2,31,1,1,0.818,0.439,0.745,33
dismantle,0.514,5,63,1,1,0.347,0.644,0.462,68
cardigan,0.514,2,31,1,1,0.599,0.324,0.264,33
economical,0.514,2,31,1,1,0.667,0.564,0.673,33
strand,0.514,11,127,1,1,0.396,0.406,0.538,138
semantics,0.514,2,31,1,1,0.698,0.394,0.569,33
colossal,0.514,5,63,1,1,0.698,0.692,0.9,68
beneficiary,0.514,2,31,1,1,0.776,0.399,0.616,33
maroon,0.514,8,95,1,1,0.469,0.358,0.336,103
tenfold,0.514,2,31,1,1,0.469,0.418,0.5,33
dashing,0.514,2,31,1,1,0.612,0.627,0.799,33
receive,0.514,197,2111,1,1,0.74,0.462,0.551,2308
disparaging,0.514,2,31,1,1,0.102,0.626,0.411,33
foodie,0.514,2,31,1,1,0.781,0.465,0.484,33
erosion,0.514,2,31,1,1,0.312,0.77,0.465,33
melodramatic,0.514,5,63,1,1,0.235,0.692,0.368,68
squall,0.514,2,31,1,1,0.191,0.833,0.655,33
uneventful,0.514,2,31,1,1,0.51,0.343,0.41,33
lovelife,0.514,5,63,1,1,0.837,0.61,0.592,68
cushion,0.514,5,63,1,1,0.653,0.221,0.292,68
extraneous,0.514,2,31,1,1,0.276,0.625,0.478,33
jittery,0.514,2,31,1,1,0.344,0.856,0.255,33
toga,0.514,2,31,1,1,0.698,0.393,0.373,33
zap,0.514,2,31,1,1,0.385,0.438,0.371,33
stamina,0.514,5,63,1,1,0.664,0.694,0.877,68
undercover,0.514,5,63,1,1,0.388,0.627,0.483,68
schedule,0.514,168,1802,1,1,0.51,0.38,0.48,1970
wave,0.513,157,1686,1,1,0.622,0.491,0.49,1843
supernatural,0.513,30,330,1,1,0.622,0.824,0.733,360
level,0.513,616,6587,1,1,0.622,0.277,0.491,7203
traffic,0.513,86,928,1,1,0.323,0.559,0.518,1014
lasting,0.512,37,405,1,1,0.804,0.535,0.745,442
stretch,0.512,69,747,1,1,0.604,0.578,0.5,816
intention,0.512,69,747,1,1,0.531,0.48,0.636,816
nay,0.512,15,170,1,1,0.344,0.29,0.325,185
humane,0.512,12,138,1,1,0.8,0.37,0.58,150
homosexual,0.512,12,138,1,1,0.333,0.78,0.431,150
raccoon,0.511,9,106,1,1,0.541,0.435,0.32,115
nosy,0.511,9,106,1,1,0.292,0.558,0.433,115
curtains,0.511,29,320,1,1,0.615,0.123,0.342,349
desk,0.511,106,1144,1,1,0.51,0.135,0.422,1250
upper,0.51,33,363,1,1,0.74,0.529,0.868,396
defeat,0.51,91,984,1,1,0.092,0.5,0.224,1075
thirty,0.51,27,299,1,1,0.562,0.349,0.316,326
swarm,0.51,6,74,1,1,0.302,0.735,0.458,80
overlap,0.51,6,74,1,1,0.594,0.615,0.627,80
bribe,0.51,6,74,1,1,0.112,0.69,0.472,80
printing,0.51,6,74,1,1,0.646,0.654,0.615,80
viewing,0.509,39,428,1,1,0.69,0.394,0.598,467
jeep,0.508,10,117,1,1,0.602,0.51,0.612,127
aging,0.508,32,353,1,1,0.214,0.255,0.284,385
duty,0.508,95,1029,1,1,0.583,0.579,0.651,1124
generally,0.508,158,1705,1,1,0.562,0.255,0.473,1863
crossing,0.508,51,557,1,1,0.549,0.349,0.451,608
phoenix,0.507,30,332,1,1,0.653,0.481,0.594,362
wise,0.507,229,2470,1,1,0.878,0.25,0.861,2699
formidable,0.506,3,42,1,1,0.708,0.709,0.857,45
valiant,0.506,3,42,1,1,0.88,0.745,0.904,45
jubilee,0.506,3,42,1,1,0.916,0.5,0.579,45
matrix,0.506,15,171,1,1,0.551,0.378,0.673,186
incredulous,0.506,3,42,1,1,0.286,0.51,0.269,45
glorify,0.506,11,128,1,1,0.94,0.591,0.661,139
nacho,0.506,3,42,1,1,0.667,0.259,0.333,45
pare,0.506,3,42,1,1,0.5,0.356,0.309,45
leper,0.506,3,42,1,1,0.075,0.589,0.206,45
peacefully,0.506,83,902,1,1,0.901,0.19,0.639,985
saga,0.506,19,214,1,1,0.635,0.44,0.6,233
saddle,0.506,3,42,1,1,0.51,0.509,0.306,45
isolate,0.505,256,2765,1,1,0.235,0.422,0.336,3021
obey,0.505,16,182,1,1,0.677,0.433,0.533,198
rebound,0.505,16,182,1,1,0.521,0.48,0.506,198
style,0.505,162,1754,1,1,0.745,0.472,0.586,1916
collaborate,0.504,12,139,1,1,0.816,0.449,0.559,151
stranded,0.504,38,419,1,1,0.292,0.459,0.219,457
brunette,0.504,12,139,1,1,0.802,0.528,0.529,151
giant,0.504,128,1389,1,1,0.646,0.814,0.963,1517
rationalize,0.504,8,96,1,1,0.633,0.4,0.746,104
siege,0.504,8,96,1,1,0.271,0.75,0.567,104
lava,0.504,8,96,1,1,0.28,0.539,0.615,104
laughs,0.504,108,1174,1,1,0.812,0.846,0.425,1282
factory,0.503,22,247,1,1,0.5,0.5,0.683,269
excruciating,0.503,18,204,1,1,0.083,0.837,0.345,222
fly,0.502,275,2979,1,1,0.76,0.775,0.676,3254
immediate,0.502,68,744,1,1,0.656,0.548,0.716,812
alternative,0.502,73,798,1,1,0.628,0.373,0.631,871
utility,0.502,9,107,1,1,0.622,0.4,0.704,116
tine,0.502,4,53,1,1,0.438,0.373,0.284,57
baseline,0.502,4,53,1,1,0.483,0.367,0.509,57
regress,0.502,4,53,1,1,0.255,0.442,0.3,57
purchasing,0.502,9,107,1,1,0.667,0.653,0.661,116
sale,0.501,51,561,1,1,0.647,0.602,0.573,612
planes,0.501,20,226,1,1,0.667,0.606,0.575,246
folded,0.5,15,172,1,1,0.179,0.373,0.327,187
chap,0.5,15,172,1,1,0.55,0.41,0.345,187
befriend,0.5,42,464,1,1,0.93,0.624,0.471,506
workshop,0.5,26,291,1,1,0.531,0.426,0.51,317
tricky,0.5,37,410,1,1,0.219,0.651,0.5,447
prepare,0.5,143,1557,1,1,0.656,0.542,0.603,1700
vacuum,0.499,33,367,1,1,0.327,0.196,0.134,400
thick,0.499,90,984,1,1,0.449,0.433,0.596,1074
bath,0.499,134,1461,1,1,0.725,0.26,0.263,1595
savvy,0.499,5,64,1,1,0.719,0.52,0.706,69
pariah,0.499,5,64,1,1,0.397,0.478,0.293,69
deli,0.499,5,64,1,1,0.561,0.448,0.447,69
calf,0.499,5,64,1,1,0.531,0.366,0.336,69
humiliation,0.499,17,194,1,1,0.048,0.712,0.31,211
duchess,0.499,5,64,1,1,0.656,0.548,0.711,69
pair,0.498,116,1267,1,1,0.552,0.317,0.304,1383
yellow,0.498,94,1029,1,1,0.671,0.275,0.387,1123
center,0.497,164,1790,1,1,0.643,0.231,0.431,1954
woodwork,0.496,6,75,1,1,0.49,0.481,0.545,81
grape,0.496,6,75,1,1,0.729,0.122,0.295,81
pushy,0.496,6,75,1,1,0.08,0.906,0.741,81
godly,0.496,13,151,1,1,0.747,0.298,0.589,164
caterpillar,0.496,6,75,1,1,0.461,0.286,0.33,81
eventual,0.496,6,75,1,1,0.633,0.459,0.413,81
entertain,0.496,112,1226,1,1,0.918,0.684,0.598,1338
excellent,0.496,127,1389,1,1,0.97,0.587,0.87,1516
mantra,0.496,28,314,1,1,0.396,0.249,0.357,342
must,0.496,2207,23986,1,1,0.408,0.382,0.441,26193
massage,0.496,36,401,1,1,0.708,0.356,0.413,437
slave,0.496,51,564,1,1,0.171,0.795,0.151,615
currency,0.495,14,162,1,1,0.583,0.418,0.592,176
camp,0.495,121,1325,1,1,0.622,0.617,0.594,1446
strained,0.495,7,86,1,1,0.122,0.656,0.58,93
oval,0.494,24,271,1,1,0.417,0.28,0.33,295
sane,0.494,135,1479,1,1,0.76,0.235,0.67,1614
opposite,0.494,281,3069,1,1,0.235,0.545,0.408,3350
setback,0.493,8,97,1,1,0.198,0.451,0.25,105
memorize,0.493,8,97,1,1,0.52,0.451,0.716,105
jarring,0.493,8,97,1,1,0.21,0.673,0.309,105
viva,0.493,8,97,1,1,0.84,0.567,0.644,105
wheels,0.493,17,195,1,1,0.667,0.471,0.386,212
unhealthy,0.493,165,1807,1,1,0.115,0.549,0.214,1972
elders,0.493,27,304,1,1,0.602,0.26,0.441,331
released,0.493,121,1328,1,1,0.844,0.49,0.651,1449
astrology,0.493,18,206,1,1,0.635,0.34,0.5,224
hammer,0.493,18,206,1,1,0.312,0.509,0.563,224
bow,0.493,56,620,1,1,0.53,0.306,0.408,676
angle,0.492,29,326,1,1,0.541,0.33,0.455,355
itchy,0.492,9,108,1,1,0.334,0.726,0.296,117
frog,0.492,20,228,1,1,0.439,0.311,0.15,248
association,0.492,31,348,1,1,0.745,0.5,0.817,379
strive,0.492,64,708,1,1,0.582,0.837,0.769,772
trap,0.492,75,828,1,1,0.104,0.61,0.391,903
tray,0.491,11,130,1,1,0.549,0.25,0.345,141
trivia,0.491,11,130,1,1,0.69,0.49,0.473,141
foul,0.491,24,272,1,1,0.224,0.46,0.355,296
rapper,0.49,25,283,1,1,0.55,0.755,0.482,308
spinning,0.49,40,447,1,1,0.594,0.61,0.481,487
rider,0.49,13,152,1,1,0.635,0.627,0.574,165
jasmine,0.49,13,152,1,1,0.765,0.23,0.286,165
integrity,0.49,71,786,1,1,0.865,0.413,0.848,857
prone,0.489,31,349,1,1,0.415,0.434,0.454,380
lamb,0.489,15,174,1,1,0.646,0.284,0.321,189
entertained,0.489,33,371,1,1,0.902,0.644,0.712,404
skating,0.489,16,185,1,1,0.745,0.673,0.435,201
degree,0.488,146,1608,1,1,0.724,0.365,0.663,1754
interpret,0.488,18,207,1,1,0.646,0.625,0.673,225
fall,0.488,1387,15201,1,1,0.177,0.657,0.221,16588
jaw,0.487,22,251,1,1,0.5,0.51,0.42,273
rat,0.486,56,624,1,1,0.271,0.567,0.255,680
supreme,0.486,59,657,1,1,0.812,0.7,0.974,716
beautiful,0.486,2526,27724,1,1,0.875,0.614,0.648,30250
fearing,0.485,41,460,1,1,0.125,0.566,0.256,501
leadership,0.485,111,1229,1,1,0.87,0.69,0.983,1340
great,0.483,4131,45448,1,1,0.958,0.665,0.81,49579
excepting,0.483,4,54,1,1,0.408,0.413,0.526,58
forthcoming,0.483,4,54,1,1,0.66,0.509,0.6,58
washroom,0.483,7,87,1,1,0.5,0.364,0.446,94
batty,0.483,2,32,1,1,0.375,0.619,0.274,34
giver,0.483,9,109,1,1,0.688,0.415,0.658,118
auburn,0.483,3,43,1,1,0.51,0.24,0.411,46
solar,0.483,31,351,1,1,0.622,0.452,0.645,382
nigger,0.483,4,54,1,1,0.24,0.347,0.398,58
genitalia,0.483,2,32,1,1,0.323,0.667,0.5,34
appeal,0.483,46,516,1,1,0.663,0.598,0.558,562
riding,0.483,90,1000,1,1,0.694,0.654,0.62,1090
cougar,0.483,3,43,1,1,0.438,0.588,0.538,46
investigator,0.483,2,32,1,1,0.615,0.509,0.779,34
delusion,0.483,19,219,1,1,0.344,0.647,0.4,238
regulars,0.483,4,54,1,1,0.729,0.327,0.508,58
farther,0.483,22,252,1,1,0.418,0.5,0.43,274
snuff,0.483,4,54,1,1,0.357,0.47,0.377,58
tyrannical,0.483,2,32,1,1,0.167,0.86,0.731,34
whoo,0.483,3,43,1,1,0.531,0.578,0.311,46
mathematical,0.483,3,43,1,1,0.62,0.5,0.548,46
podium,0.483,4,54,1,1,0.627,0.365,0.702,58
collateral,0.483,4,54,1,1,0.531,0.422,0.717,58
intake,0.483,11,131,1,1,0.604,0.527,0.442,142
redeem,0.483,10,120,1,1,0.633,0.469,0.491,130
indescribable,0.483,14,164,1,1,0.448,0.529,0.648,178
psychiatry,0.483,2,32,1,1,0.191,0.663,0.698,34
digit,0.483,3,43,1,1,0.447,0.286,0.333,46
compatible,0.483,23,263,1,1,0.892,0.387,0.638,286
footing,0.483,5,65,1,1,0.76,0.346,0.464,70
odious,0.483,3,43,1,1,0.235,0.708,0.235,46
distribution,0.483,6,76,1,1,0.635,0.548,0.788,82
degenerate,0.483,11,131,1,1,0.069,0.724,0.264,142
cork,0.483,5,65,1,1,0.347,0.25,0.281,70
casino,0.483,8,98,1,1,0.542,0.684,0.568,106
kappa,0.483,3,43,1,1,0.469,0.375,0.366,46
intent,0.483,38,428,1,1,0.55,0.481,0.5,466
cannibal,0.483,2,32,1,1,0.122,0.824,0.48,34
mandarin,0.483,3,43,1,1,0.625,0.398,0.491,46
ghoul,0.483,6,76,1,1,0.26,0.561,0.43,82
oddball,0.483,2,32,1,1,0.316,0.36,0.357,34
procreate,0.483,7,87,1,1,0.646,0.76,0.802,94
retake,0.483,2,32,1,1,0.616,0.471,0.591,34
seventy,0.483,2,32,1,1,0.625,0.353,0.446,34
retriever,0.483,4,54,1,1,0.459,0.5,0.464,58
graft,0.483,2,32,1,1,0.41,0.528,0.42,34
stairwell,0.483,3,43,1,1,0.51,0.292,0.333,46
competent,0.483,14,164,1,1,0.865,0.56,0.904,178
steer,0.483,13,153,1,1,0.469,0.49,0.527,166
boots,0.483,31,351,1,1,0.602,0.255,0.35,382
advisory,0.483,3,43,1,1,0.656,0.429,0.633,46
hairstyle,0.483,5,65,1,1,0.771,0.38,0.433,70
connect,0.482,350,3866,1,1,0.724,0.299,0.536,4216
partnership,0.481,35,396,1,1,0.786,0.387,0.545,431
breed,0.48,31,352,1,1,0.49,0.441,0.578,383
rose,0.48,127,1411,1,1,0.865,0.276,0.386,1538
liquor,0.48,28,319,1,1,0.603,0.702,0.433,347
beginning,0.48,368,4071,1,1,0.816,0.528,0.558,4439
possible,0.48,808,8927,1,1,0.688,0.316,0.548,9735
gold,0.48,188,2085,1,1,0.939,0.686,0.692,2273
anchor,0.48,26,297,1,1,0.52,0.284,0.564,323
content,0.48,905,10000,1,1,0.764,0.296,0.559,10905
gently,0.48,98,1092,1,1,0.917,0.255,0.36,1190
misunderstanding,0.479,21,242,1,1,0.112,0.618,0.284,263
lighten,0.478,17,198,1,1,0.688,0.438,0.362,215
stirring,0.478,16,187,1,1,0.582,0.702,0.558,203
mermaid,0.478,16,187,1,1,0.765,0.623,0.452,203
streak,0.478,16,187,1,1,0.44,0.608,0.511,203
contempt,0.478,32,364,1,1,0.206,0.635,0.396,396
swamp,0.478,47,530,1,1,0.245,0.425,0.235,577
eight,0.478,47,530,1,1,0.54,0.199,0.315,577
begin,0.477,315,3496,1,1,0.677,0.569,0.763,3811
boomer,0.477,13,154,1,1,0.48,0.539,0.441,167
clock,0.477,96,1073,1,1,0.677,0.173,0.407,1169
outdated,0.476,11,132,1,1,0.167,0.236,0.226,143
staircase,0.476,11,132,1,1,0.469,0.347,0.44,143
pudding,0.476,11,132,1,1,0.75,0.255,0.202,143
drawing,0.476,131,1462,1,1,0.698,0.216,0.333,1593
knowledge,0.476,376,4178,1,1,0.847,0.43,0.896,4554
heavy,0.475,335,3724,1,1,0.25,0.454,0.6,4059
breathe,0.475,509,5654,1,1,0.833,0.373,0.518,6163
misconception,0.475,10,121,1,1,0.21,0.557,0.291,131
fret,0.475,20,232,1,1,0.289,0.46,0.231,252
illiterate,0.474,9,110,1,1,0.12,0.41,0.151,119
charismatic,0.474,9,110,1,1,0.938,0.684,0.849,119
provide,0.474,238,2652,1,1,0.833,0.517,0.704,2890
casual,0.474,47,532,1,1,0.643,0.224,0.385,579
suit,0.474,93,1043,1,1,0.776,0.282,0.482,1136
deceased,0.473,17,199,1,1,0.021,0.538,0.188,216
affliction,0.473,17,199,1,1,0.294,0.635,0.392,216
artists,0.473,150,1677,1,1,0.796,0.667,0.741,1827
declare,0.473,25,288,1,1,0.677,0.623,0.668,313
advantage,0.473,179,2000,1,1,0.917,0.548,0.859,2179
rod,0.473,16,188,1,1,0.479,0.319,0.355,204
bubbly,0.473,16,188,1,1,0.698,0.608,0.462,204
cafeteria,0.473,16,188,1,1,0.757,0.4,0.382,204
uncover,0.472,7,88,1,1,0.771,0.552,0.648,95
rust,0.472,7,88,1,1,0.281,0.265,0.321,95
ruthless,0.472,15,177,1,1,0.208,0.85,0.67,192
monetary,0.472,7,88,1,1,0.583,0.494,0.716,95
affection,0.472,206,2302,1,1,0.898,0.559,0.696,2508
unusual,0.472,46,522,1,1,0.429,0.433,0.361,568
result,0.472,208,2325,1,1,0.812,0.49,0.652,2533
goat,0.471,37,422,1,1,0.448,0.304,0.364,459
temptation,0.471,36,411,1,1,0.365,0.817,0.56,447
publish,0.47,20,233,1,1,0.714,0.547,0.603,253
restoring,0.47,6,77,1,1,0.82,0.49,0.783,83
orphaned,0.47,6,77,1,1,0.062,0.43,0.228,83
adoring,0.47,6,77,1,1,0.885,0.62,0.717,83
avoiding,0.47,115,1292,1,1,0.457,0.433,0.309,1407
plot,0.47,92,1036,1,1,0.469,0.567,0.51,1128
building,0.469,327,3658,1,1,0.705,0.288,0.673,3985
techno,0.468,5,66,1,1,0.561,0.539,0.5,71
denim,0.468,5,66,1,1,0.52,0.382,0.327,71
territory,0.468,28,323,1,1,0.625,0.469,0.676,351
summer,0.468,566,6334,1,1,0.812,0.373,0.55,6900
influence,0.467,100,1128,1,1,0.622,0.663,0.824,1228
ten,0.467,183,2056,1,1,0.562,0.26,0.406,2239
insomnia,0.467,60,681,1,1,0.198,0.611,0.373,741
wright,0.467,10,122,1,1,0.54,0.528,0.389,132
parcel,0.467,10,122,1,1,0.66,0.324,0.411,132
gin,0.467,21,245,1,1,0.449,0.551,0.518,266
takeout,0.467,10,122,1,1,0.736,0.392,0.368,132
unproductive,0.467,10,122,1,1,0.1,0.324,0.237,132
dance,0.467,437,4898,1,1,0.894,0.84,0.551,5335
necklace,0.466,15,178,1,1,0.76,0.294,0.373,193
romantic,0.466,247,2775,1,1,0.936,0.531,0.598,3022
savior,0.466,55,626,1,1,0.92,0.469,0.804,681
hobby,0.465,80,906,1,1,0.827,0.56,0.471,986
bossy,0.465,4,55,1,1,0.24,0.824,0.75,59
squash,0.465,4,55,1,1,0.531,0.667,0.41,59
raggedy,0.465,4,55,1,1,0.198,0.531,0.314,59
schoolwork,0.465,4,55,1,1,0.479,0.5,0.481,59
pied,0.465,4,55,1,1,0.594,0.433,0.35,59
flyer,0.465,4,55,1,1,0.48,0.3,0.362,59
toxicity,0.464,56,638,1,1,0.104,0.865,0.491,694
identity,0.464,144,1625,1,1,0.663,0.36,0.78,1769
faux,0.464,13,156,1,1,0.291,0.49,0.204,169
barrel,0.464,13,156,1,1,0.429,0.298,0.474,169
creed,0.464,13,156,1,1,0.573,0.245,0.544,169
spare,0.464,87,986,1,1,0.552,0.398,0.411,1073
presents,0.463,62,706,1,1,0.781,0.394,0.526,768
frighten,0.463,8,100,1,1,0.255,0.843,0.5,108
chalk,0.463,8,100,1,1,0.385,0.185,0.121,108
knowingly,0.463,12,145,1,1,0.5,0.459,0.481,157
marijuana,0.463,12,145,1,1,0.312,0.779,0.558,157
purely,0.462,42,482,1,1,0.684,0.441,0.536,524
pod,0.462,24,280,1,1,0.48,0.396,0.339,304
confusion,0.461,102,1157,1,1,0.255,0.667,0.277,1259
drinker,0.461,7,89,1,1,0.365,0.735,0.441,96
marital,0.461,7,89,1,1,0.76,0.529,0.5,96
concluding,0.461,3,44,1,1,0.531,0.382,0.603,47
quid,0.461,3,44,1,1,0.479,0.378,0.327,47
session,0.461,99,1124,1,1,0.51,0.481,0.491,1223
almond,0.461,7,89,1,1,0.698,0.183,0.314,96
uprising,0.461,3,44,1,1,0.561,0.777,0.704,47
diplomat,0.461,3,44,1,1,0.563,0.262,0.868,47
backside,0.461,3,44,1,1,0.182,0.417,0.342,47
gent,0.461,3,44,1,1,0.573,0.494,0.464,47
soundproof,0.461,3,44,1,1,0.49,0.39,0.409,47
justifiable,0.461,3,44,1,1,0.786,0.413,0.821,47
faceless,0.461,7,89,1,1,0.23,0.406,0.173,96
ransom,0.461,3,44,1,1,0.582,0.8,0.565,47
wolverine,0.461,3,44,1,1,0.47,0.673,0.627,47
comprehensive,0.461,7,89,1,1,0.796,0.385,0.644,96
hindsight,0.461,11,134,1,1,0.333,0.431,0.532,145
inspired,0.461,203,2294,1,1,0.967,0.702,0.736,2497
seething,0.461,7,89,1,1,0.312,0.821,0.642,96
protecting,0.461,90,1023,1,1,0.878,0.558,0.832,1113
choosing,0.461,224,2531,1,1,0.719,0.529,0.689,2755
lean,0.46,255,2880,1,1,0.734,0.353,0.438,3135
short,0.46,550,6200,1,1,0.184,0.264,0.237,6750
trapped,0.46,236,2667,1,1,0.135,0.615,0.38,2903
leading,0.46,121,1373,1,1,0.823,0.698,0.954,1494
undo,0.46,18,213,1,1,0.365,0.444,0.349,231
kin,0.46,18,213,1,1,0.543,0.441,0.457,231
comic,0.46,71,810,1,1,0.917,0.459,0.387,881
bland,0.459,14,168,1,1,0.3,0.226,0.157,182
morbid,0.459,14,168,1,1,0.09,0.833,0.395,182
prosperous,0.459,10,123,1,1,0.948,0.627,0.89,133
conquer,0.459,65,743,1,1,0.694,0.873,0.971,808
mar,0.459,21,247,1,1,0.622,0.544,0.545,268
filter,0.458,35,405,1,1,0.44,0.296,0.26,440
learned,0.458,1018,11492,1,1,0.704,0.462,0.543,12510
trip,0.458,468,5289,1,1,0.875,0.643,0.538,5757
impressive,0.458,31,360,1,1,0.781,0.83,0.873,391
inch,0.458,34,394,1,1,0.481,0.327,0.3,428
jasper,0.458,6,78,1,1,0.48,0.425,0.402,84
painfully,0.457,36,417,1,1,0.156,0.72,0.407,453
addition,0.456,45,519,1,1,0.562,0.373,0.471,564
bleed,0.456,58,666,1,1,0.041,0.843,0.346,724
taste,0.456,251,2848,1,1,0.802,0.406,0.465,3099
black,0.456,865,9790,1,1,0.326,0.339,0.39,10655
childhood,0.456,204,2317,1,1,0.865,0.413,0.307,2521
razor,0.456,12,146,1,1,0.26,0.61,0.481,158
cathartic,0.455,28,327,1,1,0.45,0.51,0.604,355
homemade,0.455,15,180,1,1,0.869,0.34,0.398,195
grub,0.453,2,33,1,1,0.602,0.406,0.355,35
queasy,0.453,2,33,1,1,0.25,0.587,0.225,35
livelihood,0.453,5,67,1,1,0.698,0.481,0.721,72
manners,0.453,26,305,1,1,0.816,0.284,0.517,331
clause,0.453,5,67,1,1,0.48,0.409,0.528,72
stub,0.453,2,33,1,1,0.396,0.32,0.367,35
peg,0.453,5,67,1,1,0.52,0.357,0.393,72
inkling,0.453,5,67,1,1,0.448,0.551,0.57,72
clearance,0.453,5,67,1,1,0.542,0.459,0.473,72
headset,0.453,8,101,1,1,0.602,0.34,0.302,109
swamped,0.453,2,33,1,1,0.156,0.48,0.27,35
hatchet,0.453,2,33,1,1,0.333,0.608,0.5,35
earnings,0.453,5,67,1,1,0.938,0.65,0.875,72
accelerate,0.453,2,33,1,1,0.615,0.902,0.759,35
transparent,0.453,35,407,1,1,0.542,0.33,0.667,442
slum,0.453,2,33,1,1,0.292,0.528,0.302,35
rubble,0.453,5,67,1,1,0.308,0.509,0.289,72
cranky,0.453,17,203,1,1,0.194,0.776,0.396,220
charlatan,0.453,2,33,1,1,0.2,0.64,0.352,35
secularism,0.453,2,33,1,1,0.367,0.44,0.559,35
evens,0.453,2,33,1,1,0.592,0.43,0.457,35
bulletproof,0.453,2,33,1,1,0.75,0.721,0.779,35
guidance,0.453,102,1167,1,1,0.729,0.471,0.718,1269
fulfill,0.452,51,589,1,1,0.784,0.461,0.577,640
fantastic,0.452,169,1928,1,1,0.969,0.696,0.831,2097
quality,0.452,303,3449,1,1,0.896,0.443,0.852,3752
portray,0.452,16,192,1,1,0.656,0.529,0.457,208
swallow,0.452,67,771,1,1,0.466,0.608,0.436,838
usage,0.451,13,158,1,1,0.646,0.36,0.426,171
goblin,0.451,13,158,1,1,0.333,0.542,0.377,171
title,0.451,127,1453,1,1,0.708,0.356,0.574,1580
moody,0.451,49,567,1,1,0.245,0.811,0.595,616
sentient,0.451,10,124,1,1,0.583,0.417,0.363,134
rev,0.451,10,124,1,1,0.367,0.422,0.353,134
sinful,0.451,10,124,1,1,0.143,0.788,0.417,134
offered,0.45,116,1329,1,1,0.582,0.49,0.544,1445
relocate,0.45,7,90,1,1,0.5,0.594,0.64,97
verdict,0.45,7,90,1,1,0.325,0.689,0.8,97
simulation,0.449,12,147,1,1,0.552,0.574,0.567,159
bowls,0.449,12,147,1,1,0.551,0.28,0.277,159
troubled,0.448,42,489,1,1,0.167,0.627,0.385,531
reunion,0.448,24,284,1,1,0.837,0.5,0.672,308
pluck,0.448,4,56,1,1,0.375,0.583,0.474,60
craze,0.448,4,56,1,1,0.255,0.657,0.435,60
brutality,0.448,9,113,1,1,0.122,0.832,0.571,122
padded,0.448,9,113,1,1,0.606,0.212,0.371,122
learner,0.448,4,56,1,1,0.698,0.475,0.398,60
cardiac,0.448,4,56,1,1,0.344,0.765,0.615,60
scape,0.448,4,56,1,1,0.29,0.625,0.536,60
cognitive,0.448,19,227,1,1,0.513,0.401,0.634,246
circus,0.447,26,307,1,1,0.724,0.637,0.432,333
success,0.446,264,3026,1,1,0.959,0.88,0.981,3290
cola,0.445,6,79,1,1,0.469,0.325,0.24,85
continuation,0.445,6,79,1,1,0.615,0.47,0.566,85
karate,0.445,6,79,1,1,0.562,0.833,0.598,85
trousers,0.445,6,79,1,1,0.625,0.314,0.442,85
dip,0.445,43,502,1,1,0.516,0.583,0.397,545
fatigue,0.445,29,342,1,1,0.173,0.378,0.265,371
handwriting,0.444,8,102,1,1,0.615,0.378,0.381,110
animal,0.444,210,2414,1,1,0.521,0.51,0.513,2624
studio,0.444,165,1899,1,1,0.677,0.265,0.62,2064
pause,0.443,104,1201,1,1,0.429,0.188,0.264,1305
assignment,0.443,30,354,1,1,0.483,0.398,0.745,384
refuel,0.443,10,125,1,1,0.592,0.445,0.5,135
symptom,0.443,21,251,1,1,0.38,0.529,0.434,272
interact,0.443,213,2451,1,1,0.822,0.69,0.759,2664
bright,0.442,226,2601,1,1,0.89,0.527,0.812,2827
unemployment,0.442,14,171,1,1,0.094,0.4,0.297,185
slowly,0.442,493,5664,1,1,0.427,0.185,0.295,6157
continue,0.442,819,9403,1,1,0.63,0.427,0.612,10222
possibility,0.441,105,1215,1,1,0.816,0.481,0.596,1320
champion,0.441,35,412,1,1,0.89,0.88,0.945,447
publishing,0.441,18,217,1,1,0.708,0.615,0.66,235
ounce,0.44,26,309,1,1,0.531,0.255,0.288,335
deteriorate,0.439,5,68,1,1,0.083,0.471,0.202,73
candid,0.439,13,160,1,1,0.667,0.349,0.458,173
shading,0.439,3,45,1,1,0.42,0.324,0.318,48
humanities,0.439,3,45,1,1,0.729,0.325,0.677,48
gear,0.439,35,413,1,1,0.51,0.577,0.509,448
manger,0.439,3,45,1,1,0.656,0.276,0.398,48
suggestive,0.439,3,45,1,1,0.552,0.5,0.555,48
cargo,0.439,3,45,1,1,0.408,0.444,0.455,48
drifter,0.439,3,45,1,1,0.449,0.512,0.391,48
heaving,0.439,5,68,1,1,0.201,0.843,0.491,73
maintenance,0.439,35,413,1,1,0.592,0.41,0.545,448
generator,0.439,5,68,1,1,0.704,0.568,0.864,73
leech,0.439,7,91,1,1,0.25,0.623,0.268,98
tenant,0.439,5,68,1,1,0.385,0.36,0.398,73
commerce,0.439,3,45,1,1,0.646,0.5,0.788,48
disc,0.439,7,91,1,1,0.622,0.41,0.426,98
complication,0.439,3,45,1,1,0.365,0.726,0.33,48
rebuke,0.439,7,91,1,1,0.115,0.677,0.429,98
deflect,0.439,7,91,1,1,0.133,0.491,0.482,98
dust,0.438,114,1322,1,1,0.344,0.246,0.241,1436
existential,0.438,73,851,1,1,0.583,0.51,0.638,924
neutral,0.438,32,379,1,1,0.469,0.184,0.357,411
consideration,0.437,30,356,1,1,0.589,0.38,0.687,386
bitter,0.436,238,2754,1,1,0.218,0.627,0.411,2992
loot,0.436,16,195,1,1,0.604,0.711,0.537,211
banger,0.436,16,195,1,1,0.378,0.54,0.538,211
predictable,0.436,14,172,1,1,0.312,0.296,0.42,186
three,0.436,741,8558,1,1,0.653,0.225,0.377,9299
bundle,0.436,12,149,1,1,0.51,0.343,0.434,161
pacing,0.436,12,149,1,1,0.583,0.551,0.491,161
fire,0.435,484,5596,1,1,0.38,0.804,0.635,6080
validation,0.435,100,1165,1,1,0.655,0.46,0.72,1265
insightful,0.435,19,230,1,1,0.664,0.691,0.713,249
concur,0.434,8,103,1,1,0.459,0.394,0.429,111
tilt,0.434,8,103,1,1,0.365,0.549,0.463,111
speck,0.434,8,103,1,1,0.418,0.245,0.343,111
violently,0.434,17,207,1,1,0.12,0.97,0.527,224
savannah,0.434,8,103,1,1,0.729,0.212,0.309,111
anthem,0.434,42,496,1,1,0.78,0.343,0.729,538
drown,0.433,178,2069,1,1,0.071,0.86,0.27,2247
eyesight,0.433,6,80,1,1,0.75,0.226,0.343,86
fleet,0.433,6,80,1,1,0.547,0.43,0.623,86
bark,0.433,20,242,1,1,0.36,0.602,0.395,262
continent,0.432,18,219,1,1,0.551,0.373,0.833,237
minimize,0.432,11,138,1,1,0.36,0.236,0.311,149
plight,0.432,23,277,1,1,0.45,0.52,0.547,300
shelf,0.432,35,416,1,1,0.561,0.202,0.366,451
cooperation,0.432,11,138,1,1,0.847,0.473,0.686,149
ignorance,0.431,123,1436,1,1,0.153,0.417,0.209,1559
triple,0.431,26,312,1,1,0.585,0.385,0.481,338
tar,0.43,4,57,1,1,0.438,0.44,0.57,61
abruptly,0.43,9,115,1,1,0.25,0.808,0.556,124
reincarnation,0.43,4,57,1,1,0.786,0.747,0.676,61
compliance,0.43,4,57,1,1,0.75,0.462,0.75,61
riddle,0.43,4,57,1,1,0.521,0.583,0.543,61
adhere,0.43,4,57,1,1,0.633,0.339,0.554,61
contributor,0.43,4,57,1,1,0.844,0.51,0.76,61
tablet,0.43,14,173,1,1,0.562,0.33,0.438,187
taxed,0.43,4,57,1,1,0.255,0.456,0.5,61
decoration,0.43,4,57,1,1,0.878,0.553,0.526,61
boiler,0.43,4,57,1,1,0.561,0.59,0.509,61
twitching,0.43,4,57,1,1,0.292,0.7,0.482,61
drought,0.43,9,115,1,1,0.133,0.353,0.267,124
animation,0.429,22,266,1,1,0.888,0.75,0.549,288
looming,0.429,12,150,1,1,0.367,0.75,0.528,162
slow,0.429,307,3577,1,1,0.357,0.073,0.131,3884
basement,0.429,96,1126,1,1,0.388,0.5,0.268,1222
passionate,0.428,74,871,1,1,0.99,0.827,0.731,945
fourth,0.428,42,499,1,1,0.559,0.28,0.398,541
emotion,0.427,168,1966,1,1,0.693,0.873,0.696,2134
mute,0.427,63,744,1,1,0.271,0.2,0.25,807
central,0.427,66,779,1,1,0.64,0.356,0.621,845
inept,0.426,13,162,1,1,0.156,0.418,0.209,175
reunite,0.426,13,162,1,1,0.656,0.55,0.657,175
influential,0.426,13,162,1,1,0.899,0.688,0.944,175
honored,0.426,33,395,1,1,0.938,0.447,0.732,428
gore,0.426,19,232,1,1,0.26,0.608,0.518,251
suite,0.426,19,232,1,1,0.79,0.42,0.4,251
blank,0.426,68,803,1,1,0.531,0.229,0.25,871
recognized,0.426,48,570,1,1,0.875,0.458,0.786,618
demand,0.425,93,1095,1,1,0.292,0.673,0.5,1188
dignity,0.425,64,757,1,1,0.844,0.391,0.873,821
catching,0.425,79,932,1,1,0.49,0.788,0.644,1011
frailty,0.424,2,34,1,1,0.385,0.4,0.218,36
odor,0.424,2,34,1,1,0.337,0.363,0.404,36
transitional,0.424,2,34,1,1,0.573,0.472,0.491,36
throttle,0.424,2,34,1,1,0.562,0.804,0.75,36
logical,0.424,41,489,1,1,0.805,0.4,0.648,530
inadequacy,0.424,8,104,1,1,0.286,0.5,0.297,112
telegraph,0.424,2,34,1,1,0.594,0.423,0.4,36
glorified,0.424,5,69,1,1,0.865,0.57,0.886,74
daylight,0.424,32,384,1,1,0.865,0.42,0.545,416
underwood,0.424,2,34,1,1,0.51,0.453,0.51,36
impure,0.424,2,34,1,1,0.26,0.56,0.208,36
vapor,0.424,2,34,1,1,0.51,0.358,0.318,36
bonding,0.424,26,314,1,1,0.594,0.442,0.509,340
chuckle,0.424,26,314,1,1,0.844,0.736,0.481,340
lagging,0.424,2,34,1,1,0.135,0.538,0.277,36
inverted,0.424,2,34,1,1,0.31,0.471,0.357,36
fuzzy,0.424,20,244,1,1,0.306,0.472,0.158,264
overstate,0.424,2,34,1,1,0.281,0.779,0.635,36
advance,0.424,61,723,1,1,0.673,0.472,0.858,784
punish,0.423,27,326,1,1,0.061,0.808,0.61,353
represent,0.423,80,945,1,1,0.781,0.433,0.861,1025
signal,0.423,46,548,1,1,0.615,0.417,0.464,594
bare,0.423,104,1226,1,1,0.333,0.717,0.296,1330
rise,0.422,220,2583,1,1,0.667,0.593,0.745,2803
regional,0.422,12,151,1,1,0.62,0.4,0.607,163
hour,0.422,722,8453,1,1,0.552,0.265,0.336,9175
frequently,0.422,81,958,1,1,0.596,0.423,0.634,1039
deaf,0.422,45,537,1,1,0.186,0.324,0.161,582
meaningless,0.421,76,900,1,1,0.156,0.314,0.143,976
workout,0.421,61,725,1,1,0.868,0.827,0.78,786
disinterested,0.42,6,81,1,1,0.398,0.284,0.392,87
comet,0.42,6,81,1,1,0.704,0.679,0.471,87
snippet,0.42,6,81,1,1,0.612,0.41,0.368,87
condemnation,0.42,6,81,1,1,0.133,0.725,0.449,87
mutually,0.42,13,163,1,1,0.844,0.49,0.582,176
needed,0.42,1573,18446,1,1,0.677,0.342,0.679,20019
admired,0.42,28,339,1,1,0.917,0.56,0.815,367
protection,0.42,97,1148,1,1,0.863,0.53,0.664,1245
blowing,0.419,68,808,1,1,0.521,0.472,0.434,876
martial,0.419,10,128,1,1,0.48,0.71,0.737,138
angst,0.419,32,386,1,1,0.167,0.888,0.333,418
flawless,0.419,10,128,1,1,0.729,0.42,0.741,138
jewelry,0.419,10,128,1,1,0.823,0.569,0.597,138
blonde,0.418,57,680,1,1,0.698,0.545,0.412,737
positively,0.418,30,363,1,1,0.969,0.645,0.795,393
hissing,0.417,3,46,1,1,0.5,0.454,0.4,49
generalization,0.417,3,46,1,1,0.542,0.459,0.704,49
swelling,0.417,3,46,1,1,0.323,0.608,0.25,49
semi,0.417,27,328,1,1,0.296,0.345,0.304,355
tackled,0.417,3,46,1,1,0.438,0.612,0.569,49
enact,0.417,3,46,1,1,0.68,0.564,0.598,49
warrant,0.417,7,93,1,1,0.653,0.398,0.802,100
standpoint,0.417,7,93,1,1,0.585,0.388,0.652,100
slate,0.417,7,93,1,1,0.531,0.283,0.431,100
warranty,0.417,3,46,1,1,0.667,0.47,0.568,49
pursuing,0.417,31,375,1,1,0.483,0.906,0.69,406
wrapper,0.417,3,46,1,1,0.625,0.358,0.391,49
mesmerized,0.417,7,93,1,1,0.52,0.552,0.421,100
earnestly,0.417,3,46,1,1,0.847,0.49,0.717,49
bluff,0.417,3,46,1,1,0.418,0.286,0.377,49
sneak,0.417,47,563,1,1,0.281,0.745,0.449,610
distasteful,0.417,3,46,1,1,0.264,0.676,0.222,49
tor,0.417,3,46,1,1,0.337,0.43,0.418,49
ballroom,0.417,3,46,1,1,0.847,0.635,0.448,49
ire,0.417,3,46,1,1,0.198,0.74,0.575,49
indestructible,0.417,7,93,1,1,0.772,0.731,0.853,100
studied,0.417,28,340,1,1,0.786,0.306,0.806,368
sheet,0.416,24,293,1,1,0.439,0.174,0.302,317
universal,0.416,58,693,1,1,0.802,0.417,0.833,751
equal,0.416,117,1387,1,1,0.781,0.178,0.407,1504
heartache,0.416,51,611,1,1,0.088,0.75,0.291,662
satisfy,0.416,34,411,1,1,0.867,0.79,0.705,445
famous,0.415,126,1494,1,1,0.916,0.775,0.882,1620
increased,0.415,39,470,1,1,0.684,0.66,0.773,509
combat,0.415,48,576,1,1,0.302,0.846,0.833,624
bachelorette,0.415,8,105,1,1,0.735,0.78,0.465,113
bolt,0.415,8,105,1,1,0.354,0.363,0.426,113
sway,0.414,13,164,1,1,0.69,0.596,0.721,177
deceive,0.414,13,164,1,1,0.094,0.775,0.414,177
rapid,0.414,13,164,1,1,0.667,0.788,0.768,177
grow,0.414,850,10029,1,1,0.914,0.615,0.755,10879
generous,0.414,32,388,1,1,1,0.41,0.81,420
heel,0.413,9,117,1,1,0.48,0.35,0.385,126
negotiation,0.413,4,58,1,1,0.49,0.615,0.728,62
knuckle,0.413,4,58,1,1,0.655,0.333,0.393,62
hypothesis,0.413,4,58,1,1,0.552,0.37,0.509,62
taint,0.413,4,58,1,1,0.141,0.425,0.226,62
darkside,0.413,4,58,1,1,0.102,0.69,0.365,62
dismissal,0.413,4,58,1,1,0.153,0.723,0.271,62
depravity,0.413,4,58,1,1,0.115,0.854,0.453,62
debatable,0.413,4,58,1,1,0.181,0.61,0.474,62
admiral,0.413,4,58,1,1,0.844,0.49,0.847,62
decorating,0.413,14,176,1,1,0.863,0.548,0.462,190
hyper,0.413,29,353,1,1,0.542,0.616,0.64,382
six,0.412,166,1971,1,1,0.5,0.154,0.271,2137
trait,0.412,62,743,1,1,0.469,0.365,0.453,805
arc,0.412,31,377,1,1,0.552,0.388,0.396,408
industrial,0.412,10,129,1,1,0.469,0.6,0.875,139
secular,0.412,10,129,1,1,0.463,0.461,0.52,139
graphics,0.412,10,129,1,1,0.542,0.431,0.509,139
ripe,0.41,11,141,1,1,0.671,0.337,0.67,152
stationary,0.41,5,70,1,1,0.408,0.24,0.484,75
cameo,0.41,5,70,1,1,0.573,0.457,0.509,75
tang,0.41,5,70,1,1,0.594,0.383,0.34,75
fiber,0.41,11,141,1,1,0.719,0.284,0.39,152
icky,0.41,5,70,1,1,0.357,0.51,0.342,75
tad,0.41,23,283,1,1,0.459,0.24,0.25,306
cuss,0.41,11,141,1,1,0.354,0.538,0.443,152
ambiguous,0.41,5,70,1,1,0.265,0.462,0.358,75
slutty,0.41,5,70,1,1,0.224,0.81,0.371,75
blunt,0.41,68,816,1,1,0.551,0.68,0.925,884
surprising,0.409,44,532,1,1,0.888,0.79,0.692,576
large,0.409,250,2972,1,1,0.704,0.565,0.736,3222
canon,0.409,25,307,1,1,0.385,0.519,0.541,332
certain,0.409,642,7619,1,1,0.76,0.358,0.673,8261
music,0.409,2454,29100,1,1,0.833,0.563,0.605,31554
break,0.408,1488,17651,1,1,0.61,0.265,0.37,19139
varsity,0.408,6,82,1,1,0.71,0.594,0.67,88
frowning,0.408,6,82,1,1,0.194,0.582,0.5,88
misinformed,0.408,6,82,1,1,0.156,0.567,0.25,88
calculate,0.408,6,82,1,1,0.49,0.452,0.44,88
critic,0.407,14,177,1,1,0.264,0.604,0.686,191
medicate,0.407,7,94,1,1,0.417,0.375,0.546,101
cheerful,0.407,31,379,1,1,0.99,0.72,0.696,410
reception,0.407,15,189,1,1,0.694,0.375,0.567,204
hump,0.407,7,94,1,1,0.296,0.462,0.25,101
fabulous,0.407,48,581,1,1,0.979,0.66,0.797,629
exist,0.406,471,5606,1,1,0.857,0.421,0.788,6077
wrap,0.406,100,1199,1,1,0.594,0.441,0.275,1299
benefit,0.406,144,1722,1,1,0.906,0.422,0.806,1866
mistaken,0.406,42,510,1,1,0.131,0.63,0.212,552
five,0.406,285,3398,1,1,0.51,0.221,0.298,3683
lesser,0.406,26,320,1,1,0.396,0.167,0.211,346
uphold,0.406,17,213,1,1,0.698,0.321,0.561,230
stack,0.405,27,332,1,1,0.47,0.282,0.427,359
distress,0.405,48,582,1,1,0.073,0.84,0.396,630
cross,0.405,182,2177,1,1,0.448,0.321,0.569,2359
teach,0.404,332,3964,1,1,0.84,0.51,0.852,4296
discarded,0.404,10,130,1,1,0.229,0.46,0.308,140
knuckles,0.404,10,130,1,1,0.271,0.461,0.32,140
sitting,0.403,915,10913,1,1,0.561,0.146,0.353,11828
objective,0.403,23,285,1,1,0.724,0.337,0.736,308
medicine,0.403,110,1322,1,1,0.708,0.318,0.679,1432
introduce,0.403,37,452,1,1,0.592,0.559,0.648,489
declining,0.403,12,154,1,1,0.328,0.4,0.264,166
district,0.403,39,476,1,1,0.438,0.327,0.66,515
ash,0.402,81,977,1,1,0.26,0.21,0.207,1058
combo,0.402,41,500,1,1,0.698,0.439,0.453,541
deranged,0.402,13,166,1,1,0.376,0.868,0.357,179
glue,0.402,14,178,1,1,0.45,0.345,0.349,192
jaded,0.402,15,190,1,1,0.255,0.56,0.4,205
memories,0.401,514,6147,1,1,0.963,0.487,0.51,6661
punk,0.401,33,405,1,1,0.429,0.63,0.358,438
clear,0.401,573,6855,1,1,0.857,0.327,0.573,7428
niche,0.401,18,226,1,1,0.459,0.413,0.318,244
experience,0.4,1437,17185,1,1,0.827,0.618,0.905,18622
hesitation,0.4,20,250,1,1,0.286,0.396,0.217,270
ditto,0.399,27,334,1,1,0.449,0.418,0.411,361
choice,0.399,805,9644,1,1,0.745,0.52,0.664,10449
access,0.399,161,1938,1,1,0.714,0.472,0.567,2099
consume,0.399,64,777,1,1,0.427,0.62,0.509,841
recording,0.398,56,682,1,1,0.573,0.537,0.474,738
window,0.397,238,2866,1,1,0.542,0.276,0.385,3104
heal,0.397,489,5877,1,1,0.765,0.245,0.556,6366
disagreement,0.396,8,107,1,1,0.104,0.618,0.236,115
bitty,0.396,2,35,1,1,0.469,0.271,0.257,37
petulant,0.396,5,71,1,1,0.247,0.685,0.491,76
regretted,0.396,15,191,1,1,0.352,0.54,0.368,206
rig,0.396,4,59,1,1,0.542,0.382,0.746,63
claustrophobia,0.396,4,59,1,1,0.125,0.84,0.333,63
reptile,0.396,2,35,1,1,0.35,0.566,0.365,37
reservation,0.396,8,107,1,1,0.688,0.343,0.561,115
sprint,0.396,9,119,1,1,0.549,0.649,0.528,128
huddle,0.396,3,47,1,1,0.604,0.509,0.445,50
haggard,0.396,2,35,1,1,0.115,0.51,0.246,37
rewrite,0.396,11,143,1,1,0.49,0.5,0.434,154
sausage,0.396,9,119,1,1,0.542,0.429,0.3,128
startling,0.396,3,47,1,1,0.75,0.768,0.83,50
conceited,0.396,4,59,1,1,0.194,0.667,0.473,63
scoff,0.396,4,59,1,1,0.125,0.686,0.306,63
claw,0.396,11,143,1,1,0.26,0.6,0.598,154
replicate,0.396,3,47,1,1,0.48,0.63,0.585,50
tome,0.396,4,59,1,1,0.429,0.316,0.492,63
actuality,0.396,10,131,1,1,0.75,0.464,0.6,141
skater,0.396,2,35,1,1,0.633,0.774,0.652,37
splinter,0.396,2,35,1,1,0.136,0.422,0.325,37
overbearing,0.396,8,107,1,1,0.323,0.833,0.861,115
compilation,0.396,9,119,1,1,0.53,0.512,0.606,128
jelly,0.396,17,215,1,1,0.651,0.294,0.256,232
unbreakable,0.396,10,131,1,1,0.653,0.573,0.759,141
cot,0.396,3,47,1,1,0.625,0.23,0.278,50
shattering,0.396,11,143,1,1,0.135,0.76,0.475,154
rationale,0.396,4,59,1,1,0.656,0.4,0.815,63
snoop,0.396,3,47,1,1,0.134,0.74,0.434,50
mask,0.396,119,1439,1,1,0.51,0.49,0.537,1558
tact,0.396,3,47,1,1,0.55,0.417,0.417,50
lottery,0.396,19,239,1,1,0.771,0.731,0.491,258
outspoken,0.396,11,143,1,1,0.582,0.413,0.667,154
yucky,0.396,2,35,1,1,0.142,0.806,0.237,37
hanger,0.396,3,47,1,1,0.439,0.462,0.461,50
instability,0.396,7,95,1,1,0.177,0.76,0.353,102
garrison,0.396,2,35,1,1,0.51,0.527,0.679,37
duckling,0.396,2,35,1,1,0.602,0.353,0.263,37
unclean,0.396,4,59,1,1,0.133,0.529,0.134,63
stead,0.396,2,35,1,1,0.551,0.214,0.51,37
dogged,0.396,2,35,1,1,0.255,0.75,0.594,37
bohemian,0.396,11,143,1,1,0.622,0.5,0.407,154
vitamin,0.396,11,143,1,1,0.827,0.33,0.56,154
stash,0.396,6,83,1,1,0.344,0.63,0.361,89
impart,0.396,2,35,1,1,0.521,0.441,0.694,37
shortage,0.396,10,131,1,1,0.094,0.455,0.198,141
barrage,0.396,4,59,1,1,0.388,0.871,0.627,63
tobacco,0.396,5,71,1,1,0.327,0.546,0.387,76
calculus,0.396,4,59,1,1,0.36,0.36,0.562,63
regular,0.396,165,1991,1,1,0.435,0.188,0.558,2156
federation,0.396,3,47,1,1,0.633,0.354,0.763,50
waver,0.396,4,59,1,1,0.426,0.63,0.255,63
deficiency,0.396,3,47,1,1,0.073,0.373,0.179,50
fully,0.396,406,4885,1,1,0.763,0.45,0.779,5291
gym,0.394,257,3101,1,1,0.635,0.69,0.613,3358
toe,0.394,34,420,1,1,0.406,0.221,0.293,454
hatred,0.394,168,2032,1,1,0.037,0.847,0.424,2200
reference,0.394,62,757,1,1,0.633,0.312,0.595,819
resign,0.393,51,625,1,1,0.25,0.543,0.273,676
pumpkin,0.393,24,300,1,1,0.539,0.177,0.355,324
explanation,0.393,69,842,1,1,0.615,0.61,0.825,911
cynical,0.393,22,276,1,1,0.156,0.76,0.474,298
suffocating,0.392,54,662,1,1,0.133,0.774,0.429,716
aim,0.392,52,638,1,1,0.481,0.569,0.567,690
gap,0.391,50,614,1,1,0.396,0.451,0.357,664
precious,0.391,315,3811,1,1,0.917,0.5,0.726,4126
photograph,0.391,30,373,1,1,0.677,0.353,0.358,403
insufferable,0.391,14,180,1,1,0.22,0.784,0.291,194
carried,0.391,71,868,1,1,0.49,0.382,0.534,939
warm,0.39,432,5226,1,1,0.76,0.312,0.585,5658
sept,0.39,24,301,1,1,0.521,0.333,0.361,325
leaned,0.389,23,289,1,1,0.57,0.373,0.49,312
reasoning,0.389,34,422,1,1,0.729,0.365,0.729,456
finish,0.389,311,3770,1,1,0.471,0.429,0.545,4081
busy,0.389,715,8653,1,1,0.402,0.5,0.474,9368
giddy,0.389,10,132,1,1,0.438,0.847,0.611,142
praise,0.389,106,1293,1,1,0.776,0.387,0.658,1399
phenomenal,0.388,20,253,1,1,0.915,0.75,0.918,273
slight,0.388,51,628,1,1,0.521,0.24,0.155,679
magnet,0.388,9,120,1,1,0.571,0.318,0.553,129
prophecy,0.388,9,120,1,1,0.747,0.692,0.75,129
illuminate,0.388,28,350,1,1,0.905,0.646,0.782,378
analysis,0.387,36,447,1,1,0.729,0.448,0.705,483
unstoppable,0.387,17,217,1,1,0.625,0.887,0.862,234
woody,0.387,8,108,1,1,0.469,0.26,0.396,116
genuine,0.387,222,2700,1,1,0.875,0.45,0.685,2922
awe,0.387,68,835,1,1,0.469,0.74,0.3,903
limelight,0.386,7,96,1,1,0.667,0.639,0.694,103
diminished,0.386,7,96,1,1,0.156,0.269,0.196,103
iceberg,0.386,7,96,1,1,0.344,0.54,0.648,103
activate,0.386,7,96,1,1,0.764,0.65,0.806,103
star,0.386,318,3868,1,1,0.833,0.418,0.56,4186
trading,0.386,30,375,1,1,0.635,0.602,0.705,405
slip,0.386,76,933,1,1,0.316,0.714,0.321,1009
draft,0.385,44,545,1,1,0.438,0.36,0.351,589
misunderstand,0.385,14,181,1,1,0.177,0.548,0.382,195
exclude,0.385,14,181,1,1,0.292,0.5,0.53,195
purpose,0.385,412,5012,1,1,0.8,0.534,0.782,5424
sort,0.385,418,5086,1,1,0.673,0.389,0.674,5504
intolerant,0.384,13,169,1,1,0.135,0.676,0.509,182
proper,0.384,153,1869,1,1,0.796,0.312,0.757,2022
profitable,0.384,6,84,1,1,0.87,0.392,0.736,90
fanatic,0.384,6,84,1,1,0.573,0.78,0.629,90
cursed,0.384,82,1007,1,1,0.083,0.783,0.393,1089
jam,0.384,75,922,1,1,0.51,0.548,0.318,997
urgent,0.384,25,315,1,1,0.327,0.918,0.623,340
occurrence,0.384,12,157,1,1,0.573,0.69,0.541,169
four,0.383,283,3451,1,1,0.552,0.28,0.383,3734
storm,0.383,320,3901,1,1,0.188,0.94,0.543,4221
remove,0.383,118,1446,1,1,0.292,0.539,0.472,1564
championship,0.382,17,218,1,1,0.833,0.8,0.88,235
mayday,0.382,5,72,1,1,0.344,0.643,0.423,77
terror,0.381,60,742,1,1,0.069,0.902,0.415,802
audio,0.381,43,535,1,1,0.709,0.425,0.37,578
demonic,0.381,15,194,1,1,0.146,0.875,0.6,209
worm,0.381,15,194,1,1,0.13,0.418,0.219,209
curious,0.38,134,1645,1,1,0.635,0.6,0.483,1779
thin,0.38,90,1109,1,1,0.469,0.337,0.356,1199
counsel,0.38,19,243,1,1,0.594,0.519,0.73,262
abolish,0.38,4,60,1,1,0.448,0.615,0.529,64
freestyle,0.38,4,60,1,1,0.765,0.652,0.52,64
agnostic,0.38,4,60,1,1,0.306,0.396,0.574,64
fabric,0.38,14,182,1,1,0.635,0.19,0.345,196
property,0.379,63,780,1,1,0.74,0.221,0.805,843
confession,0.379,43,536,1,1,0.469,0.642,0.46,579
blue,0.379,484,5919,1,1,0.646,0.137,0.291,6403
union,0.379,71,878,1,1,0.854,0.226,0.766,949
simple,0.379,500,6118,1,1,0.653,0.13,0.314,6618
ranking,0.379,13,170,1,1,0.54,0.592,0.68,183
troublesome,0.378,8,109,1,1,0.283,0.894,0.404,117
respectable,0.378,8,109,1,1,0.85,0.35,0.889,117
diverse,0.378,26,329,1,1,0.562,0.519,0.604,355
asset,0.378,17,219,1,1,0.797,0.765,0.788,236
thorough,0.378,8,109,1,1,0.467,0.35,0.558,117
rescue,0.377,78,965,1,1,0.806,0.926,0.85,1043
letter,0.377,135,1662,1,1,0.635,0.279,0.342,1797
reverse,0.377,34,427,1,1,0.539,0.415,0.461,461
responsibility,0.377,156,1919,1,1,0.76,0.5,0.852,2075
psychiatric,0.377,12,158,1,1,0.21,0.616,0.525,170
league,0.377,116,1430,1,1,0.656,0.34,0.462,1546
entry,0.377,38,476,1,1,0.552,0.353,0.602,514
sideways,0.377,12,158,1,1,0.788,0.245,0.291,170
dinosaur,0.377,12,158,1,1,0.448,0.63,0.596,170
differences,0.377,42,525,1,1,0.365,0.582,0.342,567
halfway,0.377,50,623,1,1,0.51,0.254,0.339,673
commission,0.377,16,207,1,1,0.677,0.48,0.571,223
danger,0.376,128,1579,1,1,0.115,0.923,0.673,1707
menstrual,0.376,3,48,1,1,0.408,0.519,0.435,51
rapids,0.376,3,48,1,1,0.573,0.817,0.788,51
dearest,0.376,43,538,1,1,0.902,0.427,0.508,581
distribute,0.376,3,48,1,1,0.643,0.596,0.709,51
hallucination,0.376,3,48,1,1,0.396,0.706,0.37,51
nightclub,0.376,3,48,1,1,0.802,0.894,0.528,51
assign,0.376,3,48,1,1,0.622,0.417,0.709,51
dancer,0.376,19,244,1,1,0.74,0.768,0.545,263
customary,0.376,3,48,1,1,0.7,0.253,0.561,51
plaid,0.376,3,48,1,1,0.48,0.33,0.417,51
handmade,0.376,3,48,1,1,0.776,0.383,0.475,51
motto,0.376,23,293,1,1,0.688,0.317,0.439,316
birdie,0.376,3,48,1,1,0.594,0.394,0.407,51
geeky,0.376,3,48,1,1,0.479,0.431,0.454,51
fad,0.376,3,48,1,1,0.663,0.52,0.57,51
computer,0.375,114,1408,1,1,0.802,0.356,0.639,1522
unnecessary,0.375,80,992,1,1,0.219,0.358,0.19,1072
endeavor,0.375,22,281,1,1,0.677,0.755,0.765,303
agency,0.374,33,416,1,1,0.46,0.296,0.583,449
iconic,0.374,33,416,1,1,0.583,0.537,0.7,449
hulk,0.374,14,183,1,1,0.46,0.74,0.75,197
weather,0.374,306,3766,1,1,0.755,0.404,0.567,4072
excite,0.374,10,134,1,1,0.823,0.95,0.668,144
tragedies,0.374,10,134,1,1,0.1,0.91,0.442,144
appropriate,0.374,57,711,1,1,0.833,0.368,0.759,768
implore,0.373,6,85,1,1,0.396,0.65,0.377,91
seller,0.373,6,85,1,1,0.635,0.471,0.635,91
dissatisfied,0.373,6,85,1,1,0.042,0.561,0.291,91
scientist,0.372,23,294,1,1,0.562,0.5,0.79,317
hale,0.372,9,122,1,1,0.479,0.435,0.5,131
set,0.371,732,9019,1,1,0.521,0.482,0.63,9751
euphoria,0.371,28,356,1,1,0.769,0.955,0.648,384
exit,0.371,47,590,1,1,0.37,0.353,0.399,637
circumstance,0.37,37,467,1,1,0.52,0.565,0.596,504
lullaby,0.37,18,233,1,1,0.796,0.156,0.339,251
lovely,0.37,491,6060,1,1,0.917,0.456,0.741,6551
weapon,0.369,51,640,1,1,0.054,0.84,0.831,691
blacklist,0.369,2,36,1,1,0.133,0.75,0.396,38
layover,0.369,2,36,1,1,0.52,0.355,0.5,38
offshore,0.369,2,36,1,1,0.417,0.484,0.441,38
billing,0.369,2,36,1,1,0.406,0.481,0.67,38
indecent,0.369,2,36,1,1,0.083,0.683,0.24,38
chancellor,0.369,2,36,1,1,0.646,0.5,0.887,38
groupie,0.369,2,36,1,1,0.521,0.583,0.393,38
cranberry,0.369,2,36,1,1,0.793,0.33,0.363,38
omega,0.369,14,184,1,1,0.529,0.337,0.526,198
contentious,0.369,2,36,1,1,0.422,0.573,0.637,38
beige,0.369,2,36,1,1,0.49,0.222,0.224,38
cemented,0.369,2,36,1,1,0.429,0.382,0.537,38
agressive,0.369,2,36,1,1,0.083,0.918,0.751,38
qualifying,0.369,2,36,1,1,0.788,0.577,0.789,38
cram,0.369,2,36,1,1,0.354,0.73,0.598,38
broker,0.369,2,36,1,1,0.582,0.462,0.6,38
achy,0.369,2,36,1,1,0.167,0.84,0.373,38
rationality,0.369,2,36,1,1,0.633,0.51,0.767,38
console,0.369,41,517,1,1,0.625,0.398,0.415,558
pool,0.369,103,1282,1,1,0.625,0.356,0.598,1385
resume,0.368,19,246,1,1,0.573,0.411,0.586,265
pink,0.366,91,1137,1,1,0.806,0.269,0.471,1228
unnoticed,0.366,26,333,1,1,0.302,0.44,0.26,359
increase,0.366,74,927,1,1,0.81,0.657,0.886,1001
lucid,0.366,7,98,1,1,0.771,0.49,0.705,105
harden,0.366,7,98,1,1,0.276,0.598,0.677,105
spirited,0.366,7,98,1,1,0.854,0.587,0.734,105
coop,0.366,7,98,1,1,0.612,0.445,0.65,105
uninvited,0.366,7,98,1,1,0.09,0.385,0.307,105
doctrine,0.366,7,98,1,1,0.5,0.394,0.769,105
resolved,0.364,22,284,1,1,0.735,0.357,0.683,306
resolution,0.364,42,532,1,1,0.78,0.55,0.745,574
breath,0.364,379,4710,1,1,0.684,0.392,0.451,5089
scolding,0.363,4,61,1,1,0.071,0.833,0.417,65
feat,0.363,44,557,1,1,0.75,0.706,0.849,601
inject,0.363,4,61,1,1,0.406,0.735,0.596,65
mint,0.363,14,185,1,1,0.688,0.221,0.345,199
protocol,0.363,9,123,1,1,0.178,0.5,0.786,132
tariff,0.363,4,61,1,1,0.459,0.402,0.491,65
onion,0.363,14,185,1,1,0.378,0.367,0.382,199
area,0.363,323,4017,1,1,0.49,0.306,0.464,4340
granted,0.363,142,1773,1,1,0.882,0.348,0.779,1915
train,0.363,292,3635,1,1,0.666,0.705,0.62,3927
powerful,0.363,395,4914,1,1,0.865,0.83,0.991,5309
entertaining,0.363,67,843,1,1,0.833,0.658,0.66,910
native,0.362,47,595,1,1,0.635,0.422,0.71,642
jean,0.362,47,595,1,1,0.602,0.444,0.364,642
seating,0.362,11,148,1,1,0.552,0.265,0.286,159
sweep,0.361,13,173,1,1,0.448,0.385,0.383,186
baseless,0.361,6,86,1,1,0.292,0.382,0.375,92
hellhole,0.361,6,86,1,1,0.2,0.615,0.421,92
boner,0.361,6,86,1,1,0.344,0.612,0.393,92
lunch,0.361,342,4263,1,1,0.88,0.41,0.542,4605
heat,0.361,119,1491,1,1,0.534,0.612,0.433,1610
harsh,0.361,84,1056,1,1,0.25,0.65,0.623,1140
marathon,0.361,38,484,1,1,0.646,0.778,0.74,522
restart,0.36,15,198,1,1,0.531,0.519,0.554,213
conduct,0.36,17,223,1,1,0.453,0.51,0.75,240
banner,0.36,17,223,1,1,0.521,0.408,0.474,240
touch,0.36,565,7044,1,1,0.646,0.477,0.455,7609
clothing,0.359,41,522,1,1,0.75,0.343,0.407,563
offspring,0.359,10,136,1,1,0.656,0.435,0.6,146
balloon,0.359,10,136,1,1,0.729,0.245,0.315,146
cooler,0.359,23,298,1,1,0.664,0.375,0.46,321
version,0.359,257,3214,1,1,0.604,0.423,0.538,3471
cent,0.359,12,161,1,1,0.439,0.367,0.402,173
offer,0.359,376,4697,1,1,0.75,0.745,0.596,5073
race,0.358,202,2529,1,1,0.592,0.426,0.658,2731
smashed,0.358,14,186,1,1,0.143,0.66,0.256,200
transport,0.358,33,423,1,1,0.613,0.627,0.605,456
steps,0.357,188,2357,1,1,0.511,0.349,0.373,2545
difference,0.356,712,8911,1,1,0.474,0.56,0.483,9623
erotica,0.355,1,24,1,1,0.781,0.87,0.579,25
organized,0.355,33,424,1,1,0.816,0.337,0.746,457
handout,0.355,1,24,1,1,0.56,0.33,0.545,25
modified,0.355,3,49,1,1,0.561,0.458,0.693,52
subjugation,0.355,1,24,1,1,0.28,0.61,0.377,25
aboriginal,0.355,1,24,1,1,0.448,0.427,0.542,25
revise,0.355,5,74,1,1,0.5,0.469,0.509,79
detest,0.355,13,174,1,1,0.083,0.8,0.492,187
gazillion,0.355,1,24,1,1,0.531,0.534,0.538,25
picker,0.355,1,24,1,1,0.534,0.34,0.609,25
demolished,0.355,3,49,1,1,0.271,0.647,0.353,52
arsehole,0.355,5,74,1,1,0.276,0.598,0.433,79
skid,0.355,1,24,1,1,0.357,0.64,0.44,25
inflatable,0.355,1,24,1,1,0.51,0.51,0.4,25
troublemaker,0.355,1,24,1,1,0.26,0.9,0.596,25
raptor,0.355,1,24,1,1,0.27,0.773,0.612,25
mania,0.355,11,149,1,1,0.29,0.683,0.382,160
complexion,0.355,1,24,1,1,0.521,0.52,0.38,25
consistent,0.355,61,774,1,1,0.786,0.431,0.726,835
tremendous,0.355,29,374,1,1,0.6,0.888,0.773,403
berth,0.355,1,24,1,1,0.295,0.337,0.596,25
diarrhea,0.355,7,99,1,1,0.092,0.684,0.143,106
innings,0.355,1,24,1,1,0.573,0.487,0.443,25
swivel,0.355,1,24,1,1,0.562,0.48,0.5,25
quake,0.355,3,49,1,1,0.11,0.824,0.672,52
emu,0.355,1,24,1,1,0.42,0.358,0.33,25
heretic,0.355,1,24,1,1,0.09,0.71,0.447,25
concede,0.355,5,74,1,1,0.67,0.324,0.473,79
patronage,0.355,1,24,1,1,0.583,0.49,0.583,25
classify,0.355,3,49,1,1,0.646,0.411,0.72,52
accountant,0.355,3,49,1,1,0.625,0.45,0.639,52
culpability,0.355,1,24,1,1,0.112,0.745,0.368,25
barbarism,0.355,1,24,1,1,0.19,0.815,0.614,25
gammon,0.355,1,24,1,1,0.51,0.418,0.442,25
lithium,0.355,1,24,1,1,0.417,0.33,0.43,25
discard,0.355,5,74,1,1,0.24,0.343,0.337,79
spaceship,0.355,7,99,1,1,0.643,0.781,0.664,106
infer,0.355,1,24,1,1,0.449,0.49,0.453,25
epileptic,0.355,1,24,1,1,0.146,0.794,0.34,25
homily,0.355,1,24,1,1,0.621,0.358,0.425,25
relay,0.355,9,124,1,1,0.738,0.542,0.543,133
wide,0.355,155,1949,1,1,0.571,0.312,0.472,2104
birthright,0.355,3,49,1,1,0.684,0.417,0.714,52
mange,0.355,1,24,1,1,0.311,0.558,0.348,25
foreclosure,0.355,1,24,1,1,0.167,0.651,0.5,25
typically,0.355,47,599,1,1,0.569,0.377,0.559,646
misspell,0.355,1,24,1,1,0.292,0.423,0.281,25
kimono,0.355,1,24,1,1,0.643,0.28,0.363,25
pasty,0.355,1,24,1,1,0.479,0.363,0.375,25
species,0.355,68,862,1,1,0.561,0.33,0.645,930
whatsoever,0.355,64,812,1,1,0.4,0.314,0.302,876
greet,0.355,44,562,1,1,0.885,0.539,0.618,606
critical,0.354,77,975,1,1,0.312,0.802,0.545,1052
turning,0.354,265,3328,1,1,0.51,0.684,0.42,3593
caption,0.354,22,287,1,1,0.814,0.292,0.379,309
details,0.354,102,1289,1,1,0.583,0.367,0.481,1391
grind,0.353,67,851,1,1,0.48,0.276,0.397,918
settled,0.353,61,776,1,1,0.521,0.51,0.473,837
falling,0.353,506,6353,1,1,0.202,0.716,0.306,6859
strict,0.353,27,350,1,1,0.5,0.646,0.878,377
pride,0.353,305,3835,1,1,0.729,0.634,0.848,4140
dim,0.352,47,601,1,1,0.398,0.321,0.273,648
disappear,0.352,228,2872,1,1,0.143,0.441,0.35,3100
labor,0.351,51,652,1,1,0.594,0.639,0.754,703
aggressively,0.35,15,200,1,1,0.25,0.926,0.688,215
smelling,0.35,20,263,1,1,0.458,0.481,0.349,283
suggest,0.349,125,1584,1,1,0.573,0.471,0.517,1709
cocky,0.349,11,150,1,1,0.26,0.784,0.519,161
convenience,0.349,35,452,1,1,0.781,0.448,0.613,487
descriptive,0.347,4,62,1,1,0.667,0.352,0.57,66
owing,0.347,4,62,1,1,0.396,0.307,0.381,66
decreased,0.347,4,62,1,1,0.224,0.271,0.17,66
sample,0.347,14,188,1,1,0.521,0.187,0.452,202
shuttle,0.347,4,62,1,1,0.531,0.591,0.547,66
typhoon,0.347,4,62,1,1,0.323,0.796,0.697,66
bender,0.347,4,62,1,1,0.49,0.51,0.466,66
inquiry,0.347,9,125,1,1,0.541,0.42,0.536,134
imaginary,0.347,49,629,1,1,0.56,0.424,0.31,678
vodka,0.347,29,377,1,1,0.51,0.632,0.491,406
inspiration,0.347,225,2847,1,1,0.938,0.6,0.779,3072
comprehend,0.347,47,604,1,1,0.875,0.365,0.689,651
hunter,0.347,50,642,1,1,0.292,0.817,0.817,692
pound,0.347,22,289,1,1,0.57,0.337,0.443,311
solution,0.347,200,2534,1,1,0.79,0.339,0.664,2734
chocolate,0.346,157,1993,1,1,0.885,0.48,0.418,2150
behavioral,0.346,7,100,1,1,0.612,0.44,0.708,107
subjected,0.346,15,201,1,1,0.286,0.52,0.221,216
willingly,0.345,34,441,1,1,0.833,0.316,0.588,475
resilient,0.345,26,340,1,1,0.542,0.54,0.801,366
mission,0.345,156,1982,1,1,0.765,0.633,0.87,2138
affectionate,0.345,21,277,1,1,0.949,0.422,0.55,298
enlighten,0.345,10,138,1,1,0.729,0.549,0.667,148
feature,0.345,43,555,1,1,0.667,0.314,0.679,598
vanilla,0.344,24,315,1,1,0.706,0.216,0.284,339
flood,0.344,27,353,1,1,0.208,0.778,0.608,380
attach,0.344,19,252,1,1,0.52,0.363,0.559,271
competitive,0.343,22,290,1,1,0.447,0.718,0.908,312
pad,0.343,22,290,1,1,0.684,0.279,0.33,312
code,0.343,92,1176,1,1,0.583,0.308,0.491,1268
bucket,0.343,31,404,1,1,0.408,0.167,0.336,435
rolling,0.343,93,1189,1,1,0.51,0.606,0.321,1282
ailing,0.342,2,37,1,1,0.094,0.518,0.153,39
canary,0.342,2,37,1,1,0.582,0.276,0.265,39
dropout,0.342,2,37,1,1,0.253,0.55,0.481,39
earpiece,0.342,2,37,1,1,0.583,0.286,0.452,39
especial,0.342,2,37,1,1,0.827,0.419,0.794,39
mooch,0.342,2,37,1,1,0.378,0.413,0.309,39
forgetful,0.342,5,75,1,1,0.24,0.343,0.264,80
dispenser,0.342,2,37,1,1,0.583,0.392,0.47,39
madhouse,0.342,2,37,1,1,0.156,0.736,0.44,39
tint,0.342,2,37,1,1,0.582,0.292,0.273,39
mast,0.342,2,37,1,1,0.542,0.39,0.58,39
cryptic,0.342,5,75,1,1,0.296,0.516,0.474,80
jumper,0.342,5,75,1,1,0.615,0.336,0.481,80
dismissive,0.342,8,113,1,1,0.188,0.541,0.43,121
pita,0.342,2,37,1,1,0.551,0.279,0.255,39
undying,0.342,8,113,1,1,0.708,0.5,0.773,121
fraternity,0.342,5,75,1,1,0.892,0.536,0.679,80
misbehave,0.342,2,37,1,1,0.02,0.847,0.304,39
tack,0.342,2,37,1,1,0.365,0.431,0.431,39
unexplainable,0.342,11,151,1,1,0.26,0.448,0.61,162
demanding,0.342,38,493,1,1,0.396,0.75,0.828,531
manufacture,0.342,2,37,1,1,0.868,0.703,0.78,39
informal,0.342,5,75,1,1,0.48,0.398,0.441,80
coincide,0.342,2,37,1,1,0.635,0.49,0.593,39
positioning,0.342,2,37,1,1,0.615,0.49,0.795,39
motherfucking,0.342,11,151,1,1,0.071,0.823,0.373,162
orbiting,0.342,2,37,1,1,0.52,0.643,0.554,39
different,0.342,1994,25279,1,1,0.612,0.394,0.473,27273
phrase,0.342,63,810,1,1,0.63,0.264,0.314,873
blessed,0.341,389,4945,1,1,0.91,0.279,0.696,5334
method,0.341,37,481,1,1,0.64,0.275,0.698,518
ruling,0.341,15,202,1,1,0.177,0.566,0.41,217
backwards,0.341,47,608,1,1,0.302,0.372,0.33,655
curl,0.34,42,545,1,1,0.385,0.452,0.351,587
correlation,0.34,9,126,1,1,0.596,0.462,0.571,135
persona,0.34,39,507,1,1,0.741,0.48,0.743,546
bat,0.339,53,685,1,1,0.324,0.409,0.48,738
conclude,0.339,16,215,1,1,0.53,0.267,0.679,231
literal,0.339,71,914,1,1,0.57,0.353,0.574,985
steak,0.339,23,304,1,1,0.625,0.359,0.315,327
card,0.339,165,2109,1,1,0.531,0.269,0.436,2274
battlefield,0.338,20,266,1,1,0.133,0.918,0.781,286
damages,0.338,6,88,1,1,0.082,0.76,0.31,94
unsettled,0.338,6,88,1,1,0.208,0.647,0.17,94
brick,0.338,27,355,1,1,0.217,0.418,0.368,382
petrol,0.338,6,88,1,1,0.418,0.519,0.577,94
rope,0.338,27,355,1,1,0.385,0.28,0.345,382
stolen,0.338,53,686,1,1,0.156,0.646,0.308,739
analogy,0.337,10,139,1,1,0.51,0.367,0.509,149
imaginable,0.337,10,139,1,1,0.613,0.529,0.596,149
poker,0.337,10,139,1,1,0.48,0.689,0.398,149
risk,0.337,260,3321,1,1,0.24,0.816,0.438,3581
squad,0.337,111,1425,1,1,0.552,0.711,0.806,1536
demo,0.337,14,190,1,1,0.51,0.314,0.423,204
mend,0.336,26,343,1,1,0.542,0.436,0.602,369
larger,0.336,46,598,1,1,0.729,0.654,0.763,644
breakfast,0.336,156,2000,1,1,0.885,0.33,0.429,2156
tend,0.336,362,4627,1,1,0.604,0.398,0.412,4989
elimination,0.336,3,50,1,1,0.052,0.667,0.431,53
confetti,0.336,3,50,1,1,0.781,0.573,0.25,53
restriction,0.336,3,50,1,1,0.13,0.59,0.569,53
stair,0.336,3,50,1,1,0.375,0.354,0.345,53
permit,0.336,11,152,1,1,0.733,0.349,0.518,163
hem,0.336,3,50,1,1,0.562,0.283,0.291,53
hypothetical,0.336,7,101,1,1,0.48,0.367,0.361,108
uncaring,0.336,7,101,1,1,0.177,0.245,0.321,108
sigma,0.336,3,50,1,1,0.49,0.472,0.535,53
brawl,0.336,3,50,1,1,0.104,0.938,0.603,53
regressive,0.336,3,50,1,1,0.302,0.434,0.363,53
rectify,0.336,3,50,1,1,0.625,0.48,0.634,53
extension,0.335,16,216,1,1,0.49,0.51,0.529,232
tribute,0.334,29,382,1,1,0.684,0.573,0.7,411
sticky,0.334,12,165,1,1,0.385,0.569,0.292,177
cotton,0.334,12,165,1,1,0.639,0.071,0.24,177
catch,0.334,362,4635,1,1,0.531,0.437,0.552,4997
ant,0.334,21,280,1,1,0.448,0.216,0.216,301
vice,0.334,61,791,1,1,0.296,0.778,0.48,852
disconnected,0.334,66,855,1,1,0.292,0.276,0.173,921
egotistical,0.333,8,114,1,1,0.156,0.667,0.363,122
resident,0.333,31,408,1,1,0.592,0.327,0.5,439
rehab,0.333,22,293,1,1,0.531,0.45,0.593,315
boards,0.333,13,178,1,1,0.469,0.27,0.524,191
glitch,0.333,13,178,1,1,0.444,0.448,0.269,191
wire,0.333,13,178,1,1,0.48,0.33,0.245,191
civil,0.332,58,754,1,1,0.521,0.281,0.517,812
sprite,0.332,4,63,1,1,0.561,0.438,0.625,67
acquaintance,0.332,14,191,1,1,0.656,0.29,0.67,205
boiling,0.332,14,191,1,1,0.302,0.69,0.526,205
levy,0.332,4,63,1,1,0.438,0.42,0.491,67
roadtrip,0.332,4,63,1,1,0.677,0.596,0.519,67
cyclone,0.332,4,63,1,1,0.416,0.796,0.673,67
yawning,0.332,4,63,1,1,0.323,0.216,0.15,67
south,0.332,161,2073,1,1,0.562,0.265,0.429,2234
previously,0.331,35,460,1,1,0.594,0.337,0.623,495
wrapping,0.331,25,332,1,1,0.46,0.368,0.462,357
phenomenon,0.331,25,332,1,1,0.625,0.721,0.848,357
control,0.331,853,10937,1,1,0.729,0.352,0.808,11790
approach,0.331,162,2087,1,1,0.612,0.392,0.61,2249
cycle,0.331,148,1908,1,1,0.635,0.4,0.533,2056
ridicule,0.331,15,204,1,1,0.143,0.745,0.255,219
culture,0.331,225,2895,1,1,0.753,0.304,0.675,3120
manic,0.331,26,345,1,1,0.054,0.892,0.368,371
yawn,0.33,10,140,1,1,0.385,0.12,0.139,150
reliable,0.33,27,358,1,1,0.912,0.241,0.875,385
nerves,0.33,72,935,1,1,0.333,0.783,0.264,1007
imagined,0.33,61,794,1,1,0.656,0.412,0.418,855
countless,0.33,84,1089,1,1,0.52,0.566,0.534,1173
threaten,0.33,28,371,1,1,0.104,0.958,0.59,399
physical,0.33,314,4040,1,1,0.75,0.52,0.607,4354
cold,0.329,1133,14547,1,1,0.398,0.538,0.348,15680
effect,0.329,140,1808,1,1,0.57,0.518,0.608,1948
added,0.329,106,1372,1,1,0.562,0.405,0.509,1478
stealth,0.329,5,76,1,1,0.52,0.27,0.452,81
postpone,0.329,5,76,1,1,0.316,0.408,0.451,81
cite,0.329,5,76,1,1,0.625,0.454,0.532,81
electrical,0.329,5,76,1,1,0.531,0.62,0.688,81
happiest,0.329,155,2001,1,1,0.99,0.716,0.746,2156
pessimistic,0.329,11,153,1,1,0.088,0.394,0.236,164
sect,0.329,5,76,1,1,0.265,0.667,0.526,81
stale,0.329,11,153,1,1,0.235,0.461,0.286,164
repugnant,0.329,5,76,1,1,0.061,0.735,0.453,81
fairy,0.329,36,474,1,1,0.776,0.408,0.413,510
bees,0.328,18,243,1,1,0.562,0.635,0.412,261
pulse,0.328,12,166,1,1,0.507,0.412,0.492,178
repay,0.328,12,166,1,1,0.469,0.632,0.592,178
lion,0.327,55,719,1,1,0.532,0.717,0.682,774
editor,0.327,20,269,1,1,0.772,0.431,0.673,289
python,0.327,6,89,1,1,0.219,0.618,0.618,95
governing,0.327,6,89,1,1,0.635,0.7,0.9,95
cursing,0.327,14,192,1,1,0.112,0.86,0.446,206
trembling,0.327,14,192,1,1,0.177,0.824,0.324,206
rage,0.326,129,1672,1,1,0.082,0.888,0.658,1801
jet,0.326,22,295,1,1,0.612,0.721,0.606,317
envelope,0.326,7,102,1,1,0.604,0.275,0.377,109
research,0.326,168,2175,1,1,0.633,0.663,0.741,2343
guilt,0.326,144,1866,1,1,0.208,0.567,0.206,2010
gig,0.325,33,437,1,1,0.816,0.755,0.594,470
hopelessness,0.325,26,347,1,1,0.052,0.402,0.223,373
doubtful,0.325,8,115,1,1,0.25,0.465,0.241,123
field,0.325,163,2113,1,1,0.64,0.38,0.336,2276
dirt,0.325,72,940,1,1,0.112,0.5,0.236,1012
poster,0.325,36,476,1,1,0.542,0.275,0.365,512
tank,0.324,46,605,1,1,0.431,0.454,0.634,651
shred,0.324,9,128,1,1,0.224,0.75,0.627,137
cheap,0.323,86,1122,1,1,0.612,0.471,0.272,1208
lama,0.323,10,141,1,1,0.56,0.32,0.4,151
platonic,0.323,21,283,1,1,0.49,0.461,0.469,304
heinous,0.323,10,141,1,1,0.133,0.792,0.471,151
rob,0.323,54,709,1,1,0.112,0.84,0.5,763
feet,0.323,252,3266,1,1,0.51,0.24,0.292,3518
tolerate,0.323,92,1200,1,1,0.724,0.43,0.588,1292
garage,0.322,39,516,1,1,0.531,0.283,0.455,555
history,0.321,355,4603,1,1,0.729,0.382,0.754,4958
downward,0.321,14,193,1,1,0.188,0.347,0.255,207
bury,0.321,50,659,1,1,0.077,0.571,0.346,709
righteous,0.321,35,465,1,1,0.823,0.385,0.79,500
joker,0.321,17,232,1,1,0.771,0.76,0.416,249
purchase,0.32,36,478,1,1,0.625,0.5,0.616,514
strike,0.32,55,724,1,1,0.271,0.811,0.571,779
flight,0.32,131,1708,1,1,0.646,0.63,0.587,1839
strings,0.32,41,543,1,1,0.457,0.292,0.355,584
cell,0.32,210,2733,1,1,0.541,0.375,0.465,2943
closed,0.318,241,3139,1,1,0.24,0.164,0.318,3380
cast,0.318,126,1647,1,1,0.558,0.62,0.517,1773
lines,0.317,149,1947,1,1,0.542,0.317,0.33,2096
choose,0.317,956,12429,1,1,0.615,0.542,0.648,13385
holiday,0.317,392,5104,1,1,0.948,0.431,0.593,5496
intensify,0.316,1,25,1,1,0.604,0.87,0.737,26
bimbo,0.316,1,25,1,1,0.396,0.37,0.3,26
unanimously,0.316,1,25,1,1,0.686,0.333,0.738,26
schoolgirl,0.316,1,25,1,1,0.76,0.521,0.415,26
keynote,0.316,4,64,1,1,0.63,0.431,0.545,68
implant,0.316,1,25,1,1,0.429,0.51,0.588,26
smelt,0.316,1,25,1,1,0.333,0.441,0.345,26
soulless,0.316,11,155,1,1,0.125,0.591,0.4,166
unforeseen,0.316,1,25,1,1,0.255,0.714,0.5,26
incomplete,0.316,29,389,1,1,0.153,0.37,0.205,418
fizz,0.316,1,25,1,1,0.459,0.708,0.349,26
overthrow,0.316,3,51,1,1,0.26,0.868,0.62,54
abduct,0.316,1,25,1,1,0.173,0.72,0.615,26
munchies,0.316,1,25,1,1,0.562,0.47,0.491,26
persisting,0.316,1,25,1,1,0.697,0.677,0.745,26
shriek,0.316,1,25,1,1,0.459,0.827,0.491,26
stinging,0.316,2,38,1,1,0.26,0.73,0.459,40
emery,0.316,3,51,1,1,0.469,0.583,0.472,54
concubine,0.316,1,25,1,1,0.388,0.594,0.476,26
overpass,0.316,1,25,1,1,0.562,0.561,0.565,26
schooling,0.316,6,90,1,1,0.582,0.462,0.64,96
pedantic,0.316,1,25,1,1,0.229,0.608,0.253,26
superior,0.316,39,519,1,1,0.801,0.697,0.94,558
blob,0.316,4,64,1,1,0.5,0.376,0.298,68
pageant,0.316,1,25,1,1,0.719,0.667,0.651,26
casually,0.316,38,506,1,1,0.658,0.29,0.333,544
simulate,0.316,1,25,1,1,0.551,0.375,0.417,26
blockade,0.316,2,38,1,1,0.38,0.519,0.51,40
backdoor,0.316,1,25,1,1,0.344,0.41,0.333,26
disapprove,0.316,2,38,1,1,0.16,0.594,0.445,40
promotional,0.316,1,25,1,1,0.84,0.646,0.679,26
moldy,0.316,2,38,1,1,0.235,0.387,0.25,40
lacrosse,0.316,1,25,1,1,0.573,0.656,0.509,26
spree,0.316,9,129,1,1,0.564,0.663,0.474,138
aloha,0.316,3,51,1,1,0.698,0.44,0.441,54
optimist,0.316,3,51,1,1,0.875,0.539,0.787,54
grrrrr,0.316,1,25,1,1,0.281,0.633,0.444,26
cactus,0.316,8,116,1,1,0.439,0.412,0.284,124
tinfoil,0.316,1,25,1,1,0.448,0.284,0.311,26
spanking,0.316,2,38,1,1,0.194,0.736,0.392,40
mullet,0.316,3,51,1,1,0.521,0.356,0.377,54
moderator,0.316,1,25,1,1,0.519,0.354,0.802,26
robbery,0.316,7,103,1,1,0.133,0.843,0.435,110
uptight,0.316,3,51,1,1,0.184,0.716,0.333,54
boomerang,0.316,3,51,1,1,0.531,0.625,0.5,54
anesthetic,0.316,1,25,1,1,0.35,0.264,0.482,26
anemic,0.316,1,25,1,1,0.167,0.279,0.155,26
tandem,0.316,2,38,1,1,0.552,0.406,0.485,40
tod,0.316,2,38,1,1,0.469,0.33,0.384,40
newsflash,0.316,5,77,1,1,0.604,0.637,0.518,82
rhapsody,0.316,9,129,1,1,0.708,0.49,0.46,138
silicon,0.316,3,51,1,1,0.439,0.448,0.445,54
vector,0.316,2,38,1,1,0.538,0.308,0.482,40
mosquito,0.316,6,90,1,1,0.229,0.4,0.198,96
diffuse,0.316,1,25,1,1,0.43,0.431,0.321,26
courier,0.316,2,38,1,1,0.551,0.383,0.441,40
prohibit,0.316,1,25,1,1,0.167,0.758,0.537,26
welsh,0.316,9,129,1,1,0.49,0.385,0.5,138
royalty,0.316,7,103,1,1,0.832,0.571,0.833,110
disapproval,0.316,3,51,1,1,0.085,0.551,0.367,54
unlawful,0.316,2,38,1,1,0.094,0.759,0.402,40
repairman,0.316,1,25,1,1,0.582,0.426,0.707,26
improvise,0.316,1,25,1,1,0.646,0.65,0.519,26
flashy,0.316,2,38,1,1,0.704,0.6,0.827,40
dues,0.316,3,51,1,1,0.367,0.461,0.288,54
scourge,0.316,3,51,1,1,0.214,0.64,0.302,54
fourteen,0.316,4,64,1,1,0.552,0.279,0.308,68
telepathic,0.316,1,25,1,1,0.602,0.49,0.642,26
commit,0.315,126,1652,1,1,0.365,0.529,0.491,1778
loving,0.314,838,10929,1,1,0.948,0.612,0.636,11767
compromise,0.314,69,911,1,1,0.677,0.52,0.805,980
steam,0.314,31,416,1,1,0.469,0.413,0.421,447
fathom,0.314,30,403,1,1,0.52,0.41,0.523,433
smith,0.314,56,742,1,1,0.677,0.333,0.529,798
track,0.313,204,2673,1,1,0.448,0.433,0.526,2877
amount,0.313,375,4904,1,1,0.562,0.422,0.649,5279
bonus,0.313,43,573,1,1,0.857,0.62,0.682,616
sensitive,0.312,132,1735,1,1,0.714,0.426,0.254,1867
monologue,0.312,16,221,1,1,0.5,0.284,0.534,237
unique,0.312,198,2598,1,1,0.823,0.347,0.661,2796
fundamentally,0.311,15,208,1,1,0.653,0.441,0.759,223
cone,0.311,15,208,1,1,0.417,0.208,0.343,223
sushi,0.311,27,365,1,1,0.698,0.343,0.394,392
magazine,0.311,27,365,1,1,0.615,0.332,0.377,392
overflowing,0.311,13,182,1,1,0.439,0.796,0.635,195
elect,0.311,13,182,1,1,0.667,0.554,0.661,195
indication,0.31,12,169,1,1,0.719,0.432,0.75,181
winner,0.31,64,849,1,1,0.96,0.81,0.886,913
soldier,0.31,61,810,1,1,0.392,0.708,0.768,871
passing,0.31,168,2210,1,1,0.458,0.298,0.509,2378
small,0.309,980,12842,1,1,0.542,0.205,0.12,13822
singer,0.309,49,654,1,1,0.802,0.735,0.628,703
correction,0.308,18,248,1,1,0.448,0.485,0.558,266
hill,0.308,183,2411,1,1,0.615,0.353,0.518,2594
smiley,0.308,8,117,1,1,0.865,0.47,0.571,125
parasite,0.308,8,117,1,1,0.092,0.442,0.324,125
exception,0.308,43,576,1,1,0.469,0.6,0.544,619
format,0.307,16,222,1,1,0.562,0.308,0.438,238
crossed,0.307,67,891,1,1,0.431,0.49,0.508,958
decade,0.307,74,983,1,1,0.531,0.402,0.665,1057
nudge,0.307,7,104,1,1,0.448,0.5,0.509,111
musk,0.307,7,104,1,1,0.469,0.454,0.453,111
belittled,0.307,7,104,1,1,0.177,0.392,0.226,111
nugget,0.307,7,104,1,1,0.602,0.34,0.348,111
chew,0.306,21,288,1,1,0.52,0.49,0.404,309
breakthrough,0.305,13,183,1,1,0.68,0.525,0.718,196
heels,0.305,26,354,1,1,0.5,0.439,0.396,380
tennis,0.305,19,262,1,1,0.622,0.519,0.431,281
squirrel,0.304,12,170,1,1,0.592,0.358,0.333,182
toast,0.304,43,578,1,1,0.74,0.382,0.356,621
tighten,0.304,5,78,1,1,0.388,0.487,0.627,83
sniper,0.304,5,78,1,1,0.167,0.87,0.853,83
implied,0.304,11,157,1,1,0.327,0.53,0.481,168
nicotine,0.304,5,78,1,1,0.235,0.608,0.447,83
salute,0.304,35,473,1,1,0.833,0.542,0.681,508
ukulele,0.304,5,78,1,1,0.513,0.358,0.365,83
limp,0.304,5,78,1,1,0.393,0.44,0.172,83
happily,0.303,155,2054,1,1,1,0.69,0.674,2209
bleeding,0.303,39,526,1,1,0.135,0.817,0.408,565
passive,0.303,27,368,1,1,0.42,0.116,0.241,395
cards,0.302,86,1146,1,1,0.568,0.317,0.32,1232
sovereignty,0.302,15,210,1,1,0.719,0.529,0.886,225
infant,0.302,20,276,1,1,0.802,0.431,0.328,296
mocking,0.302,25,342,1,1,0.082,0.755,0.394,367
favor,0.301,95,1266,1,1,0.812,0.308,0.519,1361
visitation,0.301,4,65,1,1,0.729,0.346,0.534,69
restrain,0.301,4,65,1,1,0.134,0.696,0.434,69
ciao,0.301,4,65,1,1,0.542,0.426,0.409,69
spade,0.301,4,65,1,1,0.469,0.667,0.529,69
alibi,0.301,4,65,1,1,0.396,0.528,0.556,69
overt,0.301,4,65,1,1,0.708,0.326,0.607,69
treachery,0.301,4,65,1,1,0.104,0.852,0.448,69
nutty,0.301,4,65,1,1,0.444,0.317,0.271,69
testosterone,0.301,4,65,1,1,0.573,0.84,0.775,69
mailbox,0.301,4,65,1,1,0.573,0.222,0.404,69
aloud,0.301,44,593,1,1,0.458,0.713,0.75,637
excluded,0.3,28,382,1,1,0.061,0.54,0.134,410
practical,0.3,28,382,1,1,0.71,0.49,0.608,410
wet,0.3,76,1016,1,1,0.385,0.417,0.185,1092
tournament,0.3,18,250,1,1,0.694,0.74,0.611,268
vegetarian,0.3,13,184,1,1,0.562,0.255,0.407,197
mood,0.3,810,10716,1,1,0.72,0.5,0.5,11526
seven,0.3,91,1215,1,1,0.672,0.265,0.373,1306
radical,0.299,40,541,1,1,0.5,0.792,0.811,581
buffet,0.299,8,118,1,1,0.656,0.546,0.519,126
rabid,0.299,8,118,1,1,0.089,0.827,0.454,126
separate,0.299,149,1983,1,1,0.24,0.514,0.349,2132
lap,0.299,51,687,1,1,0.583,0.51,0.412,738
arcade,0.299,12,171,1,1,0.676,0.521,0.502,183
limbo,0.298,16,224,1,1,0.385,0.284,0.309,240
fill,0.298,358,4752,1,1,0.729,0.449,0.637,5110
stealing,0.298,49,661,1,1,0.086,0.913,0.455,710
harmful,0.298,32,436,1,1,0.094,0.75,0.291,468
beating,0.298,85,1138,1,1,0.153,0.833,0.481,1223
conference,0.297,76,1019,1,1,0.688,0.615,0.606,1095
goodwill,0.297,7,105,1,1,0.938,0.327,0.667,112
burglar,0.297,3,52,1,1,0.05,0.769,0.404,55
incognito,0.297,3,52,1,1,0.61,0.49,0.446,55
evident,0.297,15,211,1,1,0.633,0.444,0.664,226
dart,0.297,3,52,1,1,0.417,0.608,0.5,55
bypass,0.297,3,52,1,1,0.429,0.418,0.353,55
surplus,0.297,3,52,1,1,0.602,0.68,0.63,55
lynching,0.297,3,52,1,1,0.135,0.92,0.548,55
specs,0.297,3,52,1,1,0.54,0.398,0.618,55
stressin,0.297,3,52,1,1,0.146,0.81,0.367,55
penetration,0.297,3,52,1,1,0.438,0.885,0.792,55
galore,0.297,3,52,1,1,0.823,0.574,0.729,55
dodo,0.297,3,52,1,1,0.438,0.306,0.353,55
madden,0.297,3,52,1,1,0.329,0.602,0.457,55
sickle,0.297,3,52,1,1,0.427,0.585,0.37,55
chain,0.297,51,688,1,1,0.378,0.5,0.547,739
whispered,0.297,43,582,1,1,0.548,0.358,0.309,625
regression,0.297,3,52,1,1,0.312,0.5,0.324,55
oneday,0.297,3,52,1,1,0.667,0.245,0.374,55
bride,0.296,18,251,1,1,0.84,0.708,0.579,269
spill,0.296,33,450,1,1,0.408,0.633,0.456,483
relive,0.295,21,291,1,1,0.75,0.65,0.693,312
yearly,0.295,10,145,1,1,0.592,0.295,0.431,155
betray,0.295,32,437,1,1,0.042,0.87,0.536,469
stare,0.295,123,1646,1,1,0.541,0.43,0.538,1769
chime,0.294,6,92,1,1,0.573,0.541,0.464,98
shin,0.294,6,92,1,1,0.459,0.5,0.231,98
breather,0.294,13,185,1,1,0.624,0.471,0.388,198
impress,0.293,29,398,1,1,0.816,0.744,0.895,427
damned,0.293,62,837,1,1,0.1,0.76,0.465,899
hypocritical,0.292,15,212,1,1,0.048,0.74,0.415,227
engineer,0.292,18,252,1,1,0.719,0.5,0.875,270
lee,0.292,96,1291,1,1,0.51,0.269,0.296,1387
traditional,0.292,36,492,1,1,0.677,0.221,0.604,528
church,0.291,349,4663,1,1,0.708,0.198,0.61,5012
withhold,0.291,2,39,1,1,0.32,0.451,0.444,41
diabolical,0.291,2,39,1,1,0.102,0.912,0.456,41
pundit,0.291,2,39,1,1,0.644,0.582,0.833,41
deformed,0.291,2,39,1,1,0.198,0.435,0.308,41
borough,0.291,2,39,1,1,0.429,0.343,0.38,41
sedition,0.291,2,39,1,1,0.327,0.557,0.591,41
warden,0.291,2,39,1,1,0.615,0.627,0.898,41
complacent,0.291,11,159,1,1,0.625,0.452,0.518,170
diplomatic,0.291,5,79,1,1,0.653,0.363,0.918,84
jurisdiction,0.291,2,39,1,1,0.48,0.58,0.82,41
shuffling,0.291,5,79,1,1,0.521,0.408,0.293,84
goalie,0.291,2,39,1,1,0.573,0.389,0.455,41
knowledgeable,0.291,8,119,1,1,0.865,0.455,0.971,127
asparagus,0.291,2,39,1,1,0.469,0.317,0.264,41
blockbuster,0.291,2,39,1,1,0.73,0.676,0.883,41
blindfolded,0.291,2,39,1,1,0.208,0.564,0.209,41
nerve,0.29,55,746,1,1,0.129,0.698,0.307,801
background,0.29,135,1814,1,1,0.399,0.357,0.498,1949
connected,0.29,259,3470,1,1,0.816,0.55,0.612,3729
playground,0.29,19,266,1,1,0.888,0.62,0.435,285
protected,0.289,67,907,1,1,0.854,0.378,0.709,974
whatnot,0.289,13,186,1,1,0.375,0.493,0.363,199
burdened,0.289,13,186,1,1,0.429,0.519,0.565,199
ballad,0.289,10,146,1,1,0.792,0.284,0.424,156
whoop,0.289,10,146,1,1,0.559,0.481,0.443,156
rest,0.288,2083,27854,1,1,0.907,0.167,0.3,29937
corporation,0.288,7,106,1,1,0.429,0.332,0.873,113
empty,0.287,1084,14516,1,1,0.188,0.183,0.081,15600
strategy,0.287,49,668,1,1,0.704,0.667,0.858,717
war,0.287,398,5339,1,1,0.022,0.892,0.727,5737
digs,0.286,4,66,1,1,0.448,0.67,0.635,70
staple,0.286,4,66,1,1,0.542,0.306,0.438,70
mri,0.286,4,66,1,1,0.365,0.431,0.349,70
recipient,0.286,4,66,1,1,0.604,0.324,0.679,70
dagger,0.286,4,66,1,1,0.224,0.797,0.613,70
potential,0.285,157,2118,1,1,0.806,0.625,0.84,2275
light,0.285,1323,17756,1,1,0.771,0.32,0.519,19079
rover,0.285,16,227,1,1,0.51,0.538,0.421,243
script,0.285,28,388,1,1,0.61,0.45,0.527,416
eldest,0.285,11,160,1,1,0.625,0.471,0.741,171
honeymoon,0.284,13,187,1,1,0.979,0.678,0.526,200
hierarchy,0.284,6,93,1,1,0.583,0.722,0.902,99
heaven,0.283,417,5615,1,1,0.896,0.385,0.6,6032
recall,0.283,56,765,1,1,0.583,0.351,0.525,821
violent,0.283,60,819,1,1,0.112,0.918,0.616,879
fluid,0.283,8,120,1,1,0.673,0.407,0.589,128
freezing,0.283,44,604,1,1,0.327,0.367,0.471,648
pose,0.282,19,268,1,1,0.427,0.33,0.361,287
capitalist,0.282,10,147,1,1,0.352,0.577,0.821,157
accomplishment,0.282,23,322,1,1,0.917,0.694,0.888,345
buffalo,0.281,12,174,1,1,0.469,0.528,0.527,186
genetic,0.281,12,174,1,1,0.562,0.288,0.726,186
comp,0.281,12,174,1,1,0.573,0.45,0.371,186
alike,0.281,53,726,1,1,0.653,0.173,0.444,779
edgy,0.281,27,376,1,1,0.281,0.895,0.306,403
force,0.28,415,5605,1,1,0.612,0.75,0.905,6020
base,0.28,110,1495,1,1,0.635,0.298,0.553,1605
tire,0.28,24,336,1,1,0.438,0.385,0.381,360
strip,0.28,26,363,1,1,0.427,0.5,0.436,389
sin,0.28,154,2089,1,1,0.177,0.712,0.449,2243
celebrated,0.279,38,525,1,1,0.875,0.69,0.763,563
appendix,0.278,1,26,1,1,0.365,0.387,0.425,27
buffering,0.278,1,26,1,1,0.479,0.468,0.381,27
airplane,0.278,19,269,1,1,0.719,0.702,0.708,288
lobe,0.278,3,53,1,1,0.459,0.364,0.352,56
roasted,0.278,9,134,1,1,0.615,0.52,0.339,143
instructions,0.278,13,188,1,1,0.582,0.302,0.556,201
machete,0.278,1,26,1,1,0.26,0.69,0.474,27
possessive,0.278,9,134,1,1,0.279,0.648,0.696,143
bombshell,0.278,1,26,1,1,0.327,0.868,0.693,27
resistant,0.278,3,53,1,1,0.592,0.585,0.815,56
deadbeat,0.278,5,80,1,1,0.229,0.453,0.368,85
mantis,0.278,1,26,1,1,0.48,0.355,0.421,27
threesome,0.278,5,80,1,1,0.49,0.676,0.56,85
exorcism,0.278,1,26,1,1,0.163,0.98,0.557,27
overflow,0.278,7,107,1,1,0.398,0.792,0.5,114
aspirin,0.278,1,26,1,1,0.479,0.271,0.422,27
shrew,0.278,1,26,1,1,0.306,0.463,0.39,27
snare,0.278,1,26,1,1,0.229,0.85,0.466,27
parcels,0.278,1,26,1,1,0.551,0.445,0.418,27
spokesman,0.278,1,26,1,1,0.72,0.48,0.611,27
shag,0.278,3,53,1,1,0.417,0.462,0.34,56
torso,0.278,3,53,1,1,0.408,0.394,0.473,56
demolition,0.278,1,26,1,1,0.133,0.827,0.541,27
seam,0.278,1,26,1,1,0.427,0.25,0.414,27
bulk,0.278,11,161,1,1,0.469,0.413,0.509,172
liabilities,0.278,1,26,1,1,0.429,0.608,0.694,27
untenable,0.278,1,26,1,1,0.143,0.637,0.425,27
perplexed,0.278,5,80,1,1,0.312,0.705,0.318,85
dopey,0.278,1,26,1,1,0.32,0.38,0.365,27
upstanding,0.278,1,26,1,1,0.851,0.39,0.708,27
putrid,0.278,3,53,1,1,0.146,0.62,0.385,56
gassy,0.278,1,26,1,1,0.354,0.497,0.304,27
premium,0.278,19,269,1,1,0.786,0.59,0.769,288
housewife,0.278,7,107,1,1,0.656,0.361,0.449,114
syphilis,0.278,1,26,1,1,0.071,0.606,0.245,27
trendy,0.278,7,107,1,1,0.713,0.52,0.536,114
cod,0.278,11,161,1,1,0.51,0.321,0.304,172
corridor,0.278,9,134,1,1,0.604,0.589,0.592,143
unequivocally,0.278,3,53,1,1,0.521,0.668,0.554,56
fracture,0.278,1,26,1,1,0.135,0.74,0.375,27
nip,0.278,9,134,1,1,0.281,0.7,0.264,143
sinus,0.278,3,53,1,1,0.531,0.563,0.34,56
nutritious,0.278,1,26,1,1,0.833,0.337,0.655,27
streetlight,0.278,1,26,1,1,0.673,0.268,0.39,27
ware,0.278,3,53,1,1,0.604,0.443,0.455,56
flip,0.278,56,769,1,1,0.281,0.529,0.435,825
dry,0.277,137,1864,1,1,0.363,0.169,0.311,2001
mild,0.277,26,364,1,1,0.635,0.198,0.216,390
roof,0.277,81,1108,1,1,0.602,0.226,0.342,1189
condescending,0.276,14,202,1,1,0.583,0.363,0.593,216
colored,0.276,12,175,1,1,0.806,0.317,0.275,187
cannabis,0.275,10,148,1,1,0.271,0.5,0.564,158
outline,0.275,10,148,1,1,0.542,0.365,0.509,158
raw,0.275,90,1232,1,1,0.143,0.349,0.342,1322
bold,0.275,55,758,1,1,0.49,0.271,0.483,813
wagon,0.274,8,121,1,1,0.49,0.461,0.474,129
plural,0.274,8,121,1,1,0.56,0.432,0.564,129
mold,0.274,17,243,1,1,0.33,0.274,0.402,260
neat,0.274,33,460,1,1,0.878,0.235,0.491,493
brains,0.274,61,840,1,1,0.663,0.557,0.722,901
scrub,0.273,6,94,1,1,0.417,0.42,0.5,100
riddled,0.273,6,94,1,1,0.281,0.861,0.422,100
wits,0.273,6,94,1,1,0.76,0.596,0.765,100
pip,0.273,6,94,1,1,0.448,0.43,0.366,100
crooked,0.273,18,257,1,1,0.146,0.594,0.305,275
seat,0.273,161,2199,1,1,0.542,0.281,0.434,2360
lined,0.272,11,162,1,1,0.438,0.367,0.424,173
barrier,0.272,21,298,1,1,0.333,0.48,0.562,319
strange,0.271,399,5438,1,1,0.314,0.663,0.395,5837
avail,0.271,9,135,1,1,0.8,0.43,0.603,144
liberalism,0.271,4,67,1,1,0.562,0.712,0.75,71
misread,0.271,4,67,1,1,0.115,0.558,0.315,71
squat,0.271,4,67,1,1,0.33,0.55,0.453,71
grieved,0.271,4,67,1,1,0.104,0.46,0.191,71
immune,0.271,24,339,1,1,0.629,0.472,0.78,363
adultery,0.271,4,67,1,1,0.12,0.922,0.51,71
freelancer,0.271,4,67,1,1,0.614,0.564,0.553,71
recognize,0.271,139,1904,1,1,0.76,0.315,0.6,2043
exhausted,0.271,185,2530,1,1,0.123,0.423,0.202,2715
twin,0.271,78,1074,1,1,0.688,0.363,0.453,1152
impossible,0.27,276,3769,1,1,0.153,0.51,0.407,4045
score,0.27,56,775,1,1,0.67,0.388,0.589,831
messenger,0.27,25,353,1,1,0.694,0.434,0.5,378
free,0.27,1509,20565,1,1,0.896,0.5,0.544,22074
road,0.269,559,7628,1,1,0.656,0.404,0.404,8187
torn,0.269,100,1375,1,1,0.153,0.51,0.283,1475
fearful,0.269,39,544,1,1,0.083,0.482,0.278,583
quickly,0.269,231,3160,1,1,0.784,0.85,0.636,3391
irks,0.269,7,108,1,1,0.276,0.781,0.339,115
dynasty,0.269,7,108,1,1,0.725,0.588,0.936,115
shaving,0.269,7,108,1,1,0.5,0.469,0.353,115
odd,0.269,180,2466,1,1,0.265,0.337,0.302,2646
resent,0.269,18,258,1,1,0.073,0.553,0.163,276
describe,0.269,147,2017,1,1,0.542,0.472,0.555,2164
flashlight,0.268,10,149,1,1,0.653,0.414,0.356,159
rush,0.268,170,2331,1,1,0.406,0.809,0.546,2501
legs,0.268,95,1309,1,1,0.479,0.407,0.228,1404
rich,0.268,237,3247,1,1,0.882,0.627,0.905,3484
works,0.267,542,7411,1,1,0.776,0.434,0.657,7953
offload,0.266,2,40,1,1,0.479,0.444,0.525,42
sideline,0.266,2,40,1,1,0.44,0.382,0.517,42
duplicate,0.266,2,40,1,1,0.521,0.49,0.338,42
specimen,0.266,2,40,1,1,0.531,0.444,0.568,42
bearer,0.266,2,40,1,1,0.571,0.547,0.676,42
bidding,0.266,5,81,1,1,0.586,0.644,0.509,86
deficient,0.266,2,40,1,1,0.24,0.464,0.132,42
daycare,0.266,11,163,1,1,0.776,0.481,0.36,174
eulogy,0.266,2,40,1,1,0.625,0.443,0.667,42
assassination,0.266,5,81,1,1,0.083,0.941,0.525,86
giveaway,0.266,8,122,1,1,0.865,0.618,0.437,130
vulgar,0.266,5,81,1,1,0.083,0.82,0.445,86
null,0.266,2,40,1,1,0.253,0.147,0.152,42
roc,0.266,2,40,1,1,0.427,0.51,0.415,42
abduction,0.266,2,40,1,1,0.062,0.99,0.673,42
anesthesia,0.266,2,40,1,1,0.365,0.216,0.394,42
blurt,0.266,2,40,1,1,0.408,0.439,0.441,42
carry,0.266,403,5522,1,1,0.635,0.38,0.5,5925
mark,0.266,203,2788,1,1,0.491,0.231,0.6,2991
ally,0.266,48,669,1,1,0.792,0.32,0.688,717
trick,0.266,70,970,1,1,0.542,0.7,0.409,1040
list,0.265,383,5251,1,1,0.528,0.26,0.402,5634
sacrifices,0.265,30,423,1,1,0.281,0.717,0.538,453
charity,0.265,43,601,1,1,0.92,0.284,0.551,644
proposal,0.265,18,259,1,1,0.888,0.667,0.596,277
pack,0.265,145,1997,1,1,0.51,0.347,0.475,2142
determined,0.265,63,875,1,1,0.76,0.528,0.673,938
direct,0.265,76,1053,1,1,0.793,0.403,0.65,1129
penny,0.265,28,396,1,1,0.615,0.302,0.324,424
hostile,0.264,25,355,1,1,0.188,0.877,0.474,380
supremacy,0.264,12,177,1,1,0.794,0.706,0.943,189
overwhelming,0.264,204,2806,1,1,0.327,0.83,0.64,3010
lifted,0.264,48,670,1,1,0.714,0.441,0.657,718
grip,0.264,52,725,1,1,0.52,0.549,0.602,777
amnesia,0.264,9,136,1,1,0.296,0.33,0.308,145
lick,0.264,26,369,1,1,0.47,0.482,0.33,395
dodge,0.263,6,95,1,1,0.333,0.76,0.509,101
pressing,0.262,31,438,1,1,0.24,0.755,0.636,469
ceremony,0.262,17,246,1,1,0.76,0.559,0.761,263
uncontrollable,0.262,10,150,1,1,0.265,0.79,0.626,160
factor,0.262,51,713,1,1,0.635,0.365,0.678,764
promising,0.261,18,260,1,1,0.791,0.549,0.858,278
command,0.261,38,535,1,1,0.427,0.79,0.849,573
swing,0.261,46,645,1,1,0.602,0.51,0.481,691
bible,0.261,140,1937,1,1,0.719,0.225,0.726,2077
ferret,0.26,3,54,1,1,0.385,0.391,0.398,57
squid,0.26,3,54,1,1,0.497,0.398,0.357,57
suburb,0.26,3,54,1,1,0.354,0.566,0.441,57
doubling,0.26,3,54,1,1,0.459,0.452,0.464,57
tingle,0.26,3,54,1,1,0.46,0.56,0.264,57
theoretical,0.26,3,54,1,1,0.615,0.27,0.546,57
pessimist,0.26,3,54,1,1,0.125,0.47,0.218,57
flaunt,0.26,3,54,1,1,0.438,0.611,0.525,57
curtain,0.26,19,274,1,1,0.698,0.278,0.304,293
dosage,0.26,3,54,1,1,0.344,0.45,0.49,57
precaution,0.26,3,54,1,1,0.625,0.52,0.406,57
hives,0.26,3,54,1,1,0.417,0.473,0.591,57
universe,0.258,654,9023,1,1,0.694,0.454,0.839,9677
pathological,0.258,8,123,1,1,0.22,0.602,0.58,131
sessions,0.258,44,619,1,1,0.646,0.578,0.65,663
authority,0.258,35,495,1,1,0.592,0.592,0.934,530
fitted,0.258,8,123,1,1,0.507,0.404,0.673,131
ways,0.258,641,8845,1,1,0.688,0.56,0.425,9486
sweater,0.257,18,261,1,1,0.704,0.245,0.295,279
detail,0.257,47,661,1,1,0.514,0.406,0.528,708
improving,0.257,28,399,1,1,0.911,0.51,0.682,427
conversation,0.257,478,6606,1,1,0.75,0.51,0.609,7084
error,0.257,44,620,1,1,0.094,0.559,0.198,664
subscriber,0.257,4,68,1,1,0.562,0.398,0.57,72
tackle,0.257,29,413,1,1,0.365,0.686,0.569,442
tuck,0.257,9,137,1,1,0.367,0.473,0.361,146
radio,0.257,174,2414,1,1,0.573,0.402,0.358,2588
warranted,0.257,4,68,1,1,0.714,0.367,0.69,72
pompous,0.257,4,68,1,1,0.5,0.571,0.409,72
misplaced,0.257,9,137,1,1,0.247,0.45,0.324,146
strangle,0.257,4,68,1,1,0.094,0.927,0.527,72
offended,0.256,71,993,1,1,0.188,0.69,0.337,1064
guest,0.256,67,938,1,1,0.719,0.49,0.558,1005
alongside,0.256,57,800,1,1,0.458,0.333,0.347,857
reciprocate,0.256,15,220,1,1,0.76,0.46,0.618,235
norm,0.255,50,704,1,1,0.5,0.245,0.527,754
solidarity,0.255,159,2211,1,1,0.792,0.407,0.781,2370
soap,0.255,28,400,1,1,0.531,0.163,0.311,428
cracked,0.255,28,400,1,1,0.224,0.52,0.228,428
fabricated,0.254,5,82,1,1,0.418,0.427,0.555,87
orbs,0.254,5,82,1,1,0.469,0.355,0.482,87
fore,0.254,5,82,1,1,0.667,0.417,0.654,87
pattern,0.254,42,594,1,1,0.479,0.422,0.664,636
ken,0.254,24,345,1,1,0.438,0.409,0.36,369
ironic,0.253,56,788,1,1,0.435,0.55,0.5,844
wary,0.253,18,262,1,1,0.51,0.343,0.535,280
extend,0.253,31,442,1,1,0.646,0.57,0.689,473
distraught,0.253,12,179,1,1,0.115,0.903,0.264,191
glitter,0.253,12,179,1,1,0.814,0.75,0.762,191
compensate,0.253,12,179,1,1,0.612,0.429,0.762,191
weigh,0.253,19,276,1,1,0.333,0.396,0.375,295
discouragement,0.252,6,96,1,1,0.112,0.319,0.206,102
fluent,0.252,6,96,1,1,0.76,0.5,0.614,102
aggravated,0.252,13,193,1,1,0.079,0.76,0.43,206
saver,0.252,6,96,1,1,0.745,0.382,0.802,102
august,0.252,70,983,1,1,0.652,0.292,0.462,1053
particular,0.252,158,2203,1,1,0.562,0.402,0.552,2361
driveway,0.252,14,207,1,1,0.612,0.392,0.689,221
nada,0.252,14,207,1,1,0.25,0.231,0.136,221
fold,0.251,30,429,1,1,0.385,0.412,0.33,459
narrative,0.251,70,984,1,1,0.58,0.303,0.443,1054
spinster,0.251,7,110,1,1,0.357,0.368,0.345,117
bakery,0.251,7,110,1,1,0.802,0.5,0.38,117
sickness,0.251,56,790,1,1,0.094,0.704,0.288,846
protect,0.251,441,6135,1,1,0.823,0.714,0.791,6576
equipment,0.251,16,235,1,1,0.745,0.495,0.7,251
steal,0.25,115,1610,1,1,0.021,0.856,0.528,1725
lemonade,0.25,8,124,1,1,0.661,0.287,0.412,132
welcome,0.25,597,8305,1,1,0.898,0.555,0.664,8902
despise,0.25,56,791,1,1,0.167,0.745,0.296,847
strongly,0.25,67,944,1,1,0.63,0.817,0.885,1011
season,0.249,613,8532,1,1,0.792,0.41,0.519,9145
reinforce,0.249,9,138,1,1,0.604,0.583,0.76,147
scholarship,0.249,10,152,1,1,0.866,0.49,0.625,162
skin,0.249,257,3588,1,1,0.569,0.35,0.395,3845
tasty,0.248,11,166,1,1,0.959,0.786,0.555,177
flare,0.248,12,180,1,1,0.558,0.823,0.508,192
partisan,0.248,12,180,1,1,0.615,0.549,0.669,192
communicate,0.248,119,1670,1,1,0.823,0.41,0.696,1789
handful,0.247,41,584,1,1,0.521,0.481,0.4,625
phase,0.247,140,1963,1,1,0.645,0.3,0.482,2103
portion,0.246,32,459,1,1,0.536,0.364,0.398,491
game,0.246,1131,15785,1,1,0.735,0.788,0.493,16916
almighty,0.246,54,766,1,1,0.938,0.874,0.958,820
permission,0.246,54,766,1,1,0.612,0.311,0.58,820
beacon,0.246,18,264,1,1,0.58,0.407,0.537,282
academic,0.246,39,557,1,1,0.781,0.42,0.812,596
twenty,0.246,61,864,1,1,0.52,0.292,0.286,925
impressed,0.246,41,585,1,1,0.806,0.77,0.429,626
crowded,0.245,306,4283,1,1,0.694,0.286,0.585,4589
willingness,0.245,21,306,1,1,0.786,0.5,0.729,327
articulate,0.245,23,334,1,1,0.677,0.462,0.618,357
kangaroo,0.242,1,27,1,1,0.716,0.333,0.301,28
lanky,0.242,1,27,1,1,0.412,0.426,0.37,28
roomful,0.242,1,27,1,1,0.786,0.425,0.634,28
pow,0.242,3,55,1,1,0.375,0.44,0.426,58
malpractice,0.242,1,27,1,1,0.094,0.559,0.33,28
wiggle,0.242,3,55,1,1,0.531,0.676,0.359,58
whammy,0.242,1,27,1,1,0.461,0.491,0.345,28
bruising,0.242,1,27,1,1,0.084,0.52,0.422,28
destruct,0.242,4,69,1,1,0.071,0.868,0.525,73
tacky,0.242,4,69,1,1,0.245,0.49,0.373,73
grump,0.242,2,41,1,1,0.26,0.469,0.425,43
matinee,0.242,1,27,1,1,0.694,0.578,0.447,28
calculation,0.242,2,41,1,1,0.646,0.453,0.606,43
meatball,0.242,1,27,1,1,0.612,0.279,0.343,28
preventative,0.242,1,27,1,1,0.65,0.442,0.682,28
cornflakes,0.242,1,27,1,1,0.729,0.346,0.355,28
rebel,0.242,13,195,1,1,0.235,0.83,0.555,208
headless,0.242,1,27,1,1,0.136,0.582,0.235,28
suv,0.242,2,41,1,1,0.552,0.431,0.446,43
sponsorship,0.242,1,27,1,1,0.854,0.608,0.696,28
ladder,0.242,16,237,1,1,0.56,0.438,0.358,253
recruiter,0.242,1,27,1,1,0.662,0.63,0.69,28
cadet,0.242,2,41,1,1,0.504,0.393,0.664,43
variations,0.242,4,69,1,1,0.458,0.548,0.353,73
bong,0.242,10,153,1,1,0.333,0.566,0.375,163
lending,0.242,7,111,1,1,0.51,0.585,0.462,118
ramp,0.242,3,55,1,1,0.49,0.517,0.357,58
drivel,0.242,4,69,1,1,0.398,0.469,0.463,73
grr,0.242,4,69,1,1,0.229,0.538,0.333,73
taught,0.242,466,6537,1,1,0.814,0.481,0.642,7003
fluctuating,0.242,2,41,1,1,0.292,0.591,0.395,43
cucumber,0.242,4,69,1,1,0.49,0.235,0.237,73
eyeball,0.242,1,27,1,1,0.526,0.422,0.42,28
municipal,0.242,2,41,1,1,0.625,0.39,0.758,43
slipper,0.242,1,27,1,1,0.635,0.298,0.245,28
felony,0.242,3,55,1,1,0.206,0.808,0.472,58
surrogate,0.242,2,41,1,1,0.406,0.59,0.472,43
caricature,0.242,1,27,1,1,0.604,0.373,0.383,28
surrounding,0.242,147,2071,1,1,0.531,0.422,0.669,2218
plummet,0.242,1,27,1,1,0.302,0.75,0.36,28
mathematics,0.242,4,69,1,1,0.438,0.435,0.664,73
priesthood,0.242,1,27,1,1,0.622,0.304,0.649,28
dreadfully,0.242,1,27,1,1,0.246,0.806,0.306,28
yeast,0.242,1,27,1,1,0.5,0.35,0.327,28
sundae,0.242,1,27,1,1,0.743,0.414,0.404,28
graph,0.242,3,55,1,1,0.51,0.286,0.621,58
quandary,0.242,1,27,1,1,0.208,0.575,0.422,28
vindication,0.242,2,41,1,1,0.531,0.632,0.764,43
sully,0.242,2,41,1,1,0.378,0.55,0.37,43
amused,0.242,11,167,1,1,0.942,0.847,0.596,178
fiscal,0.242,3,55,1,1,0.5,0.582,0.845,58
handicap,0.242,3,55,1,1,0.133,0.394,0.264,58
fluctuate,0.242,1,27,1,1,0.285,0.617,0.48,28
trolley,0.242,3,55,1,1,0.562,0.558,0.464,58
femininity,0.242,4,69,1,1,0.75,0.479,0.451,73
pedestal,0.242,6,97,1,1,0.735,0.284,0.579,103
infusion,0.242,2,41,1,1,0.583,0.365,0.453,43
mainland,0.242,3,55,1,1,0.68,0.407,0.806,58
lynx,0.242,1,27,1,1,0.51,0.59,0.567,28
speciality,0.242,1,27,1,1,0.854,0.47,0.885,28
courses,0.242,18,265,1,1,0.735,0.412,0.534,283
brigade,0.242,6,97,1,1,0.604,0.71,0.828,103
net,0.241,44,630,1,1,0.441,0.288,0.417,674
term,0.24,176,2483,1,1,0.45,0.255,0.598,2659
sweat,0.24,54,771,1,1,0.388,0.579,0.297,825
pin,0.239,24,350,1,1,0.438,0.346,0.39,374
scar,0.239,24,350,1,1,0.146,0.5,0.397,374
goods,0.239,23,336,1,1,0.888,0.396,0.726,359
exposed,0.239,70,996,1,1,0.471,0.661,0.509,1066
thesis,0.239,22,322,1,1,0.583,0.582,0.552,344
tuesday,0.239,112,1586,1,1,0.469,0.184,0.33,1698
vague,0.239,19,280,1,1,0.271,0.335,0.083,299
anger,0.238,250,3526,1,1,0.167,0.865,0.657,3776
paranoia,0.238,47,674,1,1,0.146,0.841,0.407,721
banter,0.237,12,182,1,1,0.594,0.677,0.464,194
gaming,0.237,63,900,1,1,0.896,0.633,0.491,963
item,0.236,24,351,1,1,0.594,0.27,0.465,375
lab,0.236,59,844,1,1,0.479,0.5,0.6,903
rethink,0.236,23,337,1,1,0.48,0.423,0.583,360
softly,0.236,106,1506,1,1,0.517,0.206,0.304,1612
forsaken,0.236,33,478,1,1,0.05,0.49,0.192,511
acknowledgement,0.236,10,154,1,1,0.819,0.539,0.83,164
spicy,0.236,21,309,1,1,0.44,0.733,0.61,330
beaten,0.236,42,605,1,1,0.083,0.846,0.265,647
ward,0.235,30,436,1,1,0.469,0.255,0.254,466
cheers,0.235,119,1691,1,1,0.948,0.77,0.702,1810
prescribed,0.235,9,140,1,1,0.531,0.391,0.463,149
disastrous,0.235,9,140,1,1,0.071,0.741,0.439,149
brutal,0.235,48,690,1,1,0.122,0.882,0.643,738
consider,0.234,296,4190,1,1,0.677,0.368,0.579,4486
dope,0.234,89,1269,1,1,0.295,0.855,0.425,1358
thanking,0.234,25,366,1,1,0.917,0.538,0.658,391
nerd,0.233,40,578,1,1,0.408,0.481,0.315,618
unkind,0.233,7,112,1,1,0.135,0.409,0.31,119
doable,0.233,7,112,1,1,0.76,0.404,0.675,119
intended,0.233,54,776,1,1,0.406,0.542,0.587,830
learn,0.233,2309,32636,1,1,0.833,0.643,0.829,34945
traitorous,0.232,6,98,1,1,0.073,0.745,0.412,104
leftover,0.232,13,197,1,1,0.49,0.46,0.222,210
shrinking,0.232,6,98,1,1,0.19,0.4,0.217,104
degrade,0.232,6,98,1,1,0.083,0.5,0.184,104
alarmed,0.232,6,98,1,1,0.188,0.822,0.492,104
period,0.232,396,5615,1,1,0.396,0.324,0.588,6011
passenger,0.231,19,282,1,1,0.717,0.413,0.481,301
limb,0.231,12,183,1,1,0.51,0.397,0.427,195
denial,0.231,43,622,1,1,0.194,0.435,0.318,665
permanent,0.231,73,1047,1,1,0.745,0.345,0.736,1120
dump,0.231,42,608,1,1,0.345,0.5,0.37,650
laptop,0.23,78,1118,1,1,0.724,0.27,0.519,1196
witness,0.23,95,1359,1,1,0.562,0.569,0.593,1454
canceling,0.23,11,169,1,1,0.229,0.47,0.349,180
accommodation,0.23,11,169,1,1,0.817,0.415,0.587,180
automated,0.23,5,84,1,1,0.578,0.402,0.632,89
temperature,0.23,17,254,1,1,0.521,0.559,0.473,271
biology,0.23,11,169,1,1,0.479,0.274,0.546,180
leaning,0.23,44,637,1,1,0.48,0.409,0.352,681
catholic,0.229,72,1034,1,1,0.646,0.24,0.575,1106
running,0.229,565,8025,1,1,0.73,0.858,0.442,8590
manifesto,0.229,10,155,1,1,0.646,0.519,0.676,165
arrangement,0.229,10,155,1,1,0.625,0.382,0.683,165
investment,0.229,26,382,1,1,0.72,0.592,0.745,408
planning,0.229,192,2737,1,1,0.894,0.462,0.705,2929
adjust,0.229,57,822,1,1,0.647,0.327,0.638,879
onset,0.228,4,70,1,1,0.673,0.497,0.5,74
suspense,0.228,9,141,1,1,0.286,0.775,0.402,150
puffy,0.228,4,70,1,1,0.333,0.54,0.387,74
wardrobe,0.228,9,141,1,1,0.612,0.51,0.336,150
immaturity,0.228,4,70,1,1,0.146,0.567,0.221,74
tragedy,0.228,74,1064,1,1,0.052,0.843,0.34,1138
aware,0.228,316,4501,1,1,0.656,0.34,0.77,4817
sounding,0.227,37,539,1,1,0.69,0.5,0.558,576
principle,0.227,18,269,1,1,0.75,0.306,0.629,287
vine,0.227,13,198,1,1,0.531,0.292,0.405,211
respect,0.227,683,9723,1,1,0.927,0.344,0.758,10406
actress,0.227,22,326,1,1,0.633,0.556,0.596,348
persons,0.226,79,1137,1,1,0.869,0.302,0.588,1216
progress,0.226,158,2261,1,1,0.88,0.642,0.877,2419
selfless,0.226,25,369,1,1,0.521,0.235,0.396,394
cocktail,0.226,12,184,1,1,0.74,0.48,0.381,196
environmental,0.226,12,184,1,1,0.633,0.313,0.664,196
rock,0.226,287,4098,1,1,0.623,0.236,0.557,4385
audience,0.225,96,1380,1,1,0.698,0.61,0.613,1476
business,0.225,469,6692,1,1,0.688,0.569,0.755,7161
page,0.225,181,2591,1,1,0.677,0.224,0.278,2772
pajama,0.224,3,56,1,1,0.908,0.157,0.245,59
apologetic,0.224,3,56,1,1,0.479,0.461,0.571,59
prospective,0.224,3,56,1,1,0.678,0.5,0.717,59
redneck,0.224,3,56,1,1,0.401,0.5,0.348,59
bowel,0.224,3,56,1,1,0.306,0.417,0.391,59
possessing,0.224,3,56,1,1,0.461,0.593,0.612,59
pang,0.224,7,113,1,1,0.146,0.595,0.455,120
prescription,0.224,11,170,1,1,0.302,0.337,0.568,181
redo,0.224,7,113,1,1,0.481,0.5,0.535,120
spiteful,0.224,7,113,1,1,0.073,0.71,0.33,120
hack,0.224,27,398,1,1,0.135,0.717,0.534,425
awkwardness,0.224,15,227,1,1,0.167,0.454,0.148,242
direction,0.224,178,2550,1,1,0.719,0.33,0.684,2728
restaurant,0.224,108,1553,1,1,0.847,0.406,0.5,1661
goodbye,0.224,175,2509,1,1,0.24,0.389,0.328,2684
joint,0.224,37,541,1,1,0.615,0.392,0.566,578
monitor,0.224,18,270,1,1,0.49,0.298,0.538,288
bit,0.223,1405,20056,1,1,0.427,0.31,0.225,21461
marks,0.223,47,684,1,1,0.43,0.48,0.424,731
loft,0.223,10,156,1,1,0.51,0.378,0.343,166
sunk,0.223,10,156,1,1,0.146,0.531,0.185,166
raised,0.223,162,2326,1,1,0.656,0.326,0.643,2488
flaw,0.222,24,356,1,1,0.319,0.491,0.175,380
context,0.222,77,1113,1,1,0.531,0.3,0.553,1190
catastrophic,0.222,6,99,1,1,0.071,0.934,0.598,105
brethren,0.222,13,199,1,1,0.917,0.38,0.641,212
affiliation,0.222,6,99,1,1,0.615,0.594,0.5,105
amplify,0.222,6,99,1,1,0.677,0.735,0.827,105
lecture,0.222,30,442,1,1,0.594,0.462,0.737,472
two,0.222,2482,35483,1,1,0.52,0.2,0.404,37965
tense,0.222,23,342,1,1,0.396,0.439,0.655,365
invisible,0.222,143,2057,1,1,0.417,0.345,0.412,2200
crutch,0.221,9,142,1,1,0.302,0.294,0.302,151
alcohol,0.22,139,2002,1,1,0.323,0.667,0.377,2141
ground,0.219,312,4482,1,1,0.398,0.343,0.602,4794
surprisingly,0.219,36,529,1,1,0.847,0.793,0.819,565
site,0.219,90,1303,1,1,0.677,0.265,0.452,1393
tofu,0.219,2,42,1,1,0.521,0.33,0.283,44
bilingual,0.219,2,42,1,1,0.735,0.49,0.606,44
gnome,0.219,2,42,1,1,0.429,0.479,0.38,44
exacerbate,0.219,2,42,1,1,0.323,0.776,0.58,44
doctorate,0.219,2,42,1,1,0.776,0.479,0.841,44
overworked,0.219,5,85,1,1,0.133,0.67,0.387,90
skillet,0.219,2,42,1,1,0.51,0.296,0.345,44
unbiased,0.219,5,85,1,1,0.625,0.378,0.618,90
jargon,0.219,2,42,1,1,0.333,0.548,0.404,44
vanguard,0.219,2,42,1,1,0.693,0.64,0.78,44
standup,0.219,2,42,1,1,0.633,0.583,0.55,44
token,0.219,8,128,1,1,0.51,0.418,0.414,136
glade,0.219,8,128,1,1,0.6,0.385,0.434,136
uncalled,0.219,2,42,1,1,0.344,0.294,0.222,44
toothless,0.219,2,42,1,1,0.312,0.541,0.272,44
ponytail,0.219,2,42,1,1,0.541,0.337,0.302,44
likelihood,0.219,8,128,1,1,0.76,0.469,0.542,136
overall,0.218,82,1189,1,1,0.583,0.37,0.67,1271
appear,0.218,139,2007,1,1,0.735,0.506,0.567,2146
adulthood,0.216,43,631,1,1,0.541,0.454,0.652,674
movement,0.216,157,2269,1,1,0.656,0.654,0.658,2426
new,0.216,3621,52040,1,1,0.917,0.49,0.582,55661
doubled,0.216,7,114,1,1,0.427,0.536,0.56,121
dissertation,0.216,7,114,1,1,0.312,0.575,0.575,121
quirky,0.216,15,229,1,1,0.708,0.373,0.564,244
contact,0.216,399,5749,1,1,0.719,0.424,0.526,6148
separately,0.216,15,229,1,1,0.31,0.365,0.368,244
civilians,0.216,7,114,1,1,0.49,0.448,0.525,121
holy,0.215,324,4673,1,1,0.812,0.112,0.69,4997
problematic,0.215,43,632,1,1,0.073,0.72,0.361,675
recent,0.215,156,2258,1,1,0.592,0.365,0.589,2414
selection,0.215,17,258,1,1,0.594,0.34,0.595,275
week,0.214,1941,27953,1,1,0.51,0.231,0.351,29894
parts,0.214,196,2835,1,1,0.459,0.327,0.392,3031
firmly,0.214,24,359,1,1,0.786,0.51,0.777,383
psychosis,0.214,9,143,1,1,0.167,0.859,0.312,152
landslide,0.214,4,71,1,1,0.25,0.864,0.53,75
wager,0.214,4,71,1,1,0.479,0.816,0.615,75
tasteless,0.214,4,71,1,1,0.146,0.196,0.148,75
momentum,0.214,14,215,1,1,0.663,0.75,0.688,229
rephrase,0.214,4,71,1,1,0.547,0.451,0.549,75
fashionable,0.214,4,71,1,1,0.75,0.51,0.605,75
work,0.214,4244,61143,1,1,0.719,0.596,0.75,65387
flush,0.213,11,172,1,1,0.408,0.755,0.589,183
miracles,0.213,23,345,1,1,0.922,0.735,0.692,368
drone,0.213,11,172,1,1,0.429,0.686,0.596,183
ethical,0.213,11,172,1,1,0.854,0.324,0.634,183
smoking,0.213,128,1859,1,1,0.176,0.557,0.384,1987
deny,0.213,80,1167,1,1,0.316,0.667,0.321,1247
unreal,0.213,37,547,1,1,0.173,0.431,0.296,584
meal,0.212,139,2018,1,1,0.833,0.461,0.473,2157
hardware,0.212,6,100,1,1,0.594,0.289,0.686,106
masquerade,0.212,6,100,1,1,0.431,0.633,0.446,106
reed,0.212,6,100,1,1,0.49,0.35,0.307,106
unthinkable,0.212,6,100,1,1,0.365,0.48,0.481,106
smooth,0.212,45,663,1,1,0.823,0.127,0.281,708
lessen,0.211,15,230,1,1,0.235,0.284,0.255,245
crusty,0.211,8,129,1,1,0.625,0.531,0.473,137
broadcasting,0.211,8,129,1,1,0.542,0.7,0.706,137
mick,0.211,8,129,1,1,0.449,0.451,0.382,137
meth,0.211,8,129,1,1,0.354,0.564,0.34,137
millionaire,0.211,8,129,1,1,0.917,0.755,0.85,137
paragraph,0.21,12,187,1,1,0.51,0.164,0.269,199
opening,0.209,229,3327,1,1,0.667,0.51,0.62,3556
blindly,0.209,16,245,1,1,0.439,0.598,0.278,261
brow,0.209,16,245,1,1,0.562,0.311,0.481,261
wasted,0.209,104,1519,1,1,0.188,0.558,0.259,1623
unlike,0.209,91,1331,1,1,0.439,0.439,0.418,1422
clarify,0.209,22,332,1,1,0.652,0.535,0.625,354
psychology,0.208,28,419,1,1,0.561,0.396,0.726,447
patch,0.208,44,651,1,1,0.439,0.288,0.283,695
sib,0.207,1,28,1,1,0.698,0.298,0.593,29
uranium,0.207,1,28,1,1,0.375,0.58,0.49,29
mart,0.207,3,57,1,1,0.531,0.402,0.418,60
burner,0.207,7,115,1,1,0.296,0.816,0.446,122
pharaoh,0.207,1,28,1,1,0.656,0.491,0.798,29
semen,0.207,1,28,1,1,0.5,0.755,0.471,29
pansy,0.207,1,28,1,1,0.653,0.283,0.589,29
sporting,0.207,7,115,1,1,0.917,0.656,0.675,122
establishment,0.207,23,347,1,1,0.69,0.398,0.631,370
hypochondriac,0.207,1,28,1,1,0.194,0.588,0.333,29
inflammation,0.207,1,28,1,1,0.146,0.765,0.423,29
fling,0.207,7,115,1,1,0.439,0.696,0.534,122
parity,0.207,1,28,1,1,0.582,0.406,0.407,29
stomped,0.207,3,57,1,1,0.229,0.684,0.406,60
eviction,0.207,3,57,1,1,0.185,0.731,0.455,60
snip,0.207,1,28,1,1,0.417,0.327,0.268,29
changeable,0.207,1,28,1,1,0.49,0.48,0.528,29
contingency,0.207,1,28,1,1,0.396,0.5,0.67,29
explosive,0.207,3,57,1,1,0.156,0.943,0.663,60
marginal,0.207,3,57,1,1,0.235,0.644,0.345,60
prowl,0.207,1,28,1,1,0.312,0.542,0.396,29
dud,0.207,3,57,1,1,0.167,0.455,0.246,60
pedestrian,0.207,3,57,1,1,0.438,0.36,0.448,60
sonic,0.207,25,376,1,1,0.594,0.5,0.481,401
ploy,0.207,5,86,1,1,0.458,0.559,0.741,91
sadist,0.207,1,28,1,1,0.042,0.918,0.5,29
governmental,0.207,1,28,1,1,0.521,0.541,0.906,29
morgue,0.207,1,28,1,1,0.022,0.539,0.241,29
punitive,0.207,1,28,1,1,0.281,0.576,0.605,29
adviser,0.207,3,57,1,1,0.745,0.362,0.705,60
coordinate,0.207,3,57,1,1,0.698,0.429,0.694,60
ledger,0.207,1,28,1,1,0.51,0.362,0.609,29
powerhouse,0.207,1,28,1,1,0.63,0.755,0.787,29
demoralized,0.207,1,28,1,1,0.082,0.59,0.149,29
mishap,0.207,1,28,1,1,0.071,0.654,0.227,29
spotty,0.207,1,28,1,1,0.281,0.606,0.241,29
baffled,0.207,13,202,1,1,0.151,0.6,0.339,215
booger,0.207,1,28,1,1,0.399,0.537,0.427,29
slush,0.207,1,28,1,1,0.427,0.283,0.296,29
denomination,0.207,1,28,1,1,0.49,0.363,0.429,29
chemotherapy,0.207,1,28,1,1,0.163,0.689,0.517,29
godmother,0.207,1,28,1,1,0.733,0.311,0.53,29
culmination,0.207,1,28,1,1,0.656,0.586,0.695,29
adamant,0.207,5,86,1,1,0.344,0.529,0.575,91
downhill,0.207,15,231,1,1,0.292,0.573,0.279,246
branching,0.207,1,28,1,1,0.52,0.422,0.472,29
subject,0.207,116,1696,1,1,0.602,0.344,0.558,1812
santa,0.206,49,725,1,1,0.735,0.286,0.509,774
jenny,0.205,18,275,1,1,0.542,0.406,0.407,293
ninja,0.205,14,217,1,1,0.542,0.844,0.682,231
missing,0.205,532,7747,1,1,0.306,0.418,0.222,8279
pace,0.204,133,1947,1,1,0.51,0.38,0.39,2080
homo,0.204,10,159,1,1,0.531,0.368,0.415,169
yogurt,0.203,8,130,1,1,0.66,0.269,0.24,138
knot,0.203,8,130,1,1,0.541,0.221,0.408,138
lingerie,0.203,8,130,1,1,0.543,0.463,0.308,138
impression,0.203,44,654,1,1,0.684,0.557,0.577,698
trained,0.203,60,887,1,1,0.771,0.538,0.645,947
round,0.203,183,2679,1,1,0.552,0.434,0.311,2862
pull,0.203,312,4558,1,1,0.45,0.685,0.473,4870
voice,0.202,994,14493,1,1,0.594,0.343,0.528,15487
spout,0.202,6,101,1,1,0.438,0.357,0.309,107
groan,0.202,6,101,1,1,0.396,0.75,0.351,107
delayed,0.202,20,305,1,1,0.188,0.49,0.216,325
classified,0.202,6,101,1,1,0.571,0.46,0.663,107
founding,0.202,6,101,1,1,0.698,0.404,0.898,107
knots,0.202,6,101,1,1,0.418,0.346,0.267,107
glare,0.202,27,407,1,1,0.698,0.735,0.733,434
senseless,0.201,11,174,1,1,0.125,0.388,0.136,185
grateful,0.201,587,8578,1,1,0.958,0.353,0.56,9165
threat,0.201,78,1152,1,1,0.135,0.865,0.667,1230
enormously,0.2,4,72,1,1,0.76,0.694,0.872,76
dishonesty,0.2,4,72,1,1,0.094,0.592,0.348,76
operator,0.2,4,72,1,1,0.612,0.63,0.726,76
ducking,0.2,14,218,1,1,0.344,0.573,0.294,232
proxy,0.2,4,72,1,1,0.521,0.408,0.52,76
slug,0.2,4,72,1,1,0.276,0.37,0.16,76
drugged,0.2,9,145,1,1,0.102,0.75,0.321,154
cardboard,0.2,9,145,1,1,0.5,0.173,0.309,154
galaxy,0.2,50,744,1,1,0.75,0.571,0.75,794
supper,0.199,12,189,1,1,0.708,0.429,0.552,201
diversity,0.199,28,423,1,1,0.806,0.472,0.711,451
disco,0.198,15,233,1,1,0.71,0.806,0.575,248
latch,0.198,7,116,1,1,0.395,0.263,0.288,123
fur,0.198,34,511,1,1,0.583,0.392,0.315,545
sorting,0.198,10,160,1,1,0.469,0.4,0.642,170
react,0.198,65,965,1,1,0.5,0.716,0.717,1030
spectrum,0.198,35,526,1,1,0.312,0.7,0.527,561
remembering,0.197,114,1683,1,1,0.535,0.386,0.509,1797
fluffy,0.197,22,336,1,1,0.781,0.431,0.356,358
current,0.196,262,3853,1,1,0.625,0.312,0.612,4115
sake,0.196,177,2608,1,1,0.49,0.573,0.407,2785
tag,0.196,123,1817,1,1,0.612,0.353,0.375,1940
mayonnaise,0.196,2,43,1,1,0.51,0.32,0.222,45
skit,0.196,2,43,1,1,0.438,0.434,0.421,45
ducky,0.196,2,43,1,1,0.52,0.43,0.368,45
straighten,0.196,5,87,1,1,0.677,0.5,0.685,92
limo,0.196,2,43,1,1,0.76,0.367,0.667,45
overpriced,0.196,5,87,1,1,0.271,0.556,0.472,92
shotgun,0.196,8,131,1,1,0.2,0.868,0.684,139
disclosed,0.196,2,43,1,1,0.271,0.575,0.546,45
presenter,0.196,2,43,1,1,0.673,0.607,0.735,45
apprentice,0.196,5,87,1,1,0.615,0.413,0.452,92
pho,0.196,2,43,1,1,0.541,0.37,0.384,45
partition,0.196,2,43,1,1,0.615,0.469,0.567,45
dealership,0.196,2,43,1,1,0.541,0.43,0.629,45
facet,0.196,5,87,1,1,0.667,0.324,0.382,92
tube,0.195,24,366,1,1,0.418,0.279,0.409,390
priority,0.195,87,1291,1,1,0.878,0.562,0.864,1378
unexpectedly,0.195,21,322,1,1,0.354,0.759,0.462,343
appearance,0.194,57,851,1,1,0.669,0.49,0.534,908
destroyed,0.194,97,1439,1,1,0.031,0.696,0.288,1536
cheeky,0.193,9,146,1,1,0.434,0.679,0.41,155
inconvenience,0.193,19,293,1,1,0.063,0.667,0.291,312
fitting,0.193,36,543,1,1,0.612,0.441,0.638,579
personality,0.193,238,3513,1,1,0.896,0.513,0.79,3751
cinema,0.193,71,1058,1,1,0.698,0.538,0.5,1129
shining,0.193,99,1470,1,1,0.885,0.673,0.812,1569
food,0.192,934,13758,1,1,0.888,0.324,0.527,14692
nuclear,0.192,24,367,1,1,0.219,0.856,0.781,391
operation,0.192,17,264,1,1,0.475,0.611,0.755,281
sweaty,0.192,17,264,1,1,0.281,0.54,0.304,281
viewpoint,0.191,10,161,1,1,0.673,0.306,0.644,171
effects,0.191,80,1192,1,1,0.47,0.578,0.379,1272
shop,0.191,180,2665,1,1,0.725,0.632,0.565,2845
transit,0.191,14,220,1,1,0.439,0.59,0.588,234
thrown,0.191,86,1281,1,1,0.5,0.55,0.619,1367
quiz,0.191,18,279,1,1,0.462,0.61,0.527,297
bachelor,0.19,30,456,1,1,0.667,0.406,0.6,486
fit,0.19,330,4881,1,1,0.604,0.45,0.632,5211
honk,0.19,3,58,1,1,0.549,0.635,0.415,61
wrongly,0.19,11,176,1,1,0.054,0.55,0.202,187
gasoline,0.19,3,58,1,1,0.417,0.562,0.519,61
footprint,0.19,3,58,1,1,0.592,0.292,0.336,61
spotless,0.19,3,58,1,1,0.792,0.327,0.726,61
scout,0.19,11,176,1,1,0.656,0.611,0.763,187
gesture,0.19,31,471,1,1,0.667,0.481,0.427,502
motor,0.19,7,117,1,1,0.531,0.551,0.648,124
basket,0.19,23,353,1,1,0.458,0.227,0.336,376
header,0.19,7,117,1,1,0.56,0.398,0.74,124
attendance,0.19,11,176,1,1,0.812,0.5,0.592,187
teaching,0.19,136,2020,1,1,0.822,0.444,0.736,2156
patrol,0.189,12,191,1,1,0.427,0.664,0.736,203
circumstances,0.189,121,1801,1,1,0.562,0.527,0.464,1922
daily,0.188,534,7903,1,1,0.653,0.347,0.473,8437
screen,0.188,145,2156,1,1,0.67,0.3,0.417,2301
tip,0.188,88,1314,1,1,0.708,0.221,0.518,1402
dub,0.188,13,206,1,1,0.51,0.48,0.387,219
appetite,0.187,23,354,1,1,0.704,0.637,0.581,377
nipple,0.187,4,73,1,1,0.48,0.786,0.415,77
minuscule,0.187,4,73,1,1,0.396,0.286,0.214,77
deter,0.187,4,73,1,1,0.344,0.537,0.567,77
refrigerator,0.187,9,147,1,1,0.677,0.26,0.391,156
pitcher,0.187,4,73,1,1,0.51,0.673,0.704,77
surgical,0.187,4,73,1,1,0.327,0.696,0.723,77
mascara,0.187,4,73,1,1,0.575,0.45,0.269,77
frail,0.187,9,147,1,1,0.255,0.333,0.069,156
scapegoat,0.187,4,73,1,1,0.184,0.685,0.481,77
vendetta,0.187,4,73,1,1,0.198,0.784,0.583,77
summary,0.187,14,221,1,1,0.729,0.26,0.427,235
theory,0.186,90,1346,1,1,0.583,0.314,0.529,1436
hole,0.186,235,3493,1,1,0.531,0.31,0.33,3728
continued,0.185,86,1288,1,1,0.635,0.44,0.5,1374
shatter,0.185,10,162,1,1,0.108,0.821,0.464,172
pit,0.185,72,1081,1,1,0.408,0.396,0.278,1153
possibly,0.185,214,3186,1,1,0.448,0.4,0.5,3400
technical,0.185,16,251,1,1,0.51,0.49,0.736,267
performance,0.185,96,1437,1,1,0.75,0.52,0.672,1533
outfit,0.185,34,518,1,1,0.76,0.49,0.566,552
untouchable,0.184,5,88,1,1,0.49,0.602,0.683,93
uninteresting,0.184,5,88,1,1,0.153,0.235,0.228,93
town,0.184,381,5669,1,1,0.551,0.299,0.627,6050
vibe,0.183,230,3429,1,1,0.71,0.48,0.517,3659
champ,0.183,19,296,1,1,0.854,0.754,0.896,315
haven,0.183,556,8273,1,1,0.684,0.265,0.547,8829
controversial,0.183,13,207,1,1,0.271,0.858,0.538,220
entertainer,0.183,6,103,1,1,0.888,0.709,0.759,109
profession,0.183,27,415,1,1,0.68,0.529,0.786,442
demon,0.182,78,1173,1,1,0.037,0.908,0.509,1251
evil,0.182,327,4874,1,1,0.04,0.827,0.545,5201
hideous,0.182,15,237,1,1,0.091,0.75,0.328,252
maternal,0.182,7,118,1,1,0.847,0.417,0.634,125
professor,0.181,48,728,1,1,0.656,0.398,0.721,776
mobile,0.181,49,743,1,1,0.615,0.569,0.481,792
information,0.181,150,2246,1,1,0.765,0.37,0.711,2396
overcoming,0.181,25,386,1,1,0.842,0.765,0.855,411
fate,0.181,182,2723,1,1,0.571,0.479,0.712,2905
spencer,0.181,8,133,1,1,0.51,0.394,0.367,141
grudge,0.181,8,133,1,1,0.115,0.647,0.414,141
province,0.181,17,267,1,1,0.714,0.255,0.471,284
backseat,0.18,9,148,1,1,0.388,0.33,0.237,157
faithful,0.179,69,1043,1,1,0.888,0.333,0.627,1112
indicate,0.178,12,193,1,1,0.594,0.35,0.676,205
dash,0.178,12,193,1,1,0.574,0.312,0.324,205
shamed,0.178,26,402,1,1,0.135,0.567,0.218,428
test,0.178,165,2477,1,1,0.449,0.5,0.509,2642
mini,0.178,59,895,1,1,0.421,0.324,0.221,954
staring,0.177,154,2314,1,1,0.542,0.306,0.423,2468
weighing,0.177,16,253,1,1,0.449,0.441,0.468,269
pray,0.177,769,11509,1,1,0.714,0.127,0.627,12278
planets,0.177,38,582,1,1,0.724,0.318,0.658,620
serious,0.176,438,6562,1,1,0.5,0.455,0.619,7000
log,0.176,62,941,1,1,0.591,0.371,0.395,1003
journey,0.176,744,11142,1,1,0.91,0.702,0.625,11886
ride,0.176,318,4772,1,1,0.806,0.465,0.472,5090
verse,0.176,55,837,1,1,0.667,0.269,0.336,892
existing,0.176,83,1256,1,1,0.802,0.344,0.75,1339
accomplished,0.175,47,718,1,1,0.87,0.52,0.798,765
sex,0.174,543,8150,1,1,0.803,0.939,0.704,8693
drama,0.174,237,3567,1,1,0.43,0.755,0.481,3804
time,0.173,16956,254267,1,1,0.604,0.288,0.609,271223
expectancy,0.173,2,44,1,1,0.581,0.622,0.558,46
impulsive,0.173,12,194,1,1,0.365,0.864,0.607,206
negotiator,0.173,1,29,1,1,0.635,0.471,0.817,30
nickel,0.173,4,74,1,1,0.51,0.347,0.406,78
brainwash,0.173,2,44,1,1,0.198,0.647,0.481,46
cling,0.173,45,689,1,1,0.417,0.62,0.588,734
verification,0.173,3,59,1,1,0.75,0.276,0.642,62
keel,0.173,1,29,1,1,0.344,0.417,0.419,30
saffron,0.173,1,29,1,1,0.443,0.373,0.349,30
burn,0.173,144,2174,1,1,0.219,0.783,0.509,2318
ratchet,0.173,5,89,1,1,0.449,0.52,0.343,94
senile,0.173,4,74,1,1,0.28,0.211,0.305,78
pedicure,0.173,2,44,1,1,0.695,0.269,0.296,46
cosmetics,0.173,1,29,1,1,0.765,0.464,0.472,30
excessively,0.173,5,89,1,1,0.449,0.882,0.716,94
austerity,0.173,6,104,1,1,0.438,0.406,0.534,110
lice,0.173,2,44,1,1,0.133,0.5,0.194,46
hassle,0.173,18,284,1,1,0.177,0.74,0.489,302
clutch,0.173,9,149,1,1,0.383,0.5,0.491,158
shark,0.173,20,314,1,1,0.26,0.845,0.596,334
disgraced,0.173,4,74,1,1,0.071,0.661,0.25,78
afterthought,0.173,3,59,1,1,0.396,0.392,0.349,62
malfunction,0.173,2,44,1,1,0.125,0.577,0.229,46
contribution,0.173,16,254,1,1,0.854,0.452,0.76,270
widely,0.173,16,254,1,1,0.698,0.453,0.725,270
motive,0.173,13,209,1,1,0.667,0.588,0.663,222
denying,0.173,26,404,1,1,0.08,0.542,0.272,430
detailed,0.173,13,209,1,1,0.603,0.314,0.472,222
squirt,0.173,1,29,1,1,0.406,0.46,0.255,30
refute,0.173,2,44,1,1,0.312,0.731,0.583,46
intermission,0.173,1,29,1,1,0.49,0.36,0.402,30
aghhh,0.173,1,29,1,1,0.281,0.635,0.243,30
tuning,0.173,9,149,1,1,0.719,0.39,0.635,158
contracted,0.173,2,44,1,1,0.344,0.557,0.449,46
bewildered,0.173,6,104,1,1,0.23,0.63,0.3,110
mediator,0.173,1,29,1,1,0.592,0.438,0.58,30
yolk,0.173,1,29,1,1,0.49,0.306,0.28,30
mixer,0.173,4,74,1,1,0.562,0.5,0.556,78
teal,0.173,2,44,1,1,0.54,0.293,0.321,46
screwdriver,0.173,1,29,1,1,0.52,0.519,0.439,30
exaggeration,0.173,5,89,1,1,0.312,0.775,0.582,94
aghast,0.173,1,29,1,1,0.133,0.865,0.464,30
midlife,0.173,3,59,1,1,0.594,0.244,0.473,62
fraudulent,0.173,6,104,1,1,0.15,0.774,0.417,110
pharmacist,0.173,2,44,1,1,0.592,0.382,0.648,46
corroboration,0.173,1,29,1,1,0.625,0.431,0.733,30
ailment,0.173,2,44,1,1,0.146,0.734,0.277,46
gusto,0.173,28,434,1,1,0.692,0.729,0.62,462
bargain,0.173,5,89,1,1,0.653,0.533,0.67,94
anxiousness,0.173,2,44,1,1,0.235,0.814,0.282,46
fright,0.173,7,119,1,1,0.177,0.816,0.191,126
inexperienced,0.173,3,59,1,1,0.281,0.473,0.231,62
snubbed,0.173,1,29,1,1,0.265,0.528,0.279,30
usher,0.173,5,89,1,1,0.521,0.44,0.519,94
lactose,0.173,5,89,1,1,0.479,0.29,0.433,94
tutoring,0.173,3,59,1,1,0.663,0.402,0.702,62
entrust,0.173,1,29,1,1,0.693,0.31,0.63,30
amazingly,0.173,19,299,1,1,0.918,0.765,0.92,318
strain,0.173,12,194,1,1,0.19,0.75,0.38,206
finch,0.173,3,59,1,1,0.438,0.444,0.358,62
folk,0.173,74,1124,1,1,0.663,0.433,0.432,1198
memo,0.173,8,134,1,1,0.625,0.235,0.407,142
shelter,0.172,88,1336,1,1,0.704,0.229,0.569,1424
age,0.171,712,10717,1,1,0.561,0.226,0.498,11429
crown,0.171,53,811,1,1,0.708,0.572,0.737,864
body,0.171,876,13187,1,1,0.694,0.461,0.571,14063
umbrella,0.17,20,315,1,1,0.583,0.246,0.255,335
destroying,0.17,58,887,1,1,0.041,0.828,0.66,945
compliment,0.169,33,511,1,1,0.82,0.49,0.651,544
persevere,0.169,16,255,1,1,0.802,0.583,0.937,271
sore,0.169,32,496,1,1,0.094,0.65,0.224,528
coat,0.169,32,496,1,1,0.677,0.256,0.464,528
warrior,0.169,75,1144,1,1,0.458,0.863,0.915,1219
nomination,0.169,14,225,1,1,0.663,0.637,0.696,239
psalms,0.168,13,210,1,1,0.602,0.252,0.534,223
mercy,0.168,110,1672,1,1,0.719,0.229,0.5,1782
stone,0.168,196,2969,1,1,0.216,0.183,0.561,3165
upbringing,0.168,12,195,1,1,0.677,0.49,0.6,207
mock,0.168,24,376,1,1,0.36,0.606,0.618,400
stumble,0.167,22,346,1,1,0.153,0.716,0.259,368
hardship,0.167,32,497,1,1,0.094,0.775,0.482,529
deposit,0.167,10,165,1,1,0.54,0.379,0.483,175
collectively,0.167,20,316,1,1,0.817,0.573,0.533,336
denied,0.167,40,618,1,1,0.188,0.604,0.333,658
fell,0.166,327,4953,1,1,0.255,0.462,0.25,5280
higher,0.166,198,3005,1,1,0.866,0.528,0.713,3203
tolerable,0.166,8,135,1,1,0.75,0.35,0.374,143
journalist,0.166,35,543,1,1,0.542,0.452,0.732,578
gala,0.166,8,135,1,1,0.755,0.443,0.679,143
life,0.166,12677,191598,1,1,0.918,0.615,0.824,204275
fist,0.165,25,392,1,1,0.333,0.686,0.481,417
unfaithful,0.165,7,120,1,1,0.031,0.806,0.298,127
wrecked,0.164,14,226,1,1,0.078,0.618,0.28,240
terminal,0.164,13,211,1,1,0.316,0.434,0.483,224
wed,0.164,13,211,1,1,0.604,0.549,0.448,224
chef,0.164,20,317,1,1,0.854,0.411,0.57,337
tactic,0.164,13,211,1,1,0.531,0.434,0.798,224
bunk,0.163,12,196,1,1,0.438,0.332,0.339,208
epiphany,0.163,18,287,1,1,0.625,0.596,0.526,305
bull,0.162,36,560,1,1,0.521,0.64,0.644,596
past,0.162,1340,20332,1,1,0.49,0.422,0.311,21672
import,0.162,5,90,1,1,0.615,0.48,0.623,95
useful,0.162,71,1091,1,1,0.833,0.411,0.726,1162
tremendously,0.162,17,272,1,1,0.719,0.722,0.661,289
pax,0.162,5,90,1,1,0.551,0.421,0.473,95
easily,0.162,312,4747,1,1,0.885,0.279,0.453,5059
frightened,0.161,50,773,1,1,0.153,0.817,0.255,823
obsess,0.161,10,166,1,1,0.112,0.846,0.509,176
nausea,0.161,10,166,1,1,0.104,0.781,0.273,176
easy,0.161,1140,17323,1,1,0.865,0.194,0.373,18463
owe,0.161,102,1563,1,1,0.5,0.429,0.386,1665
kind,0.161,1789,27185,1,1,0.918,0.24,0.618,28974
midnight,0.161,243,3705,1,1,0.562,0.47,0.545,3948
suspicion,0.16,14,227,1,1,0.204,0.711,0.377,241
cloth,0.16,9,151,1,1,0.51,0.19,0.287,160
scraping,0.16,4,75,1,1,0.265,0.479,0.305,79
trite,0.16,4,75,1,1,0.458,0.418,0.29,79
lax,0.16,4,75,1,1,0.43,0.401,0.3,79
disclosure,0.16,14,227,1,1,0.5,0.615,0.71,241
pix,0.16,4,75,1,1,0.521,0.373,0.364,79
carpenter,0.16,4,75,1,1,0.521,0.55,0.519,79
stinking,0.16,4,75,1,1,0.041,0.657,0.264,79
provision,0.16,4,75,1,1,0.75,0.45,0.692,79
asylum,0.16,19,303,1,1,0.407,0.33,0.445,322
payback,0.16,4,75,1,1,0.459,0.5,0.567,79
spoke,0.16,166,2538,1,1,0.635,0.433,0.483,2704
baking,0.159,23,364,1,1,0.549,0.455,0.451,387
long,0.159,3737,56863,1,1,0.541,0.353,0.543,60600
flying,0.158,139,2130,1,1,0.877,0.606,0.696,2269
hygiene,0.158,8,136,1,1,0.781,0.287,0.537,144
obsessed,0.158,105,1613,1,1,0.219,0.84,0.439,1718
working,0.158,1174,17891,1,1,0.74,0.585,0.576,19065
repeated,0.158,21,334,1,1,0.429,0.472,0.314,355
kiddos,0.158,12,197,1,1,0.5,0.48,0.342,209
jack,0.158,118,1812,1,1,0.487,0.45,0.441,1930
ruby,0.157,20,319,1,1,0.663,0.408,0.544,339
division,0.157,32,502,1,1,0.37,0.481,0.472,534
priest,0.157,48,746,1,1,0.561,0.324,0.648,794
paper,0.157,203,3109,1,1,0.52,0.123,0.293,3312
recourse,0.157,3,60,1,1,0.402,0.337,0.598,63
follower,0.157,39,609,1,1,0.646,0.488,0.461,648
projection,0.157,7,121,1,1,0.708,0.5,0.731,128
disclose,0.157,7,121,1,1,0.49,0.57,0.545,128
admirer,0.157,3,60,1,1,0.796,0.72,0.65,63
curling,0.157,7,121,1,1,0.583,0.592,0.4,128
brace,0.157,7,121,1,1,0.61,0.385,0.364,128
walking,0.157,667,10186,1,1,0.708,0.48,0.781,10853
march,0.157,150,2302,1,1,0.531,0.2,0.483,2452
salty,0.156,30,472,1,1,0.388,0.531,0.288,502
insane,0.156,207,3173,1,1,0.062,0.67,0.265,3380
assistant,0.156,22,350,1,1,0.625,0.39,0.536,372
bite,0.156,63,976,1,1,0.219,0.796,0.51,1039
confessions,0.156,14,228,1,1,0.325,0.538,0.658,242
engineering,0.156,14,228,1,1,0.735,0.471,0.836,242
skeleton,0.155,10,167,1,1,0.183,0.464,0.343,177
crack,0.155,65,1007,1,1,0.302,0.625,0.4,1072
understatement,0.154,13,213,1,1,0.347,0.48,0.473,226
twisted,0.154,55,855,1,1,0.071,0.736,0.311,910
jumpsuit,0.154,6,106,1,1,0.562,0.365,0.361,112
baggage,0.154,26,412,1,1,0.61,0.363,0.427,438
fairly,0.154,53,825,1,1,0.79,0.406,0.75,878
loyalty,0.153,66,1024,1,1,0.885,0.406,0.793,1090
anti,0.153,101,1560,1,1,0.365,0.412,0.384,1661
proceeds,0.153,12,198,1,1,0.677,0.47,0.585,210
wash,0.153,93,1438,1,1,0.635,0.377,0.297,1531
wonderful,0.153,540,8281,1,1,0.971,0.776,0.83,8821
uplift,0.152,18,290,1,1,0.656,0.779,0.771,308
hypocrisy,0.152,27,428,1,1,0.156,0.523,0.37,455
reality,0.152,568,8717,1,1,0.786,0.365,0.787,9285
fleabag,0.151,2,45,1,1,0.271,0.557,0.348,47
briefing,0.151,2,45,1,1,0.612,0.333,0.702,47
duet,0.151,5,91,1,1,0.694,0.693,0.527,96
substantially,0.151,2,45,1,1,0.646,0.471,0.684,47
scarcity,0.151,2,45,1,1,0.167,0.5,0.182,47
coercion,0.151,2,45,1,1,0.33,0.708,0.577,47
overtaken,0.151,2,45,1,1,0.594,0.552,0.702,47
kiwi,0.151,5,91,1,1,0.646,0.273,0.282,96
enroll,0.151,2,45,1,1,0.696,0.53,0.611,47
hotdog,0.151,2,45,1,1,0.72,0.438,0.373,47
weakly,0.151,2,45,1,1,0.27,0.255,0.111,47
nervousness,0.151,5,91,1,1,0.163,0.915,0.241,96
mistletoe,0.151,2,45,1,1,0.542,0.47,0.324,47
reactionary,0.151,2,45,1,1,0.406,0.573,0.69,47
uneasy,0.15,28,444,1,1,0.115,0.598,0.349,472
meltdown,0.15,25,398,1,1,0.629,0.657,0.602,423
broad,0.15,22,352,1,1,0.762,0.365,0.637,374
spine,0.15,22,352,1,1,0.495,0.461,0.6,374
shiny,0.15,19,306,1,1,0.885,0.604,0.787,325
jesus,0.15,693,10657,1,1,0.8,0.4,0.62,11350
bowling,0.149,10,168,1,1,0.656,0.431,0.309,178
brush,0.149,40,629,1,1,0.49,0.265,0.186,669
irrespective,0.148,7,122,1,1,0.497,0.538,0.745,129
sense,0.148,1204,18531,1,1,0.781,0.417,0.474,19735
preach,0.148,41,645,1,1,0.602,0.48,0.702,686
active,0.147,132,2046,1,1,0.847,0.73,0.731,2178
abandon,0.147,77,1200,1,1,0.052,0.519,0.245,1277
hero,0.147,147,2278,1,1,0.94,0.806,0.881,2425
bumper,0.147,4,76,1,1,0.385,0.573,0.518,80
commentary,0.147,24,384,1,1,0.602,0.402,0.446,408
motherly,0.147,4,76,1,1,0.927,0.324,0.71,80
approximately,0.147,19,307,1,1,0.622,0.396,0.538,326
flattered,0.147,4,76,1,1,0.865,0.608,0.708,80
manly,0.147,9,153,1,1,0.698,0.633,0.846,162
controller,0.147,9,153,1,1,0.469,0.712,0.868,162
forevermore,0.147,4,76,1,1,0.843,0.425,0.614,80
diminish,0.147,9,153,1,1,0.24,0.357,0.167,162
crash,0.146,70,1093,1,1,0.194,0.906,0.355,1163
monster,0.146,125,1941,1,1,0.133,0.935,0.596,2066
shortly,0.145,25,400,1,1,0.582,0.31,0.36,425
unafraid,0.145,13,215,1,1,0.5,0.52,0.655,228
manipulation,0.145,20,323,1,1,0.188,0.775,0.536,343
stark,0.145,41,647,1,1,0.33,0.63,0.577,688
forward,0.144,653,10099,1,1,0.873,0.412,0.75,10752
slot,0.144,8,138,1,1,0.469,0.337,0.337,146
chart,0.144,26,416,1,1,0.469,0.317,0.33,442
avocado,0.144,8,138,1,1,0.677,0.255,0.287,146
rotation,0.144,8,138,1,1,0.67,0.52,0.55,146
chill,0.143,354,5486,1,1,0.837,0.206,0.482,5840
viable,0.143,12,200,1,1,0.656,0.32,0.667,212
nonexistent,0.143,12,200,1,1,0.208,0.429,0.149,212
shameless,0.143,12,200,1,1,0.274,0.713,0.407,212
crumbling,0.142,16,262,1,1,0.167,0.696,0.308,278
strengthen,0.142,33,525,1,1,0.802,0.796,0.971,558
burnt,0.142,35,556,1,1,0.082,0.713,0.356,591
spoken,0.142,107,1670,1,1,0.551,0.363,0.545,1777
plug,0.142,18,293,1,1,0.531,0.356,0.473,311
world,0.142,6163,95413,1,1,0.622,0.394,0.75,101576
announcement,0.142,26,417,1,1,0.729,0.491,0.482,443
trial,0.141,54,851,1,1,0.438,0.663,0.612,905
discredited,0.14,1,30,1,1,0.112,0.491,0.182,31
squirm,0.14,1,30,1,1,0.235,0.824,0.373,31
burr,0.14,1,30,1,1,0.39,0.426,0.308,31
compile,0.14,1,30,1,1,0.6,0.413,0.519,31
reprise,0.14,1,30,1,1,0.459,0.5,0.464,31
kicker,0.14,3,61,1,1,0.427,0.711,0.614,64
handicapped,0.14,5,92,1,1,0.204,0.467,0.18,97
geographical,0.14,1,30,1,1,0.5,0.317,0.637,31
landlady,0.14,1,30,1,1,0.677,0.303,0.417,31
daft,0.14,9,154,1,1,0.255,0.436,0.157,163
humongous,0.14,1,30,1,1,0.378,0.538,0.536,31
infestation,0.14,1,30,1,1,0.256,0.776,0.527,31
partisanship,0.14,1,30,1,1,0.438,0.566,0.551,31
peanuts,0.14,5,92,1,1,0.542,0.294,0.324,97
sterling,0.14,5,92,1,1,0.529,0.481,0.615,97
caliber,0.14,3,61,1,1,0.429,0.551,0.606,64
identical,0.14,11,185,1,1,0.635,0.38,0.527,196
withholding,0.14,5,92,1,1,0.165,0.49,0.48,97
comma,0.14,3,61,1,1,0.344,0.269,0.242,64
chorus,0.14,27,433,1,1,0.62,0.417,0.5,460
onus,0.14,1,30,1,1,0.562,0.52,0.769,31
aboard,0.14,7,123,1,1,0.698,0.284,0.481,130
jumbo,0.14,1,30,1,1,0.68,0.552,0.447,31
nape,0.14,1,30,1,1,0.427,0.268,0.298,31
bribery,0.14,1,30,1,1,0.135,0.775,0.585,31
damper,0.14,1,30,1,1,0.459,0.378,0.473,31
fringe,0.14,7,123,1,1,0.52,0.387,0.323,130
clothe,0.14,1,30,1,1,0.797,0.33,0.481,31
sanitary,0.14,1,30,1,1,0.458,0.32,0.425,31
impoverished,0.14,3,61,1,1,0.125,0.311,0.203,64
seasoned,0.14,3,61,1,1,0.812,0.57,0.509,64
smug,0.14,13,216,1,1,0.198,0.552,0.587,229
irate,0.14,1,30,1,1,0.188,0.852,0.474,31
truth,0.14,927,14393,1,1,0.971,0.4,0.685,15320
arrogant,0.139,36,573,1,1,0.115,0.755,0.58,609
thrilled,0.139,26,418,1,1,0.898,0.818,0.807,444
cue,0.139,22,356,1,1,0.521,0.433,0.484,378
roman,0.138,27,434,1,1,0.615,0.475,0.639,461
lifelong,0.138,34,543,1,1,0.823,0.33,0.64,577
newly,0.137,21,341,1,1,0.688,0.422,0.552,362
foolishness,0.137,10,170,1,1,0.235,0.472,0.173,180
lesson,0.137,165,2580,1,1,0.704,0.577,0.593,2745
usual,0.137,180,2815,1,1,0.625,0.221,0.4,2995
web,0.136,38,606,1,1,0.583,0.411,0.519,644
transition,0.136,50,793,1,1,0.605,0.561,0.558,843
oatmeal,0.136,6,108,1,1,0.592,0.192,0.241,114
firm,0.136,69,1089,1,1,0.635,0.38,0.728,1158
horseman,0.136,6,108,1,1,0.441,0.7,0.676,114
slightly,0.135,133,2087,1,1,0.47,0.274,0.255,2220
average,0.135,90,1417,1,1,0.684,0.28,0.455,1507
arguments,0.135,35,560,1,1,0.541,0.602,0.657,595
snowflake,0.135,11,186,1,1,0.748,0.192,0.26,197
raging,0.135,33,529,1,1,0.219,0.927,0.598,562
calls,0.134,288,4505,1,1,0.608,0.431,0.551,4793
rental,0.134,9,155,1,1,0.51,0.37,0.308,164
cabbage,0.134,4,77,1,1,0.398,0.225,0.264,81
rumble,0.134,4,77,1,1,0.367,0.745,0.613,81
gluten,0.134,4,77,1,1,0.385,0.308,0.388,81
imp,0.134,4,77,1,1,0.35,0.448,0.42,81
despondent,0.134,4,77,1,1,0.133,0.378,0.221,81
crust,0.134,4,77,1,1,0.542,0.337,0.456,81
spiked,0.134,4,77,1,1,0.281,0.613,0.407,81
stunned,0.134,9,155,1,1,0.306,0.663,0.356,164
tactical,0.134,4,77,1,1,0.594,0.481,0.684,81
continuing,0.133,50,795,1,1,0.667,0.5,0.52,845
teen,0.133,86,1357,1,1,0.729,0.531,0.568,1443
lemon,0.133,17,280,1,1,0.596,0.317,0.316,297
model,0.133,82,1295,1,1,0.607,0.388,0.723,1377
negative,0.133,356,5574,1,1,0.102,0.527,0.176,5930
believer,0.133,33,530,1,1,0.725,0.445,0.564,563
red,0.132,411,6436,1,1,0.427,0.385,0.377,6847
belated,0.132,7,124,1,1,0.24,0.4,0.214,131
setup,0.132,15,249,1,1,0.667,0.398,0.635,264
dish,0.132,23,374,1,1,0.552,0.255,0.264,397
shrimp,0.132,7,124,1,1,0.571,0.361,0.425,131
boot,0.132,18,296,1,1,0.438,0.65,0.625,314
plain,0.132,62,984,1,1,0.5,0.167,0.311,1046
lowering,0.132,10,171,1,1,0.286,0.363,0.236,181
install,0.132,10,171,1,1,0.63,0.583,0.736,181
salon,0.132,10,171,1,1,0.531,0.296,0.463,181
agreed,0.132,131,2063,1,1,0.797,0.449,0.574,2194
stink,0.131,13,218,1,1,0.042,0.481,0.18,231
understood,0.131,265,4160,1,1,0.78,0.441,0.686,4425
humbled,0.131,13,218,1,1,0.28,0.618,0.198,231
dozen,0.131,30,484,1,1,0.583,0.343,0.425,514
miserably,0.131,16,265,1,1,0.28,0.545,0.15,281
effort,0.13,262,4116,1,1,0.698,0.778,0.858,4378
nowadays,0.13,142,2238,1,1,0.68,0.346,0.4,2380
drinks,0.13,84,1330,1,1,0.729,0.656,0.412,1414
swerve,0.13,2,46,1,1,0.276,0.612,0.357,48
expertise,0.13,8,140,1,1,0.792,0.589,0.925,148
tickled,0.13,2,46,1,1,0.755,0.707,0.364,48
recruiting,0.13,5,93,1,1,0.448,0.787,0.693,98
saliva,0.13,2,46,1,1,0.214,0.265,0.236,48
creeper,0.13,5,93,1,1,0.429,0.558,0.366,98
rainbows,0.13,14,234,1,1,0.875,0.517,0.402,248
digestive,0.13,2,46,1,1,0.542,0.413,0.434,48
bargaining,0.13,2,46,1,1,0.622,0.64,0.642,48
continuously,0.13,35,563,1,1,0.719,0.417,0.702,598
jumpy,0.13,5,93,1,1,0.353,0.81,0.216,98
drive,0.129,450,7071,1,1,0.625,0.689,0.713,7521
thumb,0.129,21,344,1,1,0.673,0.271,0.361,365
careless,0.129,18,297,1,1,0.255,0.431,0.125,315
jersey,0.128,31,501,1,1,0.594,0.317,0.411,532
bee,0.128,28,454,1,1,0.52,0.509,0.309,482
stereotype,0.128,9,156,1,1,0.151,0.422,0.612,165
throne,0.127,84,1334,1,1,0.724,0.606,0.887,1418
diamond,0.127,33,533,1,1,0.91,0.606,0.769,566
allot,0.127,6,109,1,1,0.622,0.481,0.616,115
educational,0.127,13,219,1,1,0.745,0.457,0.764,232
public,0.127,629,9900,1,1,0.592,0.51,0.664,10529
sport,0.126,56,895,1,1,0.865,0.7,0.657,951
rushing,0.126,35,565,1,1,0.398,0.821,0.529,600
alpha,0.126,28,455,1,1,0.708,0.34,0.755,483
tab,0.126,10,172,1,1,0.594,0.208,0.308,182
clap,0.126,21,345,1,1,0.779,0.731,0.529,366
drawer,0.126,10,172,1,1,0.429,0.196,0.292,182
temper,0.125,29,471,1,1,0.633,0.623,0.818,500
rank,0.125,18,298,1,1,0.531,0.38,0.686,316
maid,0.125,18,298,1,1,0.406,0.324,0.3,316
surprise,0.125,137,2171,1,1,0.875,0.875,0.562,2308
tail,0.125,26,424,1,1,0.48,0.272,0.293,450
covered,0.124,83,1322,1,1,0.562,0.34,0.644,1405
domino,0.124,3,62,1,1,0.594,0.51,0.473,65
degrading,0.124,7,125,1,1,0.031,0.583,0.232,132
voodoo,0.124,3,62,1,1,0.188,0.6,0.453,65
brotherly,0.124,3,62,1,1,0.865,0.306,0.596,65
carpool,0.124,3,62,1,1,0.625,0.509,0.5,65
assuredly,0.124,3,62,1,1,0.786,0.396,0.833,65
impatient,0.124,15,251,1,1,0.25,0.708,0.429,266
tech,0.124,70,1118,1,1,0.684,0.491,0.732,1188
frightening,0.123,42,677,1,1,0.122,0.969,0.625,719
poke,0.123,12,204,1,1,0.365,0.713,0.475,216
hotel,0.123,235,3721,1,1,0.74,0.37,0.407,3956
terms,0.123,215,3406,1,1,0.49,0.362,0.645,3621
devastation,0.123,8,141,1,1,0.09,0.904,0.472,149
chord,0.123,8,141,1,1,0.729,0.394,0.539,149
numerous,0.122,40,646,1,1,0.622,0.462,0.609,686
scores,0.122,13,220,1,1,0.594,0.469,0.629,233
expense,0.122,18,299,1,1,0.317,0.451,0.377,317
chased,0.122,18,299,1,1,0.188,0.83,0.287,317
ringing,0.122,42,678,1,1,0.724,0.598,0.693,720
unified,0.121,4,78,1,1,0.729,0.439,0.764,82
harmless,0.121,9,157,1,1,0.625,0.226,0.241,166
nosey,0.121,4,78,1,1,0.276,0.655,0.223,82
plea,0.121,14,236,1,1,0.633,0.491,0.517,250
elated,0.121,4,78,1,1,0.792,0.96,0.725,82
highway,0.121,30,489,1,1,0.64,0.583,0.425,519
bar,0.121,249,3951,1,1,0.5,0.531,0.481,4200
splitting,0.12,10,173,1,1,0.188,0.598,0.375,183
tear,0.12,129,2056,1,1,0.404,0.62,0.327,2185
foolish,0.12,39,632,1,1,0.316,0.255,0.109,671
corner,0.119,309,4907,1,1,0.4,0.296,0.366,5216
toothbrush,0.119,5,94,1,1,0.517,0.33,0.321,99
imbecile,0.119,5,94,1,1,0.082,0.569,0.26,99
wacky,0.119,5,94,1,1,0.153,0.72,0.321,99
december,0.119,137,2185,1,1,0.74,0.54,0.464,2322
bring,0.119,980,15539,1,1,0.635,0.46,0.462,16519
typical,0.118,50,807,1,1,0.635,0.206,0.426,857
lock,0.118,141,2249,1,1,0.271,0.585,0.6,2390
attention,0.118,763,12106,1,1,0.74,0.599,0.774,12869
insist,0.118,32,522,1,1,0.635,0.651,0.688,554
opposition,0.118,39,633,1,1,0.135,0.729,0.592,672
little,0.118,2922,46333,1,1,0.385,0.16,0.213,49255
wall,0.118,353,5611,1,1,0.417,0.25,0.509,5964
bikini,0.118,6,110,1,1,0.73,0.639,0.353,116
arms,0.117,391,6220,1,1,0.464,0.395,0.483,6611
shift,0.116,142,2269,1,1,0.479,0.61,0.491,2411
instructor,0.116,7,126,1,1,0.771,0.49,0.782,133
tub,0.116,31,507,1,1,0.449,0.235,0.265,538
delta,0.116,7,126,1,1,0.551,0.343,0.509,133
nap,0.116,104,1666,1,1,0.66,0.098,0.342,1770
unable,0.116,142,2271,1,1,0.132,0.459,0.193,2413
pantry,0.116,8,142,1,1,0.622,0.294,0.312,150
turned,0.115,417,6643,1,1,0.63,0.538,0.583,7060
propose,0.115,18,301,1,1,0.604,0.72,0.71,319
cherry,0.114,31,508,1,1,0.688,0.186,0.25,539
cruise,0.114,21,349,1,1,0.74,0.442,0.683,370
countdown,0.113,12,206,1,1,0.438,0.692,0.49,218
greedy,0.113,25,413,1,1,0.125,0.66,0.476,438
improve,0.113,106,1703,1,1,0.833,0.528,0.815,1809
snack,0.113,26,429,1,1,0.646,0.407,0.345,455
spy,0.113,13,222,1,1,0.26,0.686,0.53,235
scene,0.113,246,3934,1,1,0.57,0.34,0.578,4180
drinking,0.113,305,4874,1,1,0.562,0.459,0.317,5179
obsessive,0.113,14,238,1,1,0.219,0.823,0.48,252
dictator,0.113,14,238,1,1,0.073,0.76,0.862,252
needles,0.113,14,238,1,1,0.25,0.602,0.348,252
meet,0.113,1115,17783,1,1,0.76,0.51,0.58,18898
uplifting,0.113,30,493,1,1,0.771,0.548,0.605,523
offices,0.113,15,254,1,1,0.469,0.312,0.534,269
heartbreak,0.112,81,1306,1,1,0.208,0.61,0.245,1387
criticize,0.112,16,270,1,1,0.143,0.708,0.473,286
orphan,0.112,19,318,1,1,0.133,0.388,0.14,337
table,0.112,250,4003,1,1,0.551,0.17,0.284,4253
crushed,0.11,43,702,1,1,0.167,0.647,0.3,745
smiles,0.11,134,2156,1,1,0.892,0.606,0.607,2290
stream,0.11,213,3419,1,1,0.449,0.537,0.559,3632
loud,0.109,547,8761,1,1,0.573,0.65,0.87,9308
awesomeness,0.109,5,95,1,1,0.917,0.647,0.927,100
artillery,0.109,1,31,1,1,0.35,0.912,0.794,32
widower,0.109,3,63,1,1,0.184,0.406,0.325,66
disk,0.109,3,63,1,1,0.573,0.423,0.412,66
prudent,0.109,2,47,1,1,0.706,0.25,0.657,49
verbatim,0.109,2,47,1,1,0.562,0.255,0.574,49
legalized,0.109,1,31,1,1,0.76,0.44,0.855,32
marine,0.109,14,239,1,1,0.633,0.471,0.679,253
anointed,0.109,3,63,1,1,0.5,0.368,0.579,66
timetable,0.109,2,47,1,1,0.561,0.189,0.491,49
mattress,0.109,16,271,1,1,0.612,0.255,0.397,287
antiquated,0.109,1,31,1,1,0.42,0.392,0.236,32
principal,0.109,10,175,1,1,0.65,0.353,0.709,185
unwittingly,0.109,1,31,1,1,0.312,0.51,0.264,32
indebted,0.109,2,47,1,1,0.138,0.698,0.275,49
pox,0.109,1,31,1,1,0.235,0.567,0.309,32
gooood,0.109,4,79,1,1,0.857,0.652,0.547,83
heated,0.109,13,223,1,1,0.479,0.497,0.542,236
opinionated,0.109,4,79,1,1,0.156,0.8,0.491,83
uninspired,0.109,3,63,1,1,0.163,0.243,0.26,66
faulty,0.109,5,95,1,1,0.184,0.52,0.378,100
assumed,0.109,37,607,1,1,0.612,0.247,0.454,644
lever,0.109,2,47,1,1,0.4,0.343,0.402,49
diagnostic,0.109,1,31,1,1,0.417,0.483,0.635,32
numbering,0.109,1,31,1,1,0.51,0.363,0.482,32
knob,0.109,4,79,1,1,0.34,0.36,0.272,83
barbaric,0.109,5,95,1,1,0.235,0.798,0.738,100
catfish,0.109,5,95,1,1,0.458,0.337,0.296,100
volleyball,0.109,5,95,1,1,0.64,0.7,0.458,100
mandate,0.109,7,127,1,1,0.448,0.67,0.779,134
latex,0.109,1,31,1,1,0.479,0.413,0.325,32
insufficient,0.109,4,79,1,1,0.188,0.38,0.093,83
oppression,0.109,18,303,1,1,0.08,0.673,0.615,321
dandy,0.109,5,95,1,1,0.673,0.52,0.63,100
stillborn,0.109,1,31,1,1,0.271,0.519,0.337,32
pouch,0.109,1,31,1,1,0.438,0.23,0.271,32
stepfather,0.109,4,79,1,1,0.396,0.491,0.611,83
atheism,0.109,4,79,1,1,0.276,0.46,0.481,83
malarkey,0.109,2,47,1,1,0.396,0.5,0.465,49
rife,0.109,3,63,1,1,0.57,0.561,0.692,66
demonstrating,0.109,3,63,1,1,0.698,0.571,0.693,66
skyscraper,0.109,1,31,1,1,0.622,0.696,0.798,32
misrepresented,0.109,1,31,1,1,0.042,0.519,0.466,32
sew,0.109,7,127,1,1,0.51,0.34,0.34,134
melee,0.109,3,63,1,1,0.541,0.704,0.611,66
scone,0.109,3,63,1,1,0.418,0.287,0.229,66
experienced,0.107,274,4404,1,1,0.771,0.613,0.914,4678
highlight,0.107,36,592,1,1,0.844,0.637,0.882,628
hearts,0.106,279,4491,1,1,0.948,0.592,0.634,4770
band,0.106,135,2181,1,1,0.648,0.552,0.525,2316
define,0.106,89,1443,1,1,0.688,0.415,0.632,1532
muscle,0.105,19,320,1,1,0.359,0.49,0.645,339
meantime,0.105,35,577,1,1,0.432,0.222,0.3,612
sleeve,0.105,15,256,1,1,0.531,0.27,0.273,271
punished,0.104,26,433,1,1,0.177,0.735,0.481,459
certified,0.104,12,208,1,1,0.781,0.422,0.806,220
fireworks,0.103,23,385,1,1,0.735,0.863,0.579,408
nerdy,0.103,10,176,1,1,0.296,0.255,0.292,186
unfulfilled,0.103,10,176,1,1,0.184,0.426,0.268,186
dreamt,0.103,20,337,1,1,0.812,0.38,0.518,357
hot,0.102,385,6214,1,1,0.49,0.74,0.573,6599
resist,0.102,58,949,1,1,0.414,0.676,0.651,1007
moral,0.102,94,1529,1,1,0.7,0.459,0.796,1623
scarf,0.102,8,144,1,1,0.75,0.224,0.224,152
disregard,0.102,17,289,1,1,0.177,0.647,0.308,306
negativity,0.101,119,1933,1,1,0.06,0.52,0.273,2052
transportation,0.101,16,273,1,1,0.667,0.56,0.472,289
needless,0.101,15,257,1,1,0.327,0.385,0.2,272
filthy,0.101,23,386,1,1,0.115,0.714,0.321,409
sunglasses,0.101,7,128,1,1,0.844,0.443,0.364,135
emotional,0.1,535,8646,1,1,0.779,0.714,0.526,9181
radiation,0.1,6,112,1,1,0.167,0.741,0.536,118
kettle,0.1,13,225,1,1,0.357,0.497,0.333,238
sliver,0.1,6,112,1,1,0.388,0.347,0.291,118
keyboard,0.1,27,451,1,1,0.573,0.279,0.349,478
bereaved,0.1,6,112,1,1,0.104,0.479,0.221,118
robin,0.099,53,871,1,1,0.552,0.363,0.393,924
criticism,0.099,39,645,1,1,0.115,0.563,0.505,684
truck,0.099,57,936,1,1,0.531,0.368,0.546,993
trade,0.099,100,1631,1,1,0.561,0.544,0.69,1731
neck,0.099,100,1631,1,1,0.541,0.245,0.345,1731
warning,0.099,74,1211,1,1,0.229,0.774,0.629,1285
bugger,0.098,5,96,1,1,0.312,0.627,0.474,101
ecosystem,0.098,5,96,1,1,0.729,0.259,0.633,101
bugged,0.098,5,96,1,1,0.561,0.439,0.5,101
secondary,0.098,17,290,1,1,0.636,0.375,0.26,307
baseball,0.098,35,581,1,1,0.66,0.76,0.563,616
reckon,0.098,23,387,1,1,0.643,0.42,0.472,410
appreciated,0.098,174,2829,1,1,0.91,0.434,0.779,3003
repeat,0.098,161,2619,1,1,0.49,0.529,0.552,2780
subscribe,0.098,16,274,1,1,0.66,0.344,0.591,290
awards,0.098,27,452,1,1,0.958,0.736,0.652,479
belly,0.097,30,501,1,1,0.51,0.388,0.387,531
irritated,0.096,55,906,1,1,0.21,0.816,0.281,961
spike,0.096,9,161,1,1,0.382,0.51,0.408,170
helm,0.096,4,80,1,1,0.511,0.45,0.615,84
unaccompanied,0.096,4,80,1,1,0.292,0.376,0.297,84
reopen,0.096,4,80,1,1,0.656,0.528,0.568,84
clubs,0.096,34,566,1,1,0.723,0.53,0.591,600
sector,0.096,14,242,1,1,0.594,0.19,0.569,256
kinky,0.096,9,161,1,1,0.449,0.558,0.361,170
puzzled,0.096,4,80,1,1,0.204,0.5,0.272,84
scrambling,0.096,4,80,1,1,0.421,0.81,0.731,84
thunder,0.096,43,712,1,1,0.296,0.916,0.526,755
walk,0.096,1339,21715,1,1,0.643,0.412,0.45,23054
match,0.096,159,2592,1,1,0.599,0.573,0.5,2751
cutting,0.096,100,1636,1,1,0.448,0.375,0.536,1736
standing,0.095,451,7327,1,1,0.604,0.317,0.425,7778
interest,0.095,238,3874,1,1,0.78,0.667,0.618,4112
hanging,0.094,265,4316,1,1,0.378,0.471,0.389,4581
polo,0.093,3,64,1,1,0.582,0.36,0.415,67
hart,0.093,7,129,1,1,0.643,0.389,0.447,136
algebra,0.093,3,64,1,1,0.44,0.34,0.565,67
inane,0.093,3,64,1,1,0.271,0.35,0.268,67
comparable,0.093,11,194,1,1,0.562,0.443,0.458,205
degraded,0.093,3,64,1,1,0.167,0.433,0.205,67
mockery,0.093,7,129,1,1,0.094,0.806,0.181,136
bummer,0.093,15,259,1,1,0.163,0.5,0.267,274
foil,0.093,3,64,1,1,0.312,0.204,0.342,67
farce,0.093,7,129,1,1,0.265,0.667,0.246,136
cutter,0.093,3,64,1,1,0.427,0.731,0.583,67
hometown,0.093,39,649,1,1,0.858,0.333,0.605,688
incompatible,0.093,3,64,1,1,0.196,0.5,0.31,67
escort,0.093,11,194,1,1,0.729,0.48,0.608,205
mitigate,0.093,3,64,1,1,0.506,0.427,0.456,67
refer,0.092,29,487,1,1,0.506,0.358,0.558,516
lizard,0.092,10,178,1,1,0.378,0.375,0.324,188
name,0.091,911,14843,1,1,0.573,0.3,0.415,15754
fears,0.091,259,4231,1,1,0.061,0.821,0.306,4490
alien,0.091,69,1139,1,1,0.41,0.615,0.491,1208
demonstrated,0.091,6,113,1,1,0.617,0.5,0.649,119
stutter,0.091,6,113,1,1,0.25,0.469,0.258,119
vary,0.091,6,113,1,1,0.521,0.373,0.413,119
apply,0.091,68,1123,1,1,0.612,0.321,0.667,1191
speed,0.091,68,1123,1,1,0.719,0.849,0.658,1191
crime,0.091,143,2345,1,1,0.071,0.943,0.63,2488
swim,0.09,91,1498,1,1,0.688,0.461,0.529,1589
popular,0.09,120,1971,1,1,0.88,0.676,0.731,2091
idiocy,0.09,9,162,1,1,0.112,0.635,0.137,171
conspiracy,0.09,42,700,1,1,0.125,0.787,0.652,742
visible,0.09,38,635,1,1,0.75,0.342,0.509,673
sensible,0.089,21,358,1,1,0.625,0.454,0.312,379
unlikely,0.089,24,407,1,1,0.271,0.293,0.245,431
smelly,0.088,8,146,1,1,0.1,0.528,0.245,154
speculation,0.088,5,97,1,1,0.325,0.683,0.394,102
cult,0.088,44,734,1,1,0.448,0.535,0.648,778
burst,0.088,47,783,1,1,0.156,0.894,0.845,830
imaging,0.088,2,48,1,1,0.724,0.394,0.482,50
maternity,0.088,5,97,1,1,0.865,0.48,0.622,102
heater,0.088,11,195,1,1,0.5,0.573,0.538,206
solve,0.088,92,1518,1,1,0.656,0.53,0.688,1610
quirk,0.088,5,97,1,1,0.49,0.384,0.618,102
retail,0.088,20,342,1,1,0.51,0.353,0.411,362
unimpressed,0.088,2,48,1,1,0.198,0.302,0.327,50
hide,0.088,389,6371,1,1,0.438,0.51,0.218,6760
employment,0.087,16,277,1,1,0.75,0.594,0.611,293
motivating,0.087,13,228,1,1,0.958,0.82,0.787,241
rubber,0.086,10,179,1,1,0.46,0.217,0.315,189
woohoo,0.086,10,179,1,1,0.658,0.67,0.451,189
smaller,0.085,68,1129,1,1,0.3,0.31,0.179,1197
dumpster,0.085,12,212,1,1,0.229,0.418,0.101,224
thunderstorm,0.085,12,212,1,1,0.135,0.86,0.784,224
teeth,0.085,79,1310,1,1,0.52,0.388,0.427,1389
roughly,0.085,17,294,1,1,0.448,0.539,0.463,311
corporate,0.084,32,540,1,1,0.592,0.454,0.745,572
psychotic,0.084,14,245,1,1,0.198,0.856,0.474,259
filler,0.084,4,81,1,1,0.531,0.347,0.529,85
coherent,0.084,4,81,1,1,0.698,0.281,0.5,85
resemblance,0.084,4,81,1,1,0.743,0.216,0.57,85
guide,0.084,171,2820,1,1,0.688,0.315,0.62,2991
forehead,0.084,36,606,1,1,0.47,0.308,0.556,642
binge,0.083,70,1164,1,1,0.304,0.65,0.5,1234
parking,0.083,72,1197,1,1,0.777,0.469,0.51,1269
plastic,0.083,47,787,1,1,0.49,0.269,0.32,834
salad,0.083,30,508,1,1,0.75,0.26,0.307,538
nick,0.083,68,1132,1,1,0.554,0.388,0.387,1200
pavement,0.082,6,114,1,1,0.46,0.353,0.475,120
unsatisfied,0.082,6,114,1,1,0.2,0.547,0.241,120
general,0.082,287,4731,1,1,0.834,0.484,0.853,5018
keeping,0.082,348,5734,1,1,0.592,0.28,0.723,6082
avoid,0.082,418,6885,1,1,0.427,0.442,0.415,7303
bloke,0.082,15,262,1,1,0.45,0.479,0.545,277
layout,0.081,8,147,1,1,0.615,0.442,0.557,155
programme,0.081,17,295,1,1,0.74,0.298,0.537,312
bio,0.081,55,920,1,1,0.612,0.225,0.49,975
empathy,0.081,106,1759,1,1,0.729,0.349,0.545,1865
cut,0.081,454,7485,1,1,0.49,0.49,0.393,7939
sarcastic,0.081,21,361,1,1,0.397,0.781,0.298,382
alcoholism,0.081,10,180,1,1,0.061,0.779,0.407,190
rampant,0.08,12,213,1,1,0.49,0.788,0.526,225
assumption,0.079,20,345,1,1,0.479,0.431,0.417,365
cover,0.079,191,3163,1,1,0.365,0.24,0.471,3354
polite,0.079,26,444,1,1,0.927,0.378,0.562,470
credit,0.079,107,1779,1,1,0.673,0.549,0.648,1886
dread,0.079,71,1186,1,1,0.153,0.792,0.368,1257
sign,0.078,305,5046,1,1,0.62,0.481,0.397,5351
important,0.078,1607,26525,1,1,0.827,0.63,0.836,28132
riots,0.078,3,65,1,1,0.099,0.882,0.564,68
geriatric,0.078,1,32,1,1,0.479,0.247,0.436,33
munchkin,0.078,1,32,1,1,0.49,0.466,0.374,33
expert,0.078,37,626,1,1,0.776,0.646,0.911,663
divide,0.078,29,494,1,1,0.333,0.52,0.417,523
disarm,0.078,1,32,1,1,0.292,0.528,0.613,33
drool,0.078,3,65,1,1,0.385,0.398,0.204,68
crud,0.078,1,32,1,1,0.312,0.33,0.444,33
arena,0.078,27,461,1,1,0.51,0.235,0.404,488
gingerbread,0.078,1,32,1,1,0.597,0.333,0.264,33
rewind,0.078,11,197,1,1,0.46,0.551,0.431,208
cub,0.078,3,65,1,1,0.646,0.382,0.284,68
morale,0.078,5,98,1,1,0.729,0.158,0.792,103
unidentified,0.078,1,32,1,1,0.385,0.361,0.199,33
subordinate,0.078,1,32,1,1,0.276,0.392,0.121,33
thankless,0.078,1,32,1,1,0.146,0.5,0.497,33
intestines,0.078,1,32,1,1,0.292,0.547,0.398,33
leeches,0.078,3,65,1,1,0.115,0.698,0.295,68
restock,0.078,1,32,1,1,0.51,0.538,0.645,33
demolish,0.078,1,32,1,1,0.125,0.632,0.7,33
patriarchal,0.078,5,98,1,1,0.531,0.5,0.857,103
veer,0.078,1,32,1,1,0.469,0.43,0.338,33
staunch,0.078,3,65,1,1,0.48,0.363,0.833,68
indefensible,0.078,1,32,1,1,0.173,0.647,0.484,33
cupping,0.078,1,32,1,1,0.49,0.61,0.402,33
seasoning,0.078,1,32,1,1,0.633,0.388,0.479,33
consumer,0.078,9,164,1,1,0.507,0.551,0.677,173
replay,0.078,15,263,1,1,0.612,0.522,0.761,278
rapping,0.078,7,131,1,1,0.565,0.716,0.417,138
pushover,0.078,1,32,1,1,0.347,0.558,0.375,33
stroller,0.078,1,32,1,1,0.786,0.398,0.314,33
hypnosis,0.078,1,32,1,1,0.417,0.41,0.546,33
kickoff,0.078,1,32,1,1,0.583,0.6,0.629,33
gemini,0.077,40,676,1,1,0.531,0.32,0.327,716
excited,0.077,456,7549,1,1,0.908,0.931,0.709,8005
rub,0.076,39,660,1,1,0.521,0.565,0.4,699
betty,0.076,14,247,1,1,0.542,0.358,0.381,261
scratch,0.075,32,545,1,1,0.276,0.625,0.27,577
weekly,0.075,46,777,1,1,0.622,0.288,0.38,823
friendless,0.074,33,562,1,1,0.102,0.36,0.204,595
incredible,0.074,197,3278,1,1,0.857,0.796,0.902,3475
presentation,0.074,22,380,1,1,0.792,0.604,0.553,402
liking,0.074,162,2700,1,1,0.963,0.604,0.589,2862
stoop,0.074,6,115,1,1,0.49,0.43,0.284,121
grief,0.073,212,3529,1,1,0.07,0.64,0.474,3741
relevant,0.073,46,778,1,1,0.719,0.608,0.764,824
khan,0.073,18,314,1,1,0.463,0.476,0.529,332
generic,0.073,11,198,1,1,0.52,0.357,0.422,209
temporary,0.073,182,3034,1,1,0.458,0.415,0.324,3216
boarding,0.072,19,331,1,1,0.531,0.402,0.534,350
hog,0.072,4,82,1,1,0.317,0.509,0.271,86
population,0.071,75,1261,1,1,0.615,0.423,0.667,1336
cheeks,0.071,45,763,1,1,0.708,0.324,0.282,808
executive,0.071,17,298,1,1,0.704,0.449,0.894,315
caused,0.071,123,2060,1,1,0.344,0.52,0.382,2183
amazed,0.07,36,614,1,1,0.796,0.779,0.533,650
sigh,0.07,216,3608,1,1,0.469,0.387,0.273,3824
sports,0.069,82,1381,1,1,0.833,0.683,0.587,1463
survive,0.068,326,5446,1,1,0.77,0.824,0.726,5772
comedy,0.068,49,832,1,1,0.918,0.555,0.49,881
captain,0.068,67,1132,1,1,0.552,0.653,0.966,1199
napkin,0.068,2,49,1,1,0.469,0.142,0.209,51
snappy,0.068,2,49,1,1,0.573,0.592,0.418,51
mitt,0.068,2,49,1,1,0.406,0.183,0.264,51
centipede,0.068,2,49,1,1,0.296,0.399,0.361,51
documents,0.068,11,199,1,1,0.53,0.25,0.587,210
protein,0.068,5,99,1,1,0.75,0.337,0.654,104
nil,0.068,2,49,1,1,0.286,0.143,0.157,51
motivational,0.068,14,249,1,1,0.906,0.646,0.858,263
missile,0.068,2,49,1,1,0.24,0.83,0.764,51
hoop,0.068,2,49,1,1,0.635,0.204,0.315,51
distract,0.068,95,1599,1,1,0.241,0.609,0.336,1694
commendable,0.068,2,49,1,1,0.786,0.57,0.555,51
trifle,0.068,2,49,1,1,0.271,0.296,0.221,51
misuse,0.068,5,99,1,1,0.083,0.56,0.196,104
unwillingness,0.068,2,49,1,1,0.204,0.311,0.113,51
bake,0.067,24,416,1,1,0.867,0.418,0.519,440
physics,0.067,15,266,1,1,0.582,0.415,0.664,281
previous,0.066,77,1301,1,1,0.521,0.337,0.348,1378
earn,0.066,45,767,1,1,0.865,0.769,0.817,812
bathroom,0.066,307,5142,1,1,0.561,0.283,0.345,5449
electricity,0.065,30,517,1,1,0.698,0.81,0.733,547
pointless,0.065,61,1035,1,1,0.055,0.353,0.111,1096
back,0.065,5595,93531,1,1,0.438,0.353,0.336,99126
dysfunction,0.065,6,116,1,1,0.156,0.41,0.386,122
cowardly,0.065,13,233,1,1,0.102,0.385,0.127,246
clarification,0.065,6,116,1,1,0.802,0.461,0.613,122
initial,0.065,24,417,1,1,0.583,0.314,0.539,441
represented,0.065,24,417,1,1,0.724,0.444,0.688,441
inconvenient,0.064,10,183,1,1,0.224,0.61,0.375,193
unit,0.063,46,786,1,1,0.562,0.235,0.578,832
opposing,0.063,11,200,1,1,0.188,0.66,0.518,211
insert,0.063,27,468,1,1,0.481,0.552,0.519,495
hacker,0.063,3,66,1,1,0.271,0.755,0.74,69
visibly,0.063,7,133,1,1,0.724,0.373,0.591,140
buyer,0.063,3,66,1,1,0.613,0.519,0.649,69
obedient,0.063,3,66,1,1,0.8,0.179,0.518,69
dissociation,0.063,3,66,1,1,0.135,0.555,0.471,69
pork,0.063,7,133,1,1,0.37,0.45,0.333,140
carrying,0.062,74,1256,1,1,0.656,0.557,0.443,1330
puts,0.062,130,2195,1,1,0.428,0.407,0.369,2325
example,0.061,189,3186,1,1,0.542,0.337,0.51,3375
words,0.061,1458,24473,1,1,0.71,0.216,0.473,25931
hint,0.061,44,754,1,1,0.602,0.33,0.517,798
revolving,0.061,8,150,1,1,0.602,0.57,0.58,158
rollercoaster,0.061,22,385,1,1,0.802,0.91,0.651,407
lovable,0.061,13,234,1,1,0.948,0.335,0.565,247
absurdity,0.06,4,83,1,1,0.115,0.528,0.227,87
amends,0.06,4,83,1,1,0.64,0.366,0.517,87
assist,0.059,30,520,1,1,0.833,0.435,0.629,550
bell,0.058,58,992,1,1,0.552,0.51,0.505,1050
longtime,0.058,5,100,1,1,0.362,0.442,0.546,105
offence,0.058,11,201,1,1,0.312,0.798,0.446,212
choreography,0.058,5,100,1,1,0.812,0.75,0.547,105
unattended,0.058,5,100,1,1,0.255,0.4,0.167,105
judgment,0.058,47,807,1,1,0.396,0.6,0.816,854
peas,0.058,5,100,1,1,0.542,0.283,0.31,105
lie,0.057,513,8655,1,1,0.13,0.725,0.272,9168
carter,0.057,12,218,1,1,0.312,0.48,0.431,230
seriousness,0.057,19,336,1,1,0.439,0.365,0.75,355
heart,0.057,3281,55311,1,1,0.827,0.5,0.693,58592
snatch,0.056,6,117,1,1,0.219,0.861,0.691,123
piper,0.056,6,117,1,1,0.569,0.442,0.398,123
ethic,0.056,6,117,1,1,0.786,0.26,0.791,123
kidnapping,0.056,6,117,1,1,0.094,0.88,0.561,123
basic,0.056,97,1652,1,1,0.643,0.102,0.395,1749
plane,0.056,83,1416,1,1,0.51,0.356,0.386,1499
realization,0.055,107,1822,1,1,0.554,0.51,0.836,1929
main,0.055,269,4557,1,1,0.667,0.51,0.811,4826
destroy,0.055,177,3004,1,1,0.046,0.935,0.635,3181
type,0.055,591,9996,1,1,0.5,0.284,0.364,10587
sow,0.055,8,151,1,1,0.667,0.43,0.446,159
untrue,0.054,9,168,1,1,0.031,0.5,0.188,177
respectful,0.054,29,506,1,1,0.951,0.386,0.814,535
cane,0.053,10,185,1,1,0.459,0.298,0.398,195
unfit,0.053,11,202,1,1,0.25,0.368,0.185,213
approved,0.052,14,253,1,1,0.833,0.349,0.698,267
exhale,0.052,14,253,1,1,0.542,0.49,0.411,267
contest,0.052,15,270,1,1,0.667,0.698,0.717,285
hood,0.051,33,575,1,1,0.357,0.459,0.306,608
hesitant,0.051,18,321,1,1,0.333,0.542,0.321,339
middle,0.05,474,8055,1,1,0.458,0.157,0.3,8529
lay,0.05,284,4833,1,1,0.521,0.336,0.491,5117
able,0.05,1431,24293,1,1,0.786,0.5,0.81,25724
top,0.049,542,9217,1,1,0.76,0.4,0.554,9759
loveee,0.048,7,135,1,1,0.927,0.592,0.693,142
disqualify,0.048,1,33,1,1,0.208,0.595,0.267,34
oath,0.048,20,356,1,1,0.543,0.615,0.824,376
protest,0.048,45,781,1,1,0.14,0.889,0.596,826
feeder,0.048,1,33,1,1,0.604,0.452,0.713,34
beanie,0.048,2,50,1,1,0.5,0.23,0.263,52
probation,0.048,3,67,1,1,0.206,0.635,0.44,70
rivalry,0.048,2,50,1,1,0.192,0.765,0.538,52
kneeling,0.048,4,84,1,1,0.245,0.435,0.144,88
gaff,0.048,2,50,1,1,0.333,0.418,0.429,52
reaffirm,0.048,2,50,1,1,0.75,0.559,0.654,52
compatibility,0.048,3,67,1,1,0.816,0.45,0.673,70
handyman,0.048,1,33,1,1,0.66,0.373,0.393,34
impaired,0.048,4,84,1,1,0.13,0.459,0.269,88
pensioner,0.048,2,50,1,1,0.44,0.245,0.442,52
unload,0.048,5,101,1,1,0.656,0.639,0.573,106
persuade,0.048,6,118,1,1,0.62,0.618,0.709,124
scifi,0.048,1,33,1,1,0.592,0.57,0.394,34
shifty,0.048,1,33,1,1,0.365,0.687,0.483,34
expo,0.048,3,67,1,1,0.61,0.562,0.5,70
negro,0.048,2,50,1,1,0.354,0.368,0.461,52
thong,0.048,2,50,1,1,0.467,0.596,0.269,52
defective,0.048,4,84,1,1,0.122,0.58,0.274,88
shithead,0.048,4,84,1,1,0.12,0.645,0.302,88
vert,0.048,1,33,1,1,0.49,0.375,0.434,34
inbred,0.048,1,33,1,1,0.397,0.52,0.473,34
blueberry,0.048,2,50,1,1,0.656,0.185,0.365,52
wiring,0.048,1,33,1,1,0.49,0.367,0.431,34
differing,0.048,3,67,1,1,0.418,0.41,0.455,70
papyrus,0.048,2,50,1,1,0.459,0.24,0.324,52
militia,0.048,1,33,1,1,0.396,0.729,0.769,34
newsroom,0.048,3,67,1,1,0.531,0.392,0.658,70
disregarded,0.048,5,101,1,1,0.26,0.458,0.283,106
rut,0.048,11,203,1,1,0.333,0.31,0.392,214
ovation,0.048,1,33,1,1,0.719,0.758,0.75,34
equip,0.048,1,33,1,1,0.65,0.519,0.713,34
lego,0.048,9,169,1,1,0.6,0.294,0.189,178
congratulation,0.048,2,50,1,1,0.948,0.78,0.717,52
cancellation,0.048,3,67,1,1,0.224,0.431,0.389,70
fuss,0.048,12,220,1,1,0.406,0.876,0.48,232
floss,0.048,2,50,1,1,0.5,0.28,0.278,52
hairline,0.048,2,50,1,1,0.418,0.154,0.23,52
ration,0.048,1,33,1,1,0.521,0.346,0.39,34
unchallenged,0.048,1,33,1,1,0.552,0.394,0.545,34
approving,0.048,1,33,1,1,0.917,0.583,0.773,34
wrestle,0.048,7,135,1,1,0.388,0.89,0.765,142
wiener,0.048,1,33,1,1,0.594,0.434,0.391,34
godsend,0.048,3,67,1,1,0.865,0.562,0.613,70
iteration,0.048,1,33,1,1,0.531,0.449,0.486,34
subvert,0.048,1,33,1,1,0.357,0.557,0.536,34
impractical,0.048,2,50,1,1,0.16,0.373,0.291,52
endanger,0.048,1,33,1,1,0.115,0.885,0.404,34
tarantula,0.048,3,67,1,1,0.26,0.718,0.544,70
frosting,0.048,2,50,1,1,0.823,0.48,0.424,52
bozo,0.048,2,50,1,1,0.388,0.364,0.298,52
euphemism,0.048,1,33,1,1,0.418,0.453,0.491,34
grits,0.048,1,33,1,1,0.458,0.333,0.346,34
saltwater,0.048,1,33,1,1,0.327,0.33,0.364,34
greyhound,0.048,2,50,1,1,0.52,0.49,0.44,52
basketball,0.046,30,527,1,1,0.814,0.764,0.435,557
stable,0.046,76,1311,1,1,0.725,0.204,0.735,1387
intimidating,0.045,22,391,1,1,0.229,0.79,0.708,413
differently,0.045,103,1772,1,1,0.48,0.431,0.506,1875
preview,0.045,16,289,1,1,0.656,0.337,0.491,305
navigate,0.044,31,545,1,1,0.74,0.555,0.675,576
figure,0.044,438,7494,1,1,0.688,0.328,0.509,7932
formal,0.043,12,221,1,1,0.735,0.25,0.625,233
trainer,0.043,12,221,1,1,0.698,0.719,0.824,233
dime,0.043,11,204,1,1,0.653,0.317,0.345,215
seventeen,0.043,22,392,1,1,0.585,0.296,0.321,414
cinnamon,0.043,10,187,1,1,0.6,0.25,0.292,197
demonstrate,0.043,10,187,1,1,0.771,0.552,0.839,197
dumps,0.042,9,170,1,1,0.302,0.583,0.365,179
service,0.042,270,4635,1,1,0.684,0.408,0.535,4905
role,0.042,139,2394,1,1,0.552,0.26,0.464,2533
note,0.042,223,3831,1,1,0.594,0.163,0.416,4054
unfortunate,0.041,53,923,1,1,0.073,0.487,0.195,976
devil,0.041,121,2087,1,1,0.161,0.9,0.611,2208
engaged,0.041,86,1488,1,1,0.837,0.596,0.849,1574
county,0.041,56,975,1,1,0.479,0.368,0.545,1031
primary,0.04,44,770,1,1,0.562,0.39,0.545,814
compass,0.04,14,256,1,1,0.541,0.307,0.529,270
crippling,0.04,64,1113,1,1,0.156,0.598,0.391,1177
unpaid,0.04,6,119,1,1,0.3,0.413,0.365,125
lin,0.04,6,119,1,1,0.416,0.362,0.343,125
additional,0.04,20,359,1,1,0.673,0.462,0.526,379
unaware,0.04,20,359,1,1,0.208,0.355,0.31,379
alliance,0.04,20,359,1,1,0.696,0.473,0.769,379
utterly,0.039,71,1234,1,1,0.633,0.44,0.673,1305
offense,0.039,49,857,1,1,0.23,0.765,0.51,906
endorse,0.038,5,102,1,1,0.592,0.392,0.472,107
chic,0.038,5,102,1,1,0.87,0.624,0.38,107
bloodline,0.038,5,102,1,1,0.51,0.657,0.604,107
punch,0.038,47,823,1,1,0.229,0.787,0.608,870
commons,0.038,5,102,1,1,0.633,0.396,0.623,107
aggravating,0.038,5,102,1,1,0.257,0.794,0.64,107
pronounce,0.038,11,205,1,1,0.653,0.52,0.563,216
planned,0.038,100,1733,1,1,0.74,0.385,0.729,1833
defy,0.037,10,188,1,1,0.353,0.884,0.657,198
grandfather,0.037,32,566,1,1,0.827,0.279,0.586,598
meeting,0.037,268,4622,1,1,0.75,0.569,0.613,4890
offend,0.037,15,274,1,1,0.094,0.804,0.333,289
reform,0.036,14,257,1,1,0.531,0.49,0.797,271
ropes,0.036,4,85,1,1,0.458,0.304,0.402,89
impropriety,0.036,4,85,1,1,0.133,0.591,0.389,89
celebrating,0.036,94,1633,1,1,0.927,0.86,0.773,1727
outcast,0.036,43,756,1,1,0.153,0.449,0.353,799
misunderstood,0.036,90,1565,1,1,0.177,0.625,0.309,1655
teaser,0.035,13,240,1,1,0.51,0.558,0.534,253
boxers,0.035,8,154,1,1,0.375,0.88,0.654,162
bagel,0.035,8,154,1,1,0.531,0.363,0.34,162
parallel,0.035,35,619,1,1,0.568,0.284,0.465,654
twist,0.035,43,757,1,1,0.375,0.469,0.337,800
leap,0.034,25,447,1,1,0.75,0.663,0.667,472
rap,0.034,42,740,1,1,0.604,0.575,0.464,782
host,0.034,48,844,1,1,0.693,0.471,0.537,892
cutlery,0.033,3,68,1,1,0.552,0.3,0.345,71
daredevil,0.033,3,68,1,1,0.429,0.714,0.653,71
bulldog,0.033,3,68,1,1,0.494,0.65,0.53,71
rudeness,0.033,3,68,1,1,0.28,0.819,0.692,71
workload,0.033,3,68,1,1,0.231,0.792,0.49,71
revoke,0.033,3,68,1,1,0.251,0.696,0.737,71
recycling,0.033,7,137,1,1,0.552,0.32,0.509,144
enthusiastic,0.033,7,137,1,1,0.885,0.868,0.848,144
haw,0.033,3,68,1,1,0.406,0.426,0.431,71
pasta,0.033,34,603,1,1,0.615,0.306,0.375,637
pie,0.032,29,517,1,1,0.88,0.402,0.368,546
expecting,0.032,102,1778,1,1,0.561,0.45,0.302,1880
tidy,0.032,10,189,1,1,0.76,0.208,0.647,199
accomplish,0.032,49,863,1,1,0.929,0.673,0.816,912
security,0.032,170,2954,1,1,0.837,0.36,0.821,3124
teacher,0.031,159,2765,1,1,0.76,0.404,0.885,2924
elf,0.031,30,535,1,1,0.46,0.457,0.315,565
couple,0.031,628,10875,1,1,0.806,0.605,0.607,11503
yummy,0.03,9,172,1,1,0.878,0.55,0.658,181
minimum,0.03,53,934,1,1,0.38,0.198,0.194,987
teens,0.03,56,986,1,1,0.653,0.66,0.44,1042
theater,0.029,62,1090,1,1,0.76,0.635,0.516,1152
camera,0.029,87,1523,1,1,0.64,0.288,0.379,1610
ahead,0.029,238,4139,1,1,0.708,0.52,0.673,4377
run,0.029,873,15148,1,1,0.542,0.787,0.543,16021
warp,0.029,2,51,1,1,0.344,0.417,0.373,53
hurdle,0.029,5,103,1,1,0.198,0.682,0.434,108
inflated,0.029,2,51,1,1,0.303,0.431,0.617,53
adversary,0.029,2,51,1,1,0.349,0.777,0.457,53
autopilot,0.029,2,51,1,1,0.594,0.462,0.632,53
tutu,0.029,2,51,1,1,0.583,0.276,0.233,53
blind,0.029,116,2027,1,1,0.156,0.36,0.184,2143
taco,0.029,20,363,1,1,0.561,0.353,0.277,383
restrictive,0.029,2,51,1,1,0.215,0.596,0.5,53
may,0.028,2970,51525,1,1,0.704,0.273,0.245,54495
obsession,0.028,48,849,1,1,0.229,0.847,0.571,897
plan,0.028,436,7580,1,1,0.646,0.54,0.733,8016
marvel,0.028,59,1040,1,1,0.961,0.755,0.866,1099
plate,0.027,44,780,1,1,0.583,0.245,0.366,824
booking,0.027,13,242,1,1,0.708,0.503,0.583,255
autistic,0.027,41,728,1,1,0.367,0.337,0.404,769
switch,0.027,122,2134,1,1,0.5,0.538,0.509,2256
beat,0.027,282,4912,1,1,0.279,0.647,0.492,5194
collar,0.027,10,190,1,1,0.656,0.442,0.446,200
schizophrenic,0.026,12,225,1,1,0.102,0.958,0.433,237
legacy,0.025,45,799,1,1,0.792,0.529,0.827,844
spiral,0.025,32,573,1,1,0.49,0.624,0.361,605
neighbor,0.025,71,1252,1,1,0.657,0.448,0.434,1323
capable,0.024,144,2524,1,1,0.765,0.587,0.547,2668
one,0.024,17092,297699,1,1,0.542,0.292,0.37,314791
adjustment,0.024,11,208,1,1,0.59,0.52,0.661,219
punched,0.024,11,208,1,1,0.188,0.634,0.452,219
love,0.023,18497,322302,1,1,1,0.519,0.673,340799
homosexuality,0.023,6,121,1,1,0.367,0.696,0.429,127
privileged,0.023,22,400,1,1,0.867,0.49,0.853,422
villain,0.023,22,400,1,1,0.177,0.892,0.59,422
shopping,0.022,153,2685,1,1,0.915,0.445,0.63,2838
risky,0.022,19,348,1,1,0.224,0.922,0.7,367
gospel,0.022,32,575,1,1,0.74,0.333,0.58,607
committed,0.022,89,1570,1,1,0.71,0.542,0.712,1659
restroom,0.021,23,418,1,1,0.653,0.279,0.267,441
acknowledge,0.021,86,1518,1,1,0.786,0.37,0.661,1604
ownership,0.021,12,226,1,1,0.628,0.445,0.741,238
finger,0.021,78,1379,1,1,0.321,0.264,0.291,1457
fab,0.021,16,296,1,1,0.49,0.38,0.406,312
shoddy,0.019,1,34,1,1,0.082,0.463,0.179,35
coating,0.019,1,34,1,1,0.62,0.44,0.596,35
elective,0.019,1,34,1,1,0.612,0.38,0.623,35
gob,0.019,1,34,1,1,0.28,0.357,0.447,35
boarder,0.019,3,69,1,1,0.604,0.44,0.475,72
gruesome,0.019,3,69,1,1,0.094,0.837,0.474,72
ladybug,0.019,1,34,1,1,0.602,0.4,0.224,35
indict,0.019,1,34,1,1,0.188,0.731,0.458,35
overthinker,0.019,1,34,1,1,0.43,0.606,0.552,35
roundabout,0.019,1,34,1,1,0.49,0.425,0.495,35
devalued,0.019,1,34,1,1,0.321,0.462,0.212,35
pinkie,0.019,1,34,1,1,0.663,0.265,0.269,35
registration,0.019,7,139,1,1,0.622,0.396,0.574,146
tapeworm,0.019,1,34,1,1,0.357,0.334,0.331,35
awry,0.019,1,34,1,1,0.156,0.54,0.275,35
waiver,0.019,1,34,1,1,0.396,0.63,0.373,35
screech,0.019,3,69,1,1,0.214,0.802,0.306,72
indicative,0.019,3,69,1,1,0.51,0.51,0.591,72
rerun,0.019,1,34,1,1,0.333,0.62,0.529,35
parenthood,0.019,9,174,1,1,0.75,0.63,0.782,183
clergy,0.019,7,139,1,1,0.531,0.312,0.575,146
grimy,0.019,1,34,1,1,0.112,0.597,0.283,35
whopping,0.019,1,34,1,1,0.541,0.74,0.755,35
irrefutable,0.019,1,34,1,1,0.496,0.549,0.716,35
raid,0.019,11,209,1,1,0.35,0.726,0.56,220
sliding,0.017,16,297,1,1,0.356,0.73,0.491,313
nintendo,0.017,14,262,1,1,0.802,0.571,0.464,276
detective,0.017,14,262,1,1,0.5,0.764,0.901,276
half,0.017,669,11751,1,1,0.5,0.274,0.276,12420
month,0.017,719,12629,1,1,0.688,0.255,0.411,13348
specific,0.016,100,1771,1,1,0.656,0.388,0.691,1871
volume,0.016,63,1122,1,1,0.552,0.49,0.546,1185
dreaming,0.016,116,2052,1,1,0.854,0.32,0.336,2168
argue,0.016,68,1210,1,1,0.093,0.798,0.525,1278
queen,0.016,210,3703,1,1,0.875,0.692,0.86,3913
dilemma,0.015,31,561,1,1,0.153,0.59,0.43,592
fork,0.015,13,245,1,1,0.406,0.3,0.529,258
dawned,0.015,6,122,1,1,0.694,0.471,0.473,128
strawberry,0.015,13,245,1,1,0.833,0.27,0.336,258
diamonds,0.014,18,333,1,1,0.927,0.684,0.917,351
acceptable,0.014,47,843,1,1,0.812,0.286,0.583,890
ghost,0.013,213,3765,1,1,0.265,0.755,0.343,3978
bottle,0.013,156,2762,1,1,0.469,0.236,0.336,2918
milestone,0.013,9,175,1,1,0.719,0.373,0.558,184
bust,0.013,22,404,1,1,0.52,0.5,0.42,426
accent,0.013,22,404,1,1,0.598,0.357,0.509,426
abandoned,0.013,186,3292,1,1,0.046,0.481,0.13,3478
suspended,0.012,20,369,1,1,0.224,0.402,0.368,389
tone,0.012,78,1391,1,1,0.551,0.355,0.411,1469
mega,0.012,15,281,1,1,0.724,0.538,0.723,296
wannabe,0.012,7,140,1,1,0.602,0.547,0.337,147
puddle,0.012,7,140,1,1,0.396,0.302,0.298,147
question,0.011,515,9097,1,1,0.51,0.41,0.509,9612
double,0.011,116,2062,1,1,0.677,0.378,0.569,2178
overtime,0.011,13,246,1,1,0.447,0.504,0.529,259
considerate,0.011,16,299,1,1,0.781,0.38,0.633,315
fever,0.01,42,758,1,1,0.194,0.674,0.364,800
hoy,0.01,8,158,1,1,0.583,0.298,0.471,166
maneuver,0.01,2,52,1,1,0.615,0.663,0.608,54
fodder,0.01,2,52,1,1,0.316,0.358,0.43,54
inspector,0.01,2,52,1,1,0.418,0.58,0.852,54
hesitating,0.01,2,52,1,1,0.265,0.528,0.24,54
flatter,0.01,2,52,1,1,0.521,0.418,0.302,54
objection,0.01,2,52,1,1,0.347,0.592,0.709,54
explicit,0.01,5,105,1,1,0.562,0.694,0.734,110
marketing,0.01,29,529,1,1,0.521,0.774,0.675,558
morphine,0.01,2,52,1,1,0.229,0.49,0.496,54
maniac,0.01,8,158,1,1,0.12,0.849,0.431,166
disgruntled,0.01,2,52,1,1,0.104,0.658,0.442,54
extinct,0.01,5,105,1,1,0.112,0.491,0.412,110
dingy,0.01,5,105,1,1,0.156,0.483,0.343,110
offset,0.01,5,105,1,1,0.719,0.394,0.704,110
auditorium,0.01,2,52,1,1,0.529,0.49,0.538,54
windshield,0.01,2,52,1,1,0.615,0.375,0.333,54
braid,0.01,2,52,1,1,0.427,0.222,0.216,54
interface,0.01,2,52,1,1,0.643,0.357,0.6,54
mirror,0.009,203,3604,1,1,0.677,0.31,0.438,3807
controlling,0.009,33,600,1,1,0.49,0.441,0.885,633
funky,0.008,9,176,1,1,0.531,0.755,0.389,185
purple,0.008,89,1592,1,1,0.7,0.298,0.33,1681
speeding,0.007,6,123,1,1,0.438,0.908,0.645,129
puppet,0.007,20,371,1,1,0.459,0.433,0.298,391
need,0.007,12401,219717,1,1,0.51,0.574,0.2,232118
finally,0.005,1260,22367,1,1,0.583,0.433,0.465,23627
answer,0.005,550,9774,1,1,0.537,0.373,0.661,10324
neighborhood,0.005,50,904,1,1,0.385,0.469,0.373,954
suspend,0.005,3,70,1,1,0.24,0.32,0.368,73
bran,0.005,7,141,1,1,0.688,0.433,0.483,148
tackling,0.005,7,141,1,1,0.48,0.694,0.613,148
rack,0.005,7,141,1,1,0.385,0.373,0.409,148
weasel,0.005,3,70,1,1,0.408,0.317,0.337,73
aisle,0.005,15,283,1,1,0.438,0.222,0.283,298
ginger,0.005,15,283,1,1,0.406,0.375,0.316,298
curate,0.005,3,70,1,1,0.726,0.418,0.526,73
appliances,0.005,3,70,1,1,0.594,0.394,0.567,73
rambling,0.005,15,283,1,1,0.448,0.51,0.528,298
dolphin,0.005,3,70,1,1,0.776,0.35,0.414,73
cricket,0.004,16,301,1,1,0.423,0.539,0.37,317
coping,0.004,89,1598,1,1,0.562,0.63,0.613,1687
suppose,0.004,176,3144,1,1,0.551,0.343,0.348,3320
legend,0.004,51,923,1,1,0.837,0.519,0.75,974
shy,0.003,170,3039,1,1,0.28,0.153,0.132,3209
listing,0.003,8,159,1,1,0.438,0.273,0.432,167
honesty,0.003,112,2008,1,1,0.938,0.411,0.728,2120
national,0.002,235,4198,1,1,0.698,0.365,0.663,4433
likable,0.002,4,88,1,1,0.865,0.48,0.663,92
local,0.002,180,3221,1,1,0.656,0.269,0.452,3401
due,0.002,399,7122,1,1,0.562,0.34,0.467,7521
bedtime,0.001,15,284,1,1,0.673,0.314,0.373,299
media,0.001,682,12167,1,1,0.5,0.33,0.464,12849
forgiven,0.001,21,391,1,1,0.75,0.302,0.51,412
sisterhood,0.001,10,195,1,1,0.837,0.415,0.696,205
cruel,0.001,152,2726,1,1,0.122,0.866,0.391,2878
logic,0.001,62,1122,1,1,0.646,0.245,0.819,1184
heartfelt,0.001,22,409,1,1,0.904,0.44,0.54,431
boil,0,11,213,1,1,0.417,0.684,0.433,224
newt,0,5,106,1,1,0.458,0.38,0.541,111
bloody,-0,73,1319,1,1,0.031,0.91,0.518,1392
debt,-0,73,1319,1,1,0.204,0.598,0.336,1392
attend,-0,81,1462,1,1,0.65,0.42,0.625,1543
option,-0,247,4424,1,1,0.512,0.427,0.359,4671
cart,-0.001,12,231,1,1,0.52,0.344,0.388,243
sally,-0.001,12,231,1,1,0.604,0.39,0.451,243
foot,-0.001,90,1623,1,1,0.49,0.29,0.254,1713
seasonal,-0.001,20,374,1,1,0.592,0.273,0.305,394
crusade,-0.001,6,124,1,1,0.592,0.72,0.709,130
subway,-0.001,20,374,1,1,0.418,0.3,0.464,394
desperate,-0.002,193,3465,1,1,0.083,0.842,0.337,3658
mediocre,-0.002,23,428,1,1,0.188,0.481,0.149,451
carrier,-0.002,7,142,1,1,0.533,0.588,0.638,149
spoon,-0.002,23,428,1,1,0.479,0.236,0.259,451
disliked,-0.002,15,285,1,1,0.062,0.51,0.221,300
crew,-0.003,68,1233,1,1,0.604,0.598,0.735,1301
hallway,-0.003,26,482,1,1,0.573,0.23,0.279,508
potatoes,-0.003,17,321,1,1,0.69,0.271,0.309,338
play,-0.003,1037,18573,1,1,0.812,0.765,0.358,19610
skilled,-0.004,9,178,1,1,0.886,0.614,0.929,187
street,-0.004,201,3615,1,1,0.594,0.324,0.398,3816
humor,-0.004,61,1109,1,1,0.89,0.633,0.462,1170
loose,-0.004,88,1593,1,1,0.573,0.312,0.365,1681
tall,-0.004,77,1396,1,1,0.725,0.591,0.538,1473
ruined,-0.004,116,2095,1,1,0.135,0.564,0.194,2211
icon,-0.006,17,322,1,1,0.549,0.349,0.415,339
stresses,-0.007,25,466,1,1,0.115,0.817,0.396,491
repeatedly,-0.008,37,682,1,1,0.479,0.575,0.5,719
grave,-0.008,84,1527,1,1,0.153,0.385,0.386,1611
tour,-0.008,134,2426,1,1,0.663,0.545,0.543,2560
doc,-0.008,46,844,1,1,0.458,0.317,0.392,890
rude,-0.008,143,2588,1,1,0.061,0.821,0.402,2731
identify,-0.008,58,1060,1,1,0.635,0.48,0.667,1118
dietary,-0.009,1,35,1,1,0.551,0.22,0.261,36
aviation,-0.009,1,35,1,1,0.708,0.646,0.741,36
confessional,-0.009,1,35,1,1,0.458,0.392,0.629,36
subpoena,-0.009,1,35,1,1,0.281,0.634,0.555,36
frisky,-0.009,1,35,1,1,0.7,0.632,0.525,36
underpaid,-0.009,1,35,1,1,0.146,0.413,0.209,36
allowance,-0.009,7,143,1,1,0.673,0.382,0.591,150
ajar,-0.009,1,35,1,1,0.46,0.413,0.446,36
postman,-0.009,1,35,1,1,0.643,0.482,0.455,36
obnoxious,-0.009,18,341,1,1,0.088,0.602,0.256,359
fumble,-0.009,2,53,1,1,0.36,0.551,0.412,55
attendant,-0.009,3,71,1,1,0.58,0.365,0.519,74
pouty,-0.009,1,35,1,1,0.333,0.48,0.393,36
revolting,-0.009,3,71,1,1,0.102,0.69,0.3,74
zoom,-0.009,7,143,1,1,0.49,0.52,0.462,150
subtitle,-0.009,1,35,1,1,0.445,0.202,0.347,36
gallon,-0.009,5,107,1,1,0.531,0.327,0.345,112
permissible,-0.009,1,35,1,1,0.684,0.646,0.612,36
sweatshirt,-0.009,4,89,1,1,0.51,0.368,0.353,93
tribunal,-0.009,1,35,1,1,0.41,0.67,0.797,36
bearded,-0.009,4,89,1,1,0.439,0.337,0.391,93
confederate,-0.009,1,35,1,1,0.551,0.546,0.792,36
provoke,-0.009,4,89,1,1,0.3,0.871,0.735,93
classification,-0.009,2,53,1,1,0.583,0.423,0.613,55
defended,-0.009,9,179,1,1,0.663,0.451,0.582,188
mobilize,-0.009,1,35,1,1,0.604,0.684,0.727,36
monstrosity,-0.009,1,35,1,1,0.094,0.933,0.611,36
jimmy,-0.009,28,521,1,1,0.579,0.321,0.311,549
induction,-0.009,1,35,1,1,0.392,0.593,0.627,36
festive,-0.009,27,503,1,1,0.854,0.74,0.764,530
nutshell,-0.009,8,161,1,1,0.458,0.407,0.31,169
poodle,-0.009,1,35,1,1,0.5,0.413,0.301,36
infuriated,-0.009,2,53,1,1,0.073,0.93,0.51,55
knickers,-0.009,1,35,1,1,0.552,0.428,0.328,36
implicated,-0.009,1,35,1,1,0.354,0.673,0.438,36
algorithm,-0.009,7,143,1,1,0.448,0.394,0.559,150
procrastinate,-0.009,6,125,1,1,0.276,0.353,0.315,131
constituent,-0.009,2,53,1,1,0.573,0.5,0.827,55
goofball,-0.009,1,35,1,1,0.561,0.55,0.382,36
convention,-0.009,17,323,1,1,0.622,0.622,0.704,340
hose,-0.009,2,53,1,1,0.469,0.288,0.263,55
humanitarian,-0.009,6,125,1,1,0.786,0.317,0.709,131
beginner,-0.009,2,53,1,1,0.49,0.48,0.387,55
overjoyed,-0.009,3,71,1,1,0.908,0.708,0.755,74
amp,-0.009,4,89,1,1,0.439,0.393,0.375,93
ending,-0.01,243,4396,1,1,0.344,0.365,0.492,4639
stubborn,-0.011,32,594,1,1,0.157,0.702,0.575,626
unknown,-0.011,223,4038,1,1,0.357,0.45,0.204,4261
saving,-0.012,106,1930,1,1,0.663,0.23,0.621,2036
documentary,-0.012,38,703,1,1,0.622,0.213,0.596,741
picture,-0.013,282,5110,1,1,0.714,0.308,0.462,5392
outcome,-0.013,44,812,1,1,0.615,0.472,0.685,856
wicked,-0.013,43,794,1,1,0.138,0.8,0.627,837
brown,-0.013,85,1553,1,1,0.396,0.202,0.293,1638
finale,-0.013,26,487,1,1,0.406,0.33,0.468,513
invalid,-0.014,11,216,1,1,0.18,0.33,0.255,227
dare,-0.014,129,2350,1,1,0.677,0.788,0.684,2479
internet,-0.014,323,5859,1,1,0.76,0.462,0.755,6182
confidence,-0.014,172,3129,1,1,0.959,0.276,0.943,3301
hag,-0.015,8,162,1,1,0.188,0.695,0.411,170
label,-0.016,34,633,1,1,0.582,0.245,0.423,667
meh,-0.016,51,941,1,1,0.38,0.286,0.365,992
dine,-0.016,16,307,1,1,0.821,0.519,0.478,323
relief,-0.016,160,2916,1,1,0.844,0.278,0.481,3076
obsessing,-0.016,7,144,1,1,0.173,0.773,0.698,151
bin,-0.017,28,525,1,1,0.422,0.304,0.327,553
doubts,-0.017,49,906,1,1,0.306,0.448,0.305,955
hooked,-0.018,25,471,1,1,0.61,0.661,0.454,496
feedback,-0.018,42,780,1,1,0.622,0.557,0.645,822
pressure,-0.018,180,3287,1,1,0.36,0.65,0.623,3467
convincing,-0.018,29,544,1,1,0.76,0.527,0.9,573
dale,-0.018,5,108,1,1,0.622,0.27,0.365,113
board,-0.019,85,1562,1,1,0.592,0.255,0.385,1647
shooter,-0.019,10,199,1,1,0.224,0.814,0.774,209
compassionate,-0.019,32,599,1,1,0.857,0.404,0.411,631
drink,-0.02,468,8529,1,1,0.65,0.552,0.474,8997
accept,-0.02,577,10513,1,1,0.847,0.286,0.565,11090
disbelief,-0.02,14,272,1,1,0.188,0.409,0.373,286
uncommon,-0.02,14,272,1,1,0.459,0.429,0.373,286
grandson,-0.02,9,181,1,1,0.778,0.333,0.5,190
global,-0.02,63,1164,1,1,0.583,0.52,0.713,1227
lord,-0.021,650,11853,1,1,0.618,0.327,0.684,12503
sneaking,-0.021,13,254,1,1,0.203,0.755,0.545,267
politics,-0.021,146,2677,1,1,0.25,0.528,0.855,2823
purposely,-0.021,26,491,1,1,0.646,0.706,0.703,517
existent,-0.021,8,163,1,1,0.635,0.49,0.635,171
interested,-0.022,221,4045,1,1,0.75,0.529,0.725,4266
link,-0.022,103,1895,1,1,0.427,0.264,0.491,1998
upstairs,-0.022,58,1075,1,1,0.663,0.408,0.645,1133
isolated,-0.023,354,6476,1,1,0.221,0.356,0.255,6830
roll,-0.023,121,2225,1,1,0.469,0.51,0.172,2346
creak,-0.023,3,72,1,1,0.344,0.67,0.411,75
contents,-0.023,7,145,1,1,0.656,0.375,0.55,152
wealthy,-0.023,23,437,1,1,0.927,0.566,0.862,460
negligence,-0.023,3,72,1,1,0.092,0.57,0.251,75
canteen,-0.023,3,72,1,1,0.688,0.6,0.514,75
conditioner,-0.023,3,72,1,1,0.781,0.36,0.538,75
abomination,-0.023,7,145,1,1,0.078,0.755,0.518,152
grieve,-0.023,58,1076,1,1,0.122,0.5,0.333,1134
corpse,-0.024,18,346,1,1,0.094,0.657,0.232,364
spoil,-0.024,40,748,1,1,0.146,0.723,0.328,788
stupidity,-0.024,47,876,1,1,0.06,0.418,0.151,923
nuisance,-0.024,10,200,1,1,0.198,0.817,0.227,210
refugee,-0.024,10,200,1,1,0.379,0.607,0.327,210
apologize,-0.024,98,1808,1,1,0.551,0.378,0.389,1906
grinding,-0.025,24,456,1,1,0.415,0.45,0.461,480
jigsaw,-0.025,6,127,1,1,0.594,0.582,0.519,133
pitiful,-0.025,20,383,1,1,0.219,0.49,0.232,403
dream,-0.025,640,11724,1,1,0.844,0.157,0.328,12364
addict,-0.026,26,493,1,1,0.075,0.696,0.327,519
mistake,-0.026,187,3440,1,1,0.208,0.585,0.102,3627
punching,-0.026,12,237,1,1,0.332,0.915,0.623,249
storage,-0.026,12,237,1,1,0.698,0.406,0.564,249
pencil,-0.026,15,292,1,1,0.552,0.2,0.263,307
orange,-0.026,82,1519,1,1,0.646,0.132,0.296,1601
agreement,-0.027,27,512,1,1,0.76,0.44,0.736,539
flint,-0.028,8,164,1,1,0.521,0.439,0.536,172
muck,-0.028,2,54,1,1,0.347,0.423,0.272,56
advertisement,-0.028,2,54,1,1,0.6,0.566,0.539,56
sparkly,-0.028,2,54,1,1,0.885,0.59,0.726,56
wrestler,-0.028,2,54,1,1,0.52,0.863,0.911,56
contractor,-0.028,2,54,1,1,0.592,0.479,0.727,56
remarry,-0.028,2,54,1,1,0.653,0.791,0.54,56
cartoon,-0.028,17,329,1,1,0.867,0.471,0.387,346
cupboard,-0.028,8,164,1,1,0.553,0.2,0.304,172
llama,-0.028,2,54,1,1,0.49,0.59,0.519,56
communist,-0.028,14,274,1,1,0.265,0.702,0.632,288
contingent,-0.028,2,54,1,1,0.47,0.531,0.659,56
tangent,-0.028,2,54,1,1,0.573,0.373,0.454,56
prestige,-0.028,2,54,1,1,0.918,0.594,0.907,56
football,-0.028,101,1870,1,1,0.755,0.76,0.582,1971
christ,-0.028,220,4054,1,1,0.781,0.51,0.75,4274
tiny,-0.029,163,3009,1,1,0.479,0.196,0.125,3172
knife,-0.029,57,1064,1,1,0.344,0.717,0.573,1121
underlying,-0.029,10,201,1,1,0.48,0.445,0.452,211
erase,-0.03,26,495,1,1,0.24,0.26,0.321,521
refusal,-0.03,7,146,1,1,0.052,0.61,0.321,153
jacket,-0.03,30,569,1,1,0.656,0.302,0.382,599
pinpoint,-0.031,4,91,1,1,0.583,0.443,0.528,95
sidewalk,-0.031,14,275,1,1,0.479,0.192,0.348,289
soccer,-0.031,19,367,1,1,0.698,0.837,0.644,386
suppression,-0.031,4,91,1,1,0.267,0.541,0.537,95
fried,-0.032,21,404,1,1,0.479,0.482,0.336,425
decorate,-0.032,16,312,1,1,0.954,0.37,0.404,328
pains,-0.032,52,975,1,1,0.106,0.673,0.362,1027
admirable,-0.032,11,220,1,1,0.929,0.6,0.87,231
dome,-0.032,18,349,1,1,0.62,0.398,0.509,367
noticeable,-0.033,6,128,1,1,0.89,0.562,0.75,134
eating,-0.033,576,10633,1,1,0.847,0.491,0.615,11209
father,-0.033,542,10012,1,1,0.812,0.333,0.824,10554
bounce,-0.033,33,626,1,1,0.375,0.633,0.386,659
lightning,-0.034,28,534,1,1,0.429,0.683,0.595,562
ordeal,-0.034,10,202,1,1,0.344,0.539,0.529,212
assembly,-0.034,10,202,1,1,0.698,0.5,0.64,212
massive,-0.035,117,2178,1,1,0.569,0.66,0.75,2295
dictate,-0.035,16,313,1,1,0.48,0.423,0.668,329
intervention,-0.035,16,313,1,1,0.388,0.696,0.689,329
justify,-0.035,37,701,1,1,0.612,0.473,0.615,738
clown,-0.035,47,886,1,1,0.65,0.598,0.3,933
aggressive,-0.036,36,683,1,1,0.125,0.949,0.648,719
friendly,-0.036,173,3217,1,1,0.917,0.398,0.598,3390
bickering,-0.037,3,73,1,1,0.122,0.8,0.536,76
tanned,-0.037,1,36,1,1,0.615,0.55,0.491,37
gist,-0.037,5,110,1,1,0.622,0.45,0.519,115
economics,-0.037,9,184,1,1,0.625,0.481,0.632,193
stonewall,-0.037,1,36,1,1,0.337,0.457,0.655,37
scandalous,-0.037,3,73,1,1,0.135,0.907,0.556,76
aga,-0.037,1,36,1,1,0.542,0.327,0.398,37
amendment,-0.037,11,221,1,1,0.531,0.459,0.606,232
unbeatable,-0.037,1,36,1,1,0.735,0.719,0.681,37
gunshot,-0.037,1,36,1,1,0.042,0.953,0.673,37
faker,-0.037,1,36,1,1,0.245,0.63,0.48,37
mention,-0.037,155,2885,1,1,0.562,0.365,0.562,3040
diesel,-0.037,3,73,1,1,0.49,0.327,0.448,76
oppressor,-0.037,1,36,1,1,0.16,0.776,0.629,37
harem,-0.037,3,73,1,1,0.521,0.578,0.582,76
obituary,-0.037,1,36,1,1,0.188,0.33,0.423,37
showbiz,-0.037,1,36,1,1,0.661,0.713,0.598,37
hedgehog,-0.037,5,110,1,1,0.458,0.491,0.377,115
nonsensical,-0.037,5,110,1,1,0.173,0.268,0.193,115
metabolism,-0.037,1,36,1,1,0.698,0.509,0.555,37
brand,-0.037,75,1405,1,1,0.562,0.284,0.547,1480
disqualified,-0.037,1,36,1,1,0.129,0.464,0.232,37
euthanasia,-0.037,1,36,1,1,0.229,0.716,0.325,37
gambling,-0.037,9,184,1,1,0.365,0.806,0.347,193
prince,-0.037,122,2275,1,1,0.888,0.464,0.87,2397
older,-0.037,425,7886,1,1,0.385,0.255,0.317,8311
injured,-0.038,28,536,1,1,0.083,0.68,0.302,564
pain,-0.038,1872,34687,1,1,0.012,0.765,0.395,36559
shooting,-0.038,56,1055,1,1,0.276,0.931,0.602,1111
rid,-0.038,121,2260,1,1,0.194,0.408,0.327,2381
request,-0.039,64,1204,1,1,0.625,0.471,0.618,1268
pile,-0.039,51,963,1,1,0.461,0.32,0.539,1014
defensive,-0.04,17,333,1,1,0.542,0.64,0.678,350
armed,-0.04,26,500,1,1,0.188,0.75,0.808,526
closet,-0.04,78,1466,1,1,0.531,0.204,0.33,1544
voiceless,-0.04,6,129,1,1,0.271,0.235,0.131,135
rash,-0.04,6,129,1,1,0.219,0.82,0.491,135
disappointing,-0.04,48,909,1,1,0.073,0.64,0.2,957
psalm,-0.04,34,649,1,1,0.688,0.224,0.557,683
snuggling,-0.04,6,129,1,1,0.683,0.585,0.373,135
stole,-0.041,39,742,1,1,0.135,0.76,0.384,781
picked,-0.041,99,1857,1,1,0.74,0.518,0.67,1956
participate,-0.041,30,575,1,1,0.755,0.58,0.684,605
locker,-0.041,11,222,1,1,0.439,0.3,0.393,233
pictures,-0.041,180,3363,1,1,0.653,0.24,0.405,3543
pancake,-0.042,4,92,1,1,0.802,0.274,0.364,96
reflex,-0.042,4,92,1,1,0.583,0.46,0.538,96
divided,-0.042,22,427,1,1,0.271,0.623,0.391,449
milk,-0.043,79,1488,1,1,0.817,0.27,0.327,1567
walker,-0.043,30,576,1,1,0.551,0.491,0.525,606
tiring,-0.043,73,1377,1,1,0.153,0.51,0.176,1450
stage,-0.043,214,4003,1,1,0.592,0.306,0.473,4217
damage,-0.043,84,1582,1,1,0.059,0.726,0.403,1666
clover,-0.043,7,148,1,1,0.605,0.34,0.364,155
resistance,-0.043,42,800,1,1,0.427,0.694,0.796,842
actual,-0.044,216,4042,1,1,0.729,0.4,0.716,4258
drove,-0.044,60,1136,1,1,0.541,0.528,0.623,1196
offensive,-0.044,27,521,1,1,0.135,0.882,0.6,548
high,-0.045,874,16317,1,1,0.684,0.51,0.614,17191
anarchist,-0.046,2,55,1,1,0.204,0.7,0.759,57
wade,-0.046,14,279,1,1,0.51,0.656,0.472,293
pixie,-0.046,2,55,1,1,0.562,0.537,0.325,57
monopoly,-0.046,5,111,1,1,0.449,0.509,0.64,116
incite,-0.046,2,55,1,1,0.449,0.736,0.642,57
terminology,-0.046,2,55,1,1,0.612,0.284,0.566,57
variable,-0.046,2,55,1,1,0.62,0.407,0.4,57
interstate,-0.046,2,55,1,1,0.52,0.443,0.6,57
coup,-0.046,11,223,1,1,0.275,0.815,0.607,234
sellout,-0.046,2,55,1,1,0.398,0.49,0.465,57
median,-0.046,2,55,1,1,0.459,0.216,0.375,57
unborn,-0.046,8,167,1,1,0.312,0.3,0.216,175
intervene,-0.046,8,167,1,1,0.52,0.677,0.768,175
inconsiderate,-0.046,11,223,1,1,0.224,0.519,0.423,234
carnage,-0.046,2,55,1,1,0.406,0.6,0.558,57
height,-0.046,29,559,1,1,0.677,0.608,0.648,588
proactive,-0.046,5,111,1,1,0.792,0.723,0.857,116
pass,-0.046,425,7953,1,1,0.51,0.324,0.362,8378
hopes,-0.047,125,2354,1,1,0.917,0.5,0.702,2479
idea,-0.047,898,16808,1,1,0.75,0.538,0.704,17706
bawl,-0.048,6,130,1,1,0.385,0.88,0.561,136
inspire,-0.048,90,1702,1,1,0.918,0.627,0.759,1792
event,-0.049,179,3369,1,1,0.745,0.673,0.664,3548
widespread,-0.049,10,205,1,1,0.633,0.456,0.713,215
worth,-0.049,979,18356,1,1,0.872,0.51,0.889,19335
regret,-0.049,220,4140,1,1,0.23,0.623,0.331,4360
dark,-0.05,1390,26071,1,1,0.198,0.398,0.426,27461
things,-0.05,4853,90997,1,1,0.519,0.25,0.368,95850
marbles,-0.05,3,74,1,1,0.714,0.345,0.241,77
straw,-0.05,15,299,1,1,0.48,0.29,0.163,314
asinine,-0.05,3,74,1,1,0.429,0.472,0.433,77
doormat,-0.05,3,74,1,1,0.458,0.269,0.267,77
lowlife,-0.05,3,74,1,1,0.296,0.529,0.309,77
synagogue,-0.05,3,74,1,1,0.531,0.3,0.544,77
tripping,-0.05,31,599,1,1,0.276,0.594,0.293,630
african,-0.05,31,599,1,1,0.49,0.423,0.555,630
rainbow,-0.05,55,1049,1,1,0.878,0.35,0.462,1104
stat,-0.05,7,149,1,1,0.479,0.46,0.395,156
giraffe,-0.05,3,74,1,1,0.561,0.347,0.436,77
melon,-0.05,3,74,1,1,0.461,0.231,0.271,77
disordered,-0.05,3,74,1,1,0.21,0.714,0.288,77
decreasing,-0.05,3,74,1,1,0.32,0.346,0.224,77
vibes,-0.05,177,3337,1,1,0.635,0.688,0.574,3514
bag,-0.051,141,2664,1,1,0.5,0.25,0.314,2805
frustration,-0.051,82,1557,1,1,0.06,0.73,0.28,1639
major,-0.051,183,3453,1,1,0.684,0.538,0.874,3636
trailer,-0.051,52,994,1,1,0.541,0.49,0.473,1046
advisor,-0.051,8,168,1,1,0.646,0.35,0.689,176
commend,-0.051,8,168,1,1,0.906,0.694,0.711,176
housework,-0.051,8,168,1,1,0.484,0.413,0.342,176
awesome,-0.052,374,7042,1,1,0.98,0.897,0.891,7416
press,-0.052,82,1558,1,1,0.552,0.52,0.491,1640
therapy,-0.052,212,4000,1,1,0.49,0.353,0.607,4212
charge,-0.053,78,1484,1,1,0.51,0.633,0.785,1562
illegitimate,-0.053,4,93,1,1,0.184,0.644,0.302,97
carbon,-0.053,9,187,1,1,0.604,0.36,0.35,196
praising,-0.053,9,187,1,1,0.906,0.557,0.623,196
handshake,-0.053,4,93,1,1,0.816,0.654,0.492,97
growl,-0.053,4,93,1,1,0.194,0.764,0.482,97
titty,-0.053,4,93,1,1,0.561,0.548,0.294,97
belt,-0.053,20,394,1,1,0.541,0.322,0.445,414
bowl,-0.053,57,1090,1,1,0.625,0.377,0.358,1147
sleepy,-0.053,42,808,1,1,0.604,0.125,0.25,850
batch,-0.054,10,206,1,1,0.56,0.357,0.357,216
chance,-0.054,531,10011,1,1,0.833,0.551,0.525,10542
shady,-0.054,22,432,1,1,0.323,0.509,0.375,454
mushroom,-0.054,5,112,1,1,0.49,0.274,0.269,117
costly,-0.054,5,112,1,1,0.316,0.65,0.642,117
stress,-0.055,422,7969,1,1,0.173,0.843,0.317,8391
wheel,-0.055,45,866,1,1,0.615,0.31,0.446,911
trusting,-0.056,54,1036,1,1,0.857,0.508,0.75,1090
tape,-0.056,27,527,1,1,0.531,0.277,0.254,554
gram,-0.056,6,131,1,1,0.578,0.333,0.26,137
accident,-0.056,63,1206,1,1,0.125,0.908,0.336,1269
unrealistic,-0.056,21,414,1,1,0.229,0.5,0.245,435
peer,-0.056,29,565,1,1,0.458,0.321,0.569,594
market,-0.057,79,1509,1,1,0.724,0.48,0.521,1588
station,-0.057,80,1528,1,1,0.688,0.367,0.519,1608
bum,-0.057,24,471,1,1,0.281,0.451,0.155,495
justice,-0.057,167,3171,1,1,0.76,0.538,0.787,3338
blown,-0.058,46,887,1,1,0.333,0.548,0.412,933
commitment,-0.058,93,1775,1,1,0.714,0.71,0.843,1868
fir,-0.058,9,188,1,1,0.521,0.275,0.306,197
billionaire,-0.058,9,188,1,1,0.806,0.667,0.923,197
assume,-0.058,135,2570,1,1,0.698,0.401,0.464,2705
joined,-0.059,104,1985,1,1,0.667,0.394,0.6,2089
rug,-0.059,11,226,1,1,0.52,0.24,0.245,237
affecting,-0.059,24,472,1,1,0.35,0.574,0.394,496
decide,-0.059,251,4767,1,1,0.656,0.54,0.855,5018
ray,-0.059,54,1040,1,1,0.55,0.67,0.538,1094
quick,-0.06,212,4031,1,1,0.704,0.755,0.75,4243
convenient,-0.06,29,567,1,1,0.846,0.491,0.574,596
motherhood,-0.06,14,283,1,1,0.844,0.546,0.667,297
included,-0.06,94,1798,1,1,0.76,0.402,0.57,1892
extremely,-0.06,272,5169,1,1,0.635,0.827,0.886,5441
hand,-0.06,861,16326,1,1,0.542,0.314,0.434,17187
delay,-0.06,16,321,1,1,0.204,0.51,0.162,337
club,-0.061,246,4681,1,1,0.646,0.618,0.393,4927
changing,-0.061,160,3051,1,1,0.571,0.569,0.461,3211
leg,-0.061,51,985,1,1,0.51,0.373,0.313,1036
binary,-0.063,8,170,1,1,0.49,0.356,0.42,178
leaflet,-0.063,1,37,1,1,0.49,0.206,0.375,38
strap,-0.063,4,94,1,1,0.38,0.417,0.382,98
intend,-0.063,21,417,1,1,0.562,0.52,0.519,438
inspection,-0.063,2,56,1,1,0.459,0.63,0.718,58
casserole,-0.063,1,37,1,1,0.57,0.36,0.328,38
pretzel,-0.063,1,37,1,1,0.519,0.323,0.358,38
choir,-0.063,14,284,1,1,0.704,0.298,0.473,298
outburst,-0.063,3,75,1,1,0.209,0.802,0.528,78
admission,-0.063,8,170,1,1,0.802,0.415,0.732,178
payroll,-0.063,2,56,1,1,0.521,0.36,0.549,58
erasure,-0.063,2,56,1,1,0.281,0.36,0.265,58
transcript,-0.063,1,37,1,1,0.639,0.398,0.528,38
prop,-0.063,7,151,1,1,0.51,0.427,0.436,158
tweak,-0.063,1,37,1,1,0.44,0.462,0.452,38
hedge,-0.063,3,75,1,1,0.604,0.602,0.569,78
gaby,-0.063,1,37,1,1,0.51,0.347,0.377,38
alzheimers,-0.063,1,37,1,1,0.194,0.518,0.319,38
management,-0.063,41,797,1,1,0.792,0.491,0.806,838
nana,-0.063,20,398,1,1,0.765,0.255,0.375,418
sham,-0.063,8,170,1,1,0.354,0.602,0.395,178
grate,-0.063,1,37,1,1,0.333,0.25,0.419,38
fetch,-0.063,8,170,1,1,0.479,0.363,0.491,178
sluggish,-0.063,1,37,1,1,0.224,0.124,0.155,38
injure,-0.063,1,37,1,1,0.177,0.71,0.364,38
coon,-0.063,1,37,1,1,0.49,0.46,0.4,38
handgun,-0.063,1,37,1,1,0.156,0.914,0.782,38
tether,-0.063,1,37,1,1,0.323,0.62,0.407,38
revolution,-0.063,25,493,1,1,0.417,0.902,0.798,518
athletics,-0.063,1,37,1,1,0.831,0.691,0.74,38
snide,-0.063,1,37,1,1,0.186,0.723,0.455,38
furniture,-0.063,28,550,1,1,0.688,0.26,0.264,578
homely,-0.063,2,56,1,1,0.745,0.157,0.399,58
macho,-0.063,2,56,1,1,0.643,0.69,0.676,58
ultimatum,-0.063,1,37,1,1,0.219,0.855,0.837,38
condom,-0.063,4,94,1,1,0.406,0.637,0.5,98
movies,-0.064,382,7283,1,1,0.724,0.426,0.472,7665
lose,-0.065,665,12676,1,1,0.115,0.538,0.176,13341
extra,-0.065,235,4492,1,1,0.656,0.551,0.745,4727
shipping,-0.065,23,456,1,1,0.622,0.327,0.443,479
friday,-0.066,336,6417,1,1,0.624,0.411,0.341,6753
unconditional,-0.067,29,571,1,1,0.76,0.493,0.715,600
disheartening,-0.067,13,266,1,1,0.01,0.353,0.224,279
blackout,-0.068,11,228,1,1,0.126,0.53,0.349,239
refused,-0.068,58,1125,1,1,0.163,0.475,0.188,1183
attached,-0.068,105,2022,1,1,0.562,0.35,0.439,2127
forgotten,-0.068,221,4238,1,1,0.235,0.28,0.184,4459
disappointment,-0.069,77,1489,1,1,0.115,0.49,0.336,1566
box,-0.069,162,3114,1,1,0.5,0.179,0.312,3276
toll,-0.069,53,1031,1,1,0.296,0.422,0.453,1084
cheesecake,-0.069,8,171,1,1,0.86,0.276,0.238,179
apology,-0.069,26,515,1,1,0.571,0.346,0.402,541
wonder,-0.069,702,13437,1,1,0.939,0.771,0.765,14139
apple,-0.069,58,1127,1,1,0.811,0.3,0.264,1185
teammate,-0.07,7,152,1,1,0.865,0.449,0.66,159
shot,-0.07,193,3710,1,1,0.144,0.75,0.569,3903
imbalance,-0.071,6,133,1,1,0.115,0.538,0.264,139
irritate,-0.071,13,267,1,1,0.167,0.89,0.368,280
feed,-0.071,160,3082,1,1,0.812,0.429,0.739,3242
bomb,-0.071,44,861,1,1,0.167,0.912,0.75,905
lasagna,-0.072,5,114,1,1,0.719,0.441,0.396,119
expiration,-0.072,5,114,1,1,0.265,0.539,0.463,119
terrify,-0.072,5,114,1,1,0.052,0.889,0.509,119
deteriorating,-0.072,5,114,1,1,0.104,0.459,0.112,119
swag,-0.072,5,114,1,1,0.656,0.676,0.654,119
careful,-0.072,123,2376,1,1,0.625,0.538,0.53,2499
privately,-0.072,16,325,1,1,0.458,0.562,0.541,341
duck,-0.073,27,536,1,1,0.594,0.337,0.236,563
disgrace,-0.073,38,747,1,1,0.061,0.531,0.331,785
debut,-0.073,35,690,1,1,0.806,0.606,0.629,725
iffy,-0.074,4,95,1,1,0.38,0.442,0.333,99
tee,-0.074,9,191,1,1,0.459,0.373,0.377,200
taxi,-0.074,24,479,1,1,0.542,0.362,0.43,503
winning,-0.074,79,1535,1,1,0.955,0.712,0.972,1614
calculated,-0.074,4,95,1,1,0.633,0.425,0.683,99
pimp,-0.074,4,95,1,1,0.146,0.7,0.536,99
practically,-0.074,48,940,1,1,0.622,0.402,0.588,988
line,-0.074,518,9967,1,1,0.541,0.18,0.353,10485
carol,-0.074,23,460,1,1,0.673,0.412,0.436,483
fortunate,-0.074,37,729,1,1,0.927,0.639,0.836,766
tantrum,-0.075,12,249,1,1,0.219,0.817,0.404,261
planet,-0.075,234,4519,1,1,0.698,0.404,0.832,4753
hay,-0.076,24,480,1,1,0.469,0.212,0.343,504
complementary,-0.076,3,76,1,1,0.714,0.32,0.586,79
drawers,-0.076,3,76,1,1,0.539,0.26,0.236,79
intensive,-0.076,3,76,1,1,0.57,0.842,0.776,79
cocaine,-0.076,7,153,1,1,0.156,0.84,0.373,160
hormone,-0.076,3,76,1,1,0.49,0.75,0.621,79
recycle,-0.076,3,76,1,1,0.521,0.392,0.526,79
shockingly,-0.076,3,76,1,1,0.51,0.924,0.721,79
gravy,-0.076,7,153,1,1,0.608,0.45,0.339,160
add,-0.077,252,4871,1,1,0.728,0.49,0.554,5123
remembered,-0.077,122,2368,1,1,0.916,0.333,0.588,2490
crate,-0.078,6,134,1,1,0.427,0.173,0.274,140
slit,-0.078,6,134,1,1,0.406,0.49,0.366,140
loop,-0.078,37,732,1,1,0.516,0.343,0.317,769
lyric,-0.078,37,732,1,1,0.702,0.269,0.464,769
items,-0.078,30,597,1,1,0.542,0.401,0.434,627
secretly,-0.078,54,1060,1,1,0.525,0.404,0.479,1114
lights,-0.079,256,4959,1,1,0.75,0.48,0.575,5215
publicity,-0.079,9,192,1,1,0.59,0.622,0.679,201
bank,-0.079,75,1466,1,1,0.562,0.327,0.675,1541
slam,-0.079,12,250,1,1,0.459,0.577,0.48,262
darn,-0.08,15,308,1,1,0.115,0.765,0.418,323
day,-0.08,7718,149083,1,1,0.719,0.269,0.389,156801
haunted,-0.08,61,1197,1,1,0.264,0.731,0.52,1258
aged,-0.08,36,714,1,1,0.135,0.365,0.236,750
gaping,-0.081,2,57,1,1,0.408,0.668,0.242,59
lady,-0.081,335,6495,1,1,0.854,0.481,0.602,6830
apricot,-0.081,2,57,1,1,0.708,0.32,0.278,59
dork,-0.081,8,173,1,1,0.272,0.519,0.361,181
auditions,-0.081,2,57,1,1,0.74,0.765,0.596,59
responsive,-0.081,2,57,1,1,0.816,0.569,0.573,59
blood,-0.081,298,5780,1,1,0.219,0.684,0.585,6078
clean,-0.081,256,4968,1,1,0.827,0.17,0.5,5224
shoes,-0.081,93,1817,1,1,0.729,0.324,0.21,1910
rabbit,-0.082,39,773,1,1,0.685,0.33,0.241,812
moving,-0.082,481,9326,1,1,0.479,0.673,0.358,9807
deactivate,-0.082,16,328,1,1,0.235,0.447,0.392,344
neglected,-0.082,30,599,1,1,0.271,0.385,0.16,629
anniversary,-0.082,63,1238,1,1,0.88,0.77,0.723,1301
faculty,-0.082,10,212,1,1,0.615,0.412,0.732,222
naming,-0.082,10,212,1,1,0.667,0.41,0.559,222
assets,-0.082,10,212,1,1,0.667,0.613,0.765,222
addiction,-0.082,124,2420,1,1,0.18,0.806,0.42,2544
felicity,-0.083,7,154,1,1,0.913,0.704,0.793,161
classy,-0.083,7,154,1,1,0.917,0.41,0.649,161
irritating,-0.083,28,561,1,1,0.104,0.912,0.393,589
vehicle,-0.083,20,406,1,1,0.641,0.565,0.5,426
prevent,-0.083,59,1162,1,1,0.635,0.481,0.575,1221
stripper,-0.084,4,96,1,1,0.625,0.848,0.453,100
indoctrination,-0.084,4,96,1,1,0.327,0.657,0.698,100
bereavement,-0.084,4,96,1,1,0.265,0.677,0.5,100
opinion,-0.084,387,7527,1,1,0.594,0.482,0.638,7914
intelligent,-0.085,64,1261,1,1,0.917,0.541,0.868,1325
timing,-0.086,43,854,1,1,0.521,0.311,0.577,897
behavior,-0.086,124,2428,1,1,0.594,0.442,0.813,2552
surround,-0.086,175,3420,1,1,0.542,0.623,0.627,3595
plenty,-0.086,236,4606,1,1,0.827,0.612,0.824,4842
means,-0.086,1285,24999,1,1,0.615,0.373,0.46,26284
waltz,-0.087,12,252,1,1,0.769,0.41,0.315,264
giggle,-0.088,14,291,1,1,0.719,0.618,0.36,305
future,-0.088,668,13024,1,1,0.888,0.644,0.786,13692
affect,-0.088,82,1616,1,1,0.458,0.569,0.578,1698
chicken,-0.088,98,1928,1,1,0.594,0.306,0.394,2026
directly,-0.089,72,1422,1,1,0.747,0.4,0.702,1494
numbers,-0.089,147,2884,1,1,0.406,0.241,0.44,3031
flog,-0.089,1,38,1,1,0.408,0.52,0.382,39
hydrate,-0.089,1,38,1,1,0.61,0.367,0.547,39
checkup,-0.089,1,38,1,1,0.5,0.435,0.491,39
oversized,-0.089,5,116,1,1,0.552,0.54,0.679,121
snot,-0.089,3,77,1,1,0.214,0.34,0.269,80
robber,-0.089,1,38,1,1,0.135,0.772,0.481,39
thwart,-0.089,1,38,1,1,0.281,0.684,0.409,39
legislature,-0.089,1,38,1,1,0.54,0.435,0.698,39
antichrist,-0.089,1,38,1,1,0.082,0.837,0.544,39
jade,-0.089,11,233,1,1,0.604,0.41,0.455,244
panty,-0.089,1,38,1,1,0.451,0.557,0.303,39
sewage,-0.089,1,38,1,1,0.255,0.343,0.339,39
commando,-0.089,1,38,1,1,0.323,0.71,0.817,39
ace,-0.089,39,779,1,1,0.643,0.481,0.546,818
koala,-0.089,1,38,1,1,0.608,0.21,0.311,39
approve,-0.089,13,272,1,1,0.875,0.548,0.741,285
vaginal,-0.089,1,38,1,1,0.449,0.765,0.42,39
picket,-0.089,1,38,1,1,0.365,0.615,0.451,39
rotten,-0.089,21,428,1,1,0.104,0.59,0.327,449
saggy,-0.089,1,38,1,1,0.37,0.429,0.3,39
scooter,-0.089,5,116,1,1,0.51,0.587,0.371,121
overturn,-0.089,1,38,1,1,0.24,0.765,0.396,39
incontinence,-0.089,1,38,1,1,0.15,0.598,0.272,39
apparel,-0.089,1,38,1,1,0.698,0.435,0.453,39
inside,-0.09,1054,20579,1,1,0.612,0.404,0.472,21633
urge,-0.09,117,2301,1,1,0.418,0.68,0.653,2418
annoys,-0.09,30,604,1,1,0.146,0.778,0.435,634
full,-0.09,1273,24867,1,1,0.602,0.255,0.704,26140
climate,-0.091,59,1171,1,1,0.635,0.24,0.483,1230
sofa,-0.091,27,546,1,1,0.583,0.106,0.263,573
defense,-0.091,55,1093,1,1,0.652,0.698,0.802,1148
admin,-0.091,25,507,1,1,0.688,0.42,0.854,532
ended,-0.091,244,4787,1,1,0.302,0.5,0.5,5031
carpet,-0.092,15,312,1,1,0.52,0.17,0.339,327
flag,-0.092,54,1075,1,1,0.592,0.378,0.536,1129
community,-0.093,649,12717,1,1,0.75,0.35,0.659,13366
night,-0.093,3286,64359,1,1,0.598,0.396,0.404,67645
sink,-0.094,103,2036,1,1,0.375,0.439,0.322,2139
naked,-0.094,224,4407,1,1,0.323,0.885,0.288,4631
stalk,-0.094,9,195,1,1,0.436,0.272,0.395,204
stocking,-0.094,4,97,1,1,0.594,0.324,0.688,101
probable,-0.094,4,97,1,1,0.583,0.433,0.481,101
disagreeing,-0.094,4,97,1,1,0.255,0.643,0.35,101
juvenile,-0.094,4,97,1,1,0.678,0.49,0.526,101
monstrous,-0.094,4,97,1,1,0.094,0.942,0.649,101
drop,-0.095,254,4998,1,1,0.479,0.321,0.291,5252
follow,-0.095,558,10958,1,1,0.667,0.509,0.6,11516
lily,-0.095,22,450,1,1,0.64,0.245,0.263,472
unrelated,-0.095,12,254,1,1,0.302,0.27,0.264,266
stake,-0.095,12,254,1,1,0.406,0.608,0.46,266
masculinity,-0.095,12,254,1,1,0.583,0.67,0.851,266
caps,-0.095,12,254,1,1,0.51,0.221,0.368,266
third,-0.095,137,2706,1,1,0.551,0.187,0.304,2843
improved,-0.095,20,411,1,1,0.919,0.48,0.679,431
hop,-0.095,44,882,1,1,0.45,0.52,0.427,926
ether,-0.096,7,156,1,1,0.49,0.306,0.412,163
beef,-0.096,23,470,1,1,0.582,0.312,0.492,493
bonkers,-0.096,7,156,1,1,0.306,0.847,0.278,163
jail,-0.096,148,2924,1,1,0.094,0.898,0.48,3072
broadcast,-0.096,18,372,1,1,0.615,0.587,0.355,390
celebrate,-0.096,198,3907,1,1,0.917,0.857,0.859,4105
replacement,-0.097,16,333,1,1,0.385,0.519,0.5,349
tragic,-0.097,70,1394,1,1,0.048,0.904,0.396,1464
discounted,-0.098,2,58,1,1,0.677,0.471,0.43,60
ergo,-0.098,2,58,1,1,0.385,0.4,0.385,60
squeal,-0.098,2,58,1,1,0.25,0.731,0.375,60
arseholes,-0.098,2,58,1,1,0.188,0.545,0.351,60
trim,-0.098,2,58,1,1,0.5,0.466,0.43,60
overhaul,-0.098,2,58,1,1,0.5,0.651,0.491,60
culprit,-0.098,5,117,1,1,0.062,0.676,0.333,122
repress,-0.098,2,58,1,1,0.208,0.612,0.536,60
bingo,-0.098,5,117,1,1,0.735,0.667,0.429,122
dislike,-0.098,99,1966,1,1,0.156,0.406,0.321,2065
belief,-0.098,90,1790,1,1,0.896,0.375,0.656,1880
alcoholic,-0.099,25,511,1,1,0.153,0.688,0.361,536
incorrect,-0.099,12,255,1,1,0.14,0.569,0.255,267
amaze,-0.099,9,196,1,1,0.896,0.843,0.783,205
white,-0.099,625,12332,1,1,0.729,0.173,0.42,12957
catchy,-0.1,6,137,1,1,0.677,0.441,0.462,143
institution,-0.1,13,275,1,1,0.58,0.311,0.79,288
impact,-0.101,121,2405,1,1,0.469,0.884,0.776,2526
lash,-0.101,10,216,1,1,0.235,0.794,0.609,226
cheek,-0.101,40,808,1,1,0.67,0.314,0.421,848
sweetest,-0.101,44,887,1,1,0.959,0.5,0.37,931
sell,-0.101,99,1973,1,1,0.618,0.608,0.605,2072
montage,-0.102,3,78,1,1,0.438,0.52,0.388,81
bouquet,-0.102,3,78,1,1,0.724,0.352,0.306,81
fetal,-0.102,3,78,1,1,0.388,0.308,0.364,81
yeahhhh,-0.102,3,78,1,1,0.865,0.721,0.44,81
clingy,-0.102,67,1342,1,1,0.224,0.46,0.37,1409
leader,-0.102,138,2745,1,1,0.833,0.582,0.926,2883
giving,-0.102,605,11971,1,1,0.795,0.333,0.585,12576
confide,-0.102,32,651,1,1,0.669,0.472,0.595,683
overcome,-0.103,187,3714,1,1,0.719,0.689,0.848,3901
bastards,-0.104,23,474,1,1,0.082,0.68,0.422,497
bait,-0.104,9,197,1,1,0.276,0.327,0.296,206
edible,-0.104,4,98,1,1,0.75,0.425,0.497,102
homecoming,-0.104,9,197,1,1,0.76,0.413,0.472,206
wand,-0.104,4,98,1,1,0.542,0.322,0.315,102
second,-0.105,624,12384,1,1,0.49,0.21,0.25,13008
real,-0.105,1982,39298,1,1,0.719,0.51,0.717,41280
gasp,-0.105,10,217,1,1,0.44,0.754,0.298,227
distressed,-0.105,10,217,1,1,0.143,0.771,0.324,227
sympathetic,-0.106,11,237,1,1,0.796,0.434,0.609,248
frown,-0.106,11,237,1,1,0.214,0.602,0.433,248
believable,-0.106,5,118,1,1,0.866,0.39,0.676,123
lungs,-0.106,54,1090,1,1,0.531,0.352,0.555,1144
smirk,-0.107,12,257,1,1,0.792,0.596,0.583,269
blast,-0.107,73,1468,1,1,0.167,0.929,0.777,1541
changer,-0.107,6,138,1,1,0.583,0.519,0.567,144
undermine,-0.107,6,138,1,1,0.316,0.491,0.413,144
step,-0.107,487,9690,1,1,0.531,0.321,0.347,10177
din,-0.108,42,853,1,1,0.44,0.417,0.398,895
bread,-0.108,81,1629,1,1,0.66,0.314,0.342,1710
coincidence,-0.109,16,337,1,1,0.612,0.45,0.518,353
application,-0.109,16,337,1,1,0.646,0.445,0.726,353
amazing,-0.109,1095,21796,1,1,0.906,0.837,0.849,22891
christian,-0.11,125,2507,1,1,0.76,0.241,0.591,2632
face,-0.11,1179,23488,1,1,0.571,0.173,0.453,24667
marriage,-0.11,231,4618,1,1,0.844,0.684,0.75,4849
bother,-0.11,304,6073,1,1,0.208,0.78,0.37,6377
arranged,-0.11,11,238,1,1,0.698,0.531,0.728,249
cringe,-0.11,35,716,1,1,0.245,0.84,0.377,751
admitting,-0.11,35,716,1,1,0.62,0.5,0.546,751
hurricane,-0.111,24,497,1,1,0.177,0.958,0.787,521
disgraceful,-0.111,14,298,1,1,0.082,0.702,0.24,312
person,-0.111,3662,73026,1,1,0.646,0.363,0.596,76688
guilty,-0.112,171,3429,1,1,0.135,0.77,0.352,3600
ahhh,-0.113,59,1197,1,1,0.562,0.517,0.241,1256
egg,-0.113,31,638,1,1,0.684,0.241,0.293,669
incumbent,-0.115,1,39,1,1,0.396,0.54,0.565,40
frugal,-0.115,1,39,1,1,0.48,0.355,0.355,40
cookout,-0.115,1,39,1,1,0.68,0.406,0.482,40
hooray,-0.115,8,179,1,1,0.61,0.481,0.536,187
estimation,-0.115,1,39,1,1,0.74,0.48,0.589,40
victorious,-0.115,9,199,1,1,0.884,0.886,0.946,208
snag,-0.115,1,39,1,1,0.417,0.25,0.339,40
explosions,-0.115,2,59,1,1,0.123,0.86,0.594,61
supplier,-0.115,1,39,1,1,0.615,0.462,0.736,40
loathsome,-0.115,2,59,1,1,0.12,0.694,0.343,61
feather,-0.115,11,239,1,1,0.677,0.208,0.144,250
orphanage,-0.115,3,79,1,1,0.184,0.439,0.425,82
naughty,-0.115,16,339,1,1,0.451,0.857,0.371,355
betting,-0.115,12,259,1,1,0.237,0.804,0.411,271
section,-0.115,59,1199,1,1,0.5,0.269,0.421,1258
onstage,-0.115,2,59,1,1,0.719,0.673,0.583,61
tampon,-0.115,1,39,1,1,0.396,0.394,0.345,40
hazard,-0.115,8,179,1,1,0.112,0.884,0.757,187
technician,-0.115,1,39,1,1,0.592,0.51,0.713,40
celery,-0.115,2,59,1,1,0.396,0.147,0.223,61
sheriff,-0.115,4,99,1,1,0.602,0.541,0.802,103
afloat,-0.115,11,239,1,1,0.602,0.427,0.444,250
swinging,-0.115,13,279,1,1,0.656,0.51,0.312,292
grease,-0.115,3,79,1,1,0.255,0.404,0.306,82
infantry,-0.115,1,39,1,1,0.531,0.684,0.791,40
peachy,-0.115,1,39,1,1,0.755,0.479,0.388,40
interim,-0.115,2,59,1,1,0.604,0.4,0.524,61
notch,-0.115,6,139,1,1,0.459,0.361,0.358,145
aggravation,-0.115,1,39,1,1,0.071,0.784,0.613,40
monkey,-0.115,21,439,1,1,0.548,0.449,0.283,460
quitter,-0.115,1,39,1,1,0.26,0.46,0.321,40
confusing,-0.115,73,1479,1,1,0.229,0.69,0.222,1552
predictive,-0.115,2,59,1,1,0.479,0.454,0.736,61
safe,-0.115,784,15701,1,1,0.898,0.306,0.759,16485
smoke,-0.115,196,3940,1,1,0.188,0.5,0.391,4136
selfish,-0.115,248,4981,1,1,0.061,0.637,0.495,5229
snake,-0.116,34,700,1,1,0.276,0.75,0.549,734
fence,-0.117,22,460,1,1,0.5,0.198,0.398,482
sos,-0.117,21,440,1,1,0.354,0.675,0.386,461
package,-0.118,30,621,1,1,0.571,0.433,0.443,651
progressive,-0.118,30,621,1,1,0.755,0.606,0.81,651
crib,-0.118,38,782,1,1,0.653,0.24,0.407,820
ambulance,-0.119,10,220,1,1,0.5,0.75,0.609,230
dead,-0.119,638,12842,1,1,0.052,0.454,0.194,13480
annoyed,-0.12,146,2954,1,1,0.104,0.783,0.345,3100
timer,-0.12,8,180,1,1,0.469,0.433,0.5,188
fluff,-0.12,8,180,1,1,0.52,0.264,0.172,188
office,-0.12,436,8790,1,1,0.427,0.302,0.509,9226
junkie,-0.121,7,160,1,1,0.135,0.86,0.363,167
rumor,-0.121,7,160,1,1,0.255,0.582,0.282,167
first,-0.121,2723,54834,1,1,0.625,0.5,0.788,57557
client,-0.121,21,442,1,1,0.583,0.45,0.618,463
undecided,-0.122,6,140,1,1,0.286,0.433,0.127,146
gamble,-0.122,6,140,1,1,0.568,0.798,0.361,146
fart,-0.122,40,825,1,1,0.194,0.439,0.264,865
sabotage,-0.122,12,261,1,1,0.135,0.906,0.5,273
validate,-0.122,25,523,1,1,0.76,0.431,0.745,548
man,-0.123,3404,68664,1,1,0.688,0.427,0.767,72068
virgin,-0.123,53,1088,1,1,0.622,0.433,0.462,1141
accuracy,-0.123,5,120,1,1,0.604,0.481,0.802,125
times,-0.123,2650,53479,1,1,0.49,0.279,0.439,56129
teary,-0.124,10,221,1,1,0.167,0.473,0.216,231
resisting,-0.124,10,221,1,1,0.408,0.776,0.789,231
tv,-0.124,422,8540,1,1,0.622,0.38,0.393,8962
shaky,-0.124,9,201,1,1,0.26,0.734,0.223,210
incident,-0.125,32,666,1,1,0.084,0.662,0.482,698
era,-0.125,64,1313,1,1,0.615,0.407,0.449,1377
constantly,-0.125,567,11482,1,1,0.663,0.561,0.7,12049
violate,-0.126,8,181,1,1,0.061,0.97,0.519,189
insists,-0.126,8,181,1,1,0.49,0.587,0.61,189
cheerleader,-0.126,8,181,1,1,0.923,0.746,0.657,189
receiving,-0.126,48,990,1,1,0.719,0.562,0.623,1038
bald,-0.126,16,343,1,1,0.306,0.184,0.268,359
injustice,-0.127,28,586,1,1,0.082,0.755,0.444,614
cancel,-0.127,64,1315,1,1,0.214,0.306,0.368,1379
incentive,-0.127,3,80,1,1,0.812,0.618,0.718,83
gasping,-0.127,3,80,1,1,0.208,0.704,0.379,83
nauseating,-0.127,3,80,1,1,0.021,0.64,0.25,83
posse,-0.127,3,80,1,1,0.398,0.51,0.473,83
colt,-0.127,3,80,1,1,0.561,0.587,0.543,83
squishy,-0.127,3,80,1,1,0.516,0.333,0.307,83
received,-0.127,95,1944,1,1,0.646,0.436,0.561,2039
shove,-0.128,17,364,1,1,0.306,0.69,0.602,381
curry,-0.129,13,283,1,1,0.633,0.345,0.302,296
devastating,-0.129,39,811,1,1,0.104,0.856,0.419,850
tooth,-0.13,12,263,1,1,0.439,0.25,0.367,275
terribly,-0.13,41,852,1,1,0.061,0.731,0.43,893
economic,-0.13,28,588,1,1,0.561,0.408,0.639,616
old,-0.13,1649,33522,1,1,0.41,0.279,0.315,35171
op,-0.13,27,568,1,1,0.48,0.402,0.349,595
expected,-0.131,119,2438,1,1,0.729,0.412,0.545,2557
brake,-0.131,5,121,1,1,0.312,0.481,0.31,126
elbow,-0.131,5,121,1,1,0.448,0.133,0.254,126
dickhead,-0.131,8,182,1,1,0.115,0.608,0.284,190
secondhand,-0.131,2,60,1,1,0.194,0.389,0.283,62
expose,-0.131,29,609,1,1,0.344,0.643,0.537,638
legislative,-0.131,2,60,1,1,0.633,0.365,0.8,62
zodiac,-0.131,8,182,1,1,0.594,0.429,0.426,190
sock,-0.131,11,243,1,1,0.5,0.167,0.29,254
paperwork,-0.131,8,182,1,1,0.448,0.355,0.422,190
dresser,-0.131,2,60,1,1,0.604,0.398,0.473,62
intending,-0.131,2,60,1,1,0.51,0.567,0.597,62
taps,-0.131,5,121,1,1,0.448,0.378,0.409,126
dispose,-0.131,2,60,1,1,0.548,0.538,0.559,62
scalp,-0.131,2,60,1,1,0.347,0.346,0.302,62
handler,-0.131,2,60,1,1,0.439,0.593,0.861,62
snuggle,-0.131,20,426,1,1,0.781,0.39,0.35,446
invite,-0.131,133,2724,1,1,0.745,0.655,0.611,2857
ruin,-0.131,161,3294,1,1,0.125,0.588,0.192,3455
awake,-0.132,187,3824,1,1,0.667,0.469,0.741,4011
related,-0.132,125,2563,1,1,0.677,0.365,0.519,2688
bedroom,-0.132,199,4070,1,1,0.744,0.296,0.491,4269
part,-0.132,1717,34975,1,1,0.663,0.278,0.36,36692
audacity,-0.133,18,386,1,1,0.76,0.755,0.916,404
blink,-0.133,23,488,1,1,0.552,0.316,0.324,511
pilot,-0.133,15,325,1,1,0.688,0.68,0.736,340
contribute,-0.134,30,631,1,1,0.806,0.35,0.795,661
variety,-0.134,37,774,1,1,0.714,0.472,0.598,811
mislead,-0.134,4,101,1,1,0.167,0.765,0.412,105
plumber,-0.134,4,101,1,1,0.327,0.51,0.448,105
commander,-0.134,9,203,1,1,0.531,0.615,0.906,212
snort,-0.134,4,101,1,1,0.469,0.531,0.413,105
fend,-0.135,11,244,1,1,0.646,0.731,0.537,255
opener,-0.135,11,244,1,1,0.584,0.526,0.377,255
judgmental,-0.135,11,244,1,1,0.33,0.602,0.579,255
oven,-0.135,18,387,1,1,0.583,0.425,0.606,405
insidious,-0.136,6,142,1,1,0.146,0.622,0.48,148
multiply,-0.136,6,142,1,1,0.802,0.625,0.777,148
blatant,-0.136,13,285,1,1,0.327,0.677,0.675,298
assemble,-0.136,6,142,1,1,0.542,0.57,0.75,148
player,-0.136,97,2002,1,1,0.557,0.688,0.644,2099
special,-0.137,506,10367,1,1,0.844,0.602,0.73,10873
bathtub,-0.137,10,224,1,1,0.625,0.24,0.318,234
pretended,-0.137,10,224,1,1,0.167,0.556,0.227,234
outright,-0.137,10,224,1,1,0.767,0.396,0.755,234
grab,-0.137,96,1984,1,1,0.448,0.706,0.538,2080
thoughts,-0.138,2175,44572,1,1,0.745,0.382,0.691,46747
exclamation,-0.139,1,40,1,1,0.612,0.745,0.598,41
reflux,-0.139,1,40,1,1,0.281,0.559,0.347,41
stabilize,-0.139,1,40,1,1,0.839,0.427,0.722,41
bandit,-0.139,3,81,1,1,0.094,0.796,0.567,84
amend,-0.139,1,40,1,1,0.688,0.406,0.658,41
undeserved,-0.139,1,40,1,1,0.219,0.552,0.283,41
onboard,-0.139,1,40,1,1,0.612,0.451,0.491,41
hatch,-0.139,5,122,1,1,0.479,0.653,0.402,127
stooge,-0.139,1,40,1,1,0.438,0.406,0.163,41
jellyfish,-0.139,1,40,1,1,0.531,0.567,0.377,41
ball,-0.139,107,2213,1,1,0.74,0.427,0.317,2320
baggy,-0.139,1,40,1,1,0.521,0.278,0.452,41
hostel,-0.139,15,327,1,1,0.479,0.5,0.398,342
nonce,-0.139,1,40,1,1,0.422,0.37,0.377,41
shampoo,-0.139,5,122,1,1,0.604,0.18,0.25,127
periscope,-0.139,1,40,1,1,0.604,0.375,0.609,41
inflation,-0.139,3,81,1,1,0.219,0.792,0.508,84
delirious,-0.139,1,40,1,1,0.219,0.774,0.538,41
saber,-0.139,3,81,1,1,0.551,0.62,0.553,84
stoopid,-0.139,3,81,1,1,0.28,0.431,0.382,84
terrorize,-0.139,1,40,1,1,0.041,0.907,0.577,41
affirmative,-0.139,1,40,1,1,0.854,0.589,0.816,41
aircraft,-0.139,3,81,1,1,0.646,0.644,0.691,84
reek,-0.139,1,40,1,1,0.177,0.48,0.311,41
homeowner,-0.139,1,40,1,1,0.635,0.397,0.962,41
cilantro,-0.139,1,40,1,1,0.469,0.26,0.208,41
ammo,-0.139,3,81,1,1,0.323,0.765,0.621,84
dweeb,-0.139,1,40,1,1,0.354,0.446,0.327,41
duplex,-0.139,1,40,1,1,0.592,0.452,0.467,41
godforsaken,-0.139,1,40,1,1,0.439,0.52,0.422,41
unfairness,-0.139,1,40,1,1,0.17,0.817,0.336,41
actor,-0.141,33,697,1,1,0.653,0.561,0.629,730
booty,-0.141,14,307,1,1,0.663,0.587,0.784,321
assuming,-0.141,47,985,1,1,0.74,0.39,0.526,1032
globe,-0.141,23,492,1,1,0.76,0.315,0.364,515
nun,-0.141,45,944,1,1,0.5,0.15,0.406,989
kit,-0.142,17,369,1,1,0.583,0.344,0.42,386
killer,-0.142,60,1253,1,1,0.041,0.971,0.543,1313
diet,-0.143,43,904,1,1,0.429,0.235,0.398,947
swollen,-0.143,6,143,1,1,0.236,0.51,0.277,149
decline,-0.143,20,431,1,1,0.173,0.491,0.24,451
lag,-0.143,6,143,1,1,0.22,0.375,0.246,149
horrendous,-0.144,16,349,1,1,0.073,0.755,0.365,365
costume,-0.144,16,349,1,1,0.548,0.51,0.374,365
use,-0.144,1161,23924,1,1,0.438,0.358,0.409,25085
molestation,-0.144,4,102,1,1,0.102,0.808,0.407,106
unreasonable,-0.144,9,205,1,1,0.115,0.702,0.264,214
translator,-0.144,4,102,1,1,0.76,0.412,0.473,106
telegram,-0.144,4,102,1,1,0.561,0.542,0.55,106
straightforward,-0.144,4,102,1,1,0.78,0.15,0.38,106
unforgivable,-0.144,4,102,1,1,0.276,0.743,0.49,106
vindictive,-0.144,4,102,1,1,0.092,0.83,0.5,106
contract,-0.145,25,535,1,1,0.594,0.412,0.636,560
airport,-0.145,67,1401,1,1,0.729,0.684,0.682,1468
grocery,-0.145,62,1298,1,1,0.687,0.54,0.446,1360
ready,-0.145,866,17876,1,1,0.77,0.388,0.648,18742
hat,-0.145,52,1092,1,1,0.604,0.183,0.353,1144
roast,-0.146,13,288,1,1,0.521,0.541,0.311,301
burger,-0.147,19,412,1,1,0.688,0.568,0.398,431
cleaning,-0.147,104,2168,1,1,0.595,0.396,0.427,2272
widen,-0.147,2,61,1,1,0.562,0.538,0.527,63
adoptive,-0.147,2,61,1,1,0.531,0.469,0.52,63
capitalize,-0.147,2,61,1,1,0.771,0.601,0.885,63
medic,-0.147,2,61,1,1,0.5,0.472,0.585,63
complaint,-0.147,20,433,1,1,0.143,0.606,0.281,453
psychopathic,-0.147,2,61,1,1,0.077,0.918,0.508,63
hive,-0.147,8,185,1,1,0.471,0.452,0.544,193
comb,-0.147,2,61,1,1,0.49,0.123,0.268,63
cretin,-0.147,2,61,1,1,0.265,0.583,0.312,63
accounting,-0.147,5,123,1,1,0.552,0.39,0.677,128
chunky,-0.147,2,61,1,1,0.52,0.517,0.509,63
transaction,-0.147,2,61,1,1,0.65,0.577,0.579,63
minion,-0.147,2,61,1,1,0.49,0.43,0.167,63
brain,-0.148,455,9428,1,1,0.667,0.441,0.823,9883
bottom,-0.148,142,2956,1,1,0.417,0.37,0.291,3098
realistic,-0.148,27,578,1,1,0.7,0.52,0.783,605
verge,-0.148,27,578,1,1,0.5,0.337,0.305,605
pizza,-0.148,127,2646,1,1,0.847,0.39,0.295,2773
acknowledged,-0.148,15,330,1,1,0.714,0.443,0.765,345
good,-0.148,7387,152844,1,1,0.938,0.368,0.534,160231
confident,-0.149,116,2421,1,1,0.765,0.324,0.723,2537
divorce,-0.149,68,1428,1,1,0.042,0.7,0.385,1496
folder,-0.15,6,144,1,1,0.49,0.279,0.375,150
trustworthy,-0.15,13,289,1,1,0.969,0.315,0.824,302
believed,-0.15,106,2216,1,1,0.5,0.562,0.547,2322
believing,-0.15,116,2424,1,1,0.87,0.418,0.833,2540
slim,-0.15,10,227,1,1,0.562,0.18,0.296,237
oldies,-0.151,3,82,1,1,0.438,0.3,0.412,85
cesspool,-0.151,3,82,1,1,0.167,0.46,0.409,85
string,-0.151,19,414,1,1,0.385,0.398,0.445,433
other,-0.152,4650,96550,1,1,0.472,0.23,0.259,101200
cool,-0.152,816,16962,1,1,0.885,0.54,0.781,17778
alienate,-0.153,8,186,1,1,0.247,0.5,0.523,194
coming,-0.153,1144,23801,1,1,0.653,0.417,0.5,24945
pawn,-0.154,4,103,1,1,0.39,0.321,0.187,107
gel,-0.154,4,103,1,1,0.524,0.206,0.279,107
miss,-0.154,1573,32743,1,1,0.573,0.49,0.408,34316
turn,-0.154,756,15755,1,1,0.531,0.398,0.482,16511
minded,-0.155,70,1477,1,1,0.656,0.394,0.627,1547
immediately,-0.155,163,3413,1,1,0.552,0.78,0.707,3576
record,-0.155,109,2290,1,1,0.552,0.421,0.5,2399
outlet,-0.155,34,728,1,1,0.61,0.396,0.245,762
partner,-0.155,386,8062,1,1,0.673,0.302,0.586,8448
pro,-0.156,74,1562,1,1,0.667,0.471,0.692,1636
pop,-0.156,112,2354,1,1,0.673,0.51,0.491,2466
activist,-0.156,12,270,1,1,0.531,0.653,0.877,282
segment,-0.156,12,270,1,1,0.469,0.29,0.44,282
promote,-0.156,32,687,1,1,0.83,0.596,0.853,719
classroom,-0.156,39,833,1,1,0.539,0.292,0.363,872
chili,-0.157,6,145,1,1,0.592,0.566,0.433,151
uncomfortable,-0.157,202,4236,1,1,0.188,0.61,0.214,4438
hen,-0.157,7,166,1,1,0.385,0.276,0.241,173
crop,-0.157,7,166,1,1,0.615,0.26,0.5,173
insecurity,-0.158,32,688,1,1,0.094,0.647,0.35,720
debilitating,-0.159,20,438,1,1,0.125,0.49,0.308,458
mid,-0.159,43,919,1,1,0.5,0.315,0.356,962
file,-0.159,22,480,1,1,0.48,0.316,0.463,502
jay,-0.159,34,731,1,1,0.531,0.408,0.389,765
rule,-0.159,117,2467,1,1,0.567,0.427,0.593,2584
late,-0.159,644,13490,1,1,0.245,0.358,0.315,14134
hamster,-0.159,11,250,1,1,0.52,0.394,0.349,261
flipping,-0.159,11,250,1,1,0.553,0.551,0.345,261
prepared,-0.16,110,2323,1,1,0.71,0.48,0.733,2433
arrest,-0.16,15,334,1,1,0.146,0.951,0.5,349
regretting,-0.161,16,355,1,1,0.255,0.567,0.273,371
downfall,-0.161,17,376,1,1,0.2,0.717,0.182,393
flex,-0.161,18,397,1,1,0.604,0.378,0.33,415
naive,-0.161,25,544,1,1,0.406,0.26,0.375,569
cap,-0.162,52,1110,1,1,0.612,0.24,0.375,1162
difficult,-0.162,539,11321,1,1,0.235,0.7,0.508,11860
wing,-0.162,43,922,1,1,0.562,0.255,0.389,965
clue,-0.163,77,1636,1,1,0.653,0.38,0.412,1713
random,-0.163,245,5163,1,1,0.49,0.52,0.321,5408
leaky,-0.163,1,41,1,1,0.17,0.686,0.288,42
exaggerate,-0.163,2,62,1,1,0.193,0.76,0.529,64
riot,-0.163,11,251,1,1,0.061,0.946,0.586,262
wot,-0.163,3,83,1,1,0.52,0.48,0.357,86
chip,-0.163,19,419,1,1,0.479,0.382,0.452,438
liner,-0.163,5,125,1,1,0.469,0.396,0.4,130
skirts,-0.163,3,83,1,1,0.622,0.538,0.241,86
earring,-0.163,1,41,1,1,0.583,0.52,0.5,42
touchy,-0.163,6,146,1,1,0.323,0.51,0.343,152
reconsider,-0.163,10,230,1,1,0.448,0.442,0.582,240
intolerance,-0.163,7,167,1,1,0.052,0.704,0.52,174
troubles,-0.163,53,1133,1,1,0.051,0.854,0.269,1186
beam,-0.163,13,293,1,1,0.584,0.349,0.382,306
gorilla,-0.163,2,62,1,1,0.565,0.72,0.648,64
politic,-0.163,1,41,1,1,0.365,0.581,0.798,42
skirt,-0.163,7,167,1,1,0.602,0.463,0.226,174
vending,-0.163,1,41,1,1,0.417,0.565,0.549,42
logistics,-0.163,2,62,1,1,0.633,0.5,0.73,64
circulation,-0.163,1,41,1,1,0.735,0.52,0.657,42
coordinator,-0.163,2,62,1,1,0.75,0.51,0.85,64
beater,-0.163,1,41,1,1,0.438,0.545,0.482,42
revulsion,-0.163,1,41,1,1,0.104,0.765,0.343,42
demonstration,-0.163,3,83,1,1,0.551,0.676,0.679,86
textbook,-0.163,4,104,1,1,0.622,0.235,0.526,108
waitress,-0.163,6,146,1,1,0.646,0.531,0.352,152
neurological,-0.163,2,62,1,1,0.5,0.54,0.558,64
foremost,-0.163,7,167,1,1,0.735,0.593,0.907,174
midget,-0.163,2,62,1,1,0.396,0.295,0.254,64
beep,-0.163,5,125,1,1,0.595,0.541,0.304,130
unjustified,-0.163,1,41,1,1,0.288,0.541,0.314,42
substantial,-0.163,5,125,1,1,0.59,0.49,0.69,130
plank,-0.163,1,41,1,1,0.427,0.28,0.333,42
correct,-0.163,121,2561,1,1,0.857,0.306,0.723,2682
lube,-0.163,2,62,1,1,0.552,0.49,0.411,64
mine,-0.163,770,16192,1,1,0.688,0.418,0.578,16962
happier,-0.164,177,3738,1,1,0.99,0.76,0.806,3915
cheese,-0.164,76,1617,1,1,0.74,0.28,0.281,1693
screaming,-0.164,166,3510,1,1,0.245,0.901,0.46,3676
take,-0.165,4383,92255,1,1,0.828,0.537,0.348,96638
stab,-0.166,20,441,1,1,0.167,0.882,0.595,461
stays,-0.166,104,2209,1,1,0.633,0.363,0.564,2313
anonymous,-0.166,32,694,1,1,0.396,0.291,0.431,726
official,-0.166,64,1368,1,1,0.646,0.565,0.833,1432
headaches,-0.166,15,336,1,1,0.104,0.72,0.259,351
headache,-0.168,39,843,1,1,0.168,0.755,0.273,882
relieving,-0.168,18,400,1,1,0.74,0.255,0.455,418
independent,-0.169,282,5973,1,1,0.885,0.44,0.872,6255
nice,-0.169,1754,37049,1,1,0.93,0.442,0.65,38803
hallmark,-0.169,8,189,1,1,0.646,0.315,0.411,197
ban,-0.169,26,569,1,1,0.146,0.689,0.587,595
nonsense,-0.169,77,1646,1,1,0.214,0.531,0.155,1723
door,-0.169,589,12462,1,1,0.549,0.189,0.421,13051
antics,-0.169,7,168,1,1,0.448,0.74,0.236,175
dairy,-0.169,7,168,1,1,0.633,0.255,0.462,175
affordable,-0.17,14,316,1,1,0.84,0.398,0.493,330
accompany,-0.17,77,1648,1,1,0.833,0.406,0.585,1725
concern,-0.17,83,1775,1,1,0.25,0.734,0.463,1858
bastard,-0.17,34,739,1,1,0.094,0.692,0.289,773
cow,-0.17,19,422,1,1,0.449,0.23,0.3,441
badass,-0.171,25,549,1,1,0.255,0.775,0.745,574
compare,-0.171,69,1480,1,1,0.552,0.408,0.524,1549
sixteen,-0.171,5,126,1,1,0.583,0.29,0.324,131
deceiving,-0.171,5,126,1,1,0.099,0.636,0.426,131
tutor,-0.171,5,126,1,1,0.75,0.346,0.826,131
fail,-0.171,151,3217,1,1,0.177,0.578,0.154,3368
eyes,-0.172,1032,21882,1,1,0.76,0.279,0.432,22914
welfare,-0.172,15,338,1,1,0.802,0.378,0.679,353
download,-0.172,25,550,1,1,0.602,0.49,0.503,575
pot,-0.173,34,741,1,1,0.5,0.186,0.294,775
exploitation,-0.173,4,105,1,1,0.156,0.92,0.718,109
biological,-0.173,14,317,1,1,0.59,0.41,0.615,331
forgiving,-0.173,13,296,1,1,0.885,0.317,0.556,309
ship,-0.174,119,2545,1,1,0.646,0.5,0.439,2664
misleading,-0.174,8,190,1,1,0.07,0.66,0.272,198
unbelievable,-0.174,26,572,1,1,0.771,0.79,0.717,598
haircut,-0.174,8,190,1,1,0.677,0.343,0.307,198
rational,-0.174,21,466,1,1,0.775,0.347,0.632,487
nail,-0.174,25,551,1,1,0.469,0.397,0.282,576
poisoned,-0.175,7,169,1,1,0.057,0.808,0.402,176
intimidation,-0.175,3,84,1,1,0.177,0.791,0.644,87
dormitory,-0.175,3,84,1,1,0.633,0.204,0.382,87
hip,-0.175,27,594,1,1,0.448,0.415,0.345,621
stopping,-0.176,53,1147,1,1,0.388,0.382,0.473,1200
optimistic,-0.176,22,488,1,1,0.979,0.58,0.821,510
children,-0.176,617,13140,1,1,0.857,0.538,0.435,13757
dreading,-0.176,21,467,1,1,0.125,0.76,0.377,488
respected,-0.176,39,850,1,1,0.908,0.441,0.853,889
apt,-0.177,52,1127,1,1,0.582,0.418,0.382,1179
washing,-0.177,44,957,1,1,0.643,0.396,0.402,1001
mocked,-0.177,16,361,1,1,0.225,0.746,0.204,377
inspirational,-0.178,29,638,1,1,0.927,0.72,0.81,667
glamour,-0.178,9,212,1,1,0.823,0.606,0.623,221
piece,-0.178,481,10272,1,1,0.646,0.245,0.367,10753
congrats,-0.178,71,1534,1,1,0.93,0.726,0.775,1605
loony,-0.179,2,63,1,1,0.439,0.474,0.295,65
pout,-0.179,5,127,1,1,0.458,0.354,0.202,132
removal,-0.179,5,127,1,1,0.245,0.54,0.368,132
simulator,-0.179,2,63,1,1,0.677,0.559,0.583,65
townhouse,-0.179,2,63,1,1,0.622,0.4,0.443,65
spineless,-0.179,8,191,1,1,0.344,0.387,0.321,199
unopened,-0.179,2,63,1,1,0.542,0.34,0.265,65
buffer,-0.179,2,63,1,1,0.52,0.474,0.35,65
blender,-0.179,2,63,1,1,0.602,0.534,0.351,65
aid,-0.181,40,875,1,1,0.796,0.491,0.541,915
earlier,-0.181,152,3269,1,1,0.562,0.352,0.339,3421
unite,-0.181,36,790,1,1,0.781,0.375,0.61,826
leaving,-0.182,547,11718,1,1,0.163,0.542,0.371,12265
serial,-0.182,32,705,1,1,0.469,0.35,0.472,737
stitch,-0.182,9,213,1,1,0.306,0.538,0.357,222
nag,-0.182,19,427,1,1,0.271,0.451,0.472,446
gracias,-0.182,4,106,1,1,0.833,0.356,0.6,110
scenario,-0.182,39,855,1,1,0.667,0.51,0.683,894
fetus,-0.182,4,106,1,1,0.479,0.519,0.395,110
accurate,-0.182,46,1005,1,1,0.743,0.36,0.737,1051
changed,-0.182,303,6506,1,1,0.594,0.375,0.491,6809
dick,-0.183,161,3467,1,1,0.208,0.5,0.462,3628
allowed,-0.183,310,6657,1,1,0.73,0.36,0.655,6967
pillow,-0.183,70,1519,1,1,0.663,0.128,0.195,1589
ditch,-0.183,30,663,1,1,0.357,0.364,0.322,693
point,-0.183,1558,33402,1,1,0.49,0.193,0.431,34960
young,-0.184,693,14873,1,1,0.812,0.52,0.537,15566
matching,-0.184,15,342,1,1,0.719,0.735,0.418,357
move,-0.184,898,19281,1,1,0.656,0.647,0.67,20179
depressive,-0.185,39,857,1,1,0.143,0.434,0.202,896
suggestion,-0.185,21,471,1,1,0.646,0.365,0.558,492
fear,-0.187,1466,31538,1,1,0.073,0.84,0.293,33004
grenade,-0.187,1,42,1,1,0.281,0.777,0.694,43
demeaning,-0.187,3,85,1,1,0.104,0.645,0.308,88
aroused,-0.187,1,42,1,1,0.708,0.952,0.667,43
skunk,-0.187,1,42,1,1,0.284,0.491,0.38,43
corresponding,-0.187,1,42,1,1,0.74,0.423,0.618,43
dashboard,-0.187,1,42,1,1,0.51,0.371,0.595,43
sill,-0.187,1,42,1,1,0.433,0.375,0.324,43
skeptic,-0.187,1,42,1,1,0.135,0.44,0.5,43
deviate,-0.187,1,42,1,1,0.173,0.562,0.269,43
plush,-0.187,5,128,1,1,0.625,0.265,0.318,133
squeak,-0.187,1,42,1,1,0.271,0.679,0.3,43
cellmate,-0.187,1,42,1,1,0.167,0.684,0.349,43
administrative,-0.187,1,42,1,1,0.542,0.415,0.579,43
stock,-0.187,39,859,1,1,0.594,0.418,0.407,898
hockey,-0.188,18,408,1,1,0.565,0.786,0.548,426
experiences,-0.188,283,6113,1,1,0.793,0.647,0.795,6396
moods,-0.188,67,1463,1,1,0.578,0.633,0.491,1530
ratio,-0.189,10,236,1,1,0.56,0.461,0.741,246
prominent,-0.189,8,193,1,1,0.676,0.627,0.779,201
goofy,-0.19,24,538,1,1,0.281,0.224,0.179,562
brag,-0.19,15,344,1,1,0.347,0.545,0.578,359
shine,-0.19,146,3169,1,1,0.844,0.539,0.741,3315
coo,-0.19,22,495,1,1,0.49,0.439,0.5,517
offender,-0.19,6,150,1,1,0.104,0.851,0.537,156
hyped,-0.191,23,517,1,1,0.708,0.582,0.679,540
budget,-0.192,29,647,1,1,0.643,0.396,0.731,676
blackmail,-0.192,4,107,1,1,0.094,0.802,0.482,111
alerts,-0.192,4,107,1,1,0.337,0.804,0.673,111
misguided,-0.192,9,215,1,1,0.28,0.531,0.259,224
unheard,-0.192,14,323,1,1,0.344,0.539,0.5,337
sleeper,-0.192,4,107,1,1,0.64,0.154,0.254,111
share,-0.192,1162,25128,1,1,0.759,0.548,0.545,26290
available,-0.192,235,5099,1,1,0.844,0.356,0.623,5334
republic,-0.192,17,388,1,1,0.635,0.34,0.83,405
brat,-0.192,12,280,1,1,0.312,0.44,0.231,292
give,-0.192,2630,56876,1,1,0.75,0.346,0.5,59506
overwhelmed,-0.192,128,2788,1,1,0.341,0.68,0.348,2916
drake,-0.193,18,410,1,1,0.467,0.411,0.452,428
status,-0.193,84,1838,1,1,0.658,0.377,0.588,1922
jealous,-0.193,96,2098,1,1,0.173,0.855,0.345,2194
alert,-0.194,44,973,1,1,0.479,0.82,0.648,1017
threatened,-0.194,36,800,1,1,0.052,0.928,0.354,836
slur,-0.195,2,64,1,1,0.115,0.814,0.427,66
disclaimer,-0.195,5,129,1,1,0.367,0.571,0.542,134
smooch,-0.195,2,64,1,1,0.796,0.731,0.491,66
enterprise,-0.195,5,129,1,1,0.76,0.392,0.754,134
basics,-0.195,8,194,1,1,0.688,0.311,0.491,202
parody,-0.195,8,194,1,1,0.561,0.651,0.375,202
outsider,-0.195,20,454,1,1,0.398,0.549,0.447,474
nickname,-0.195,8,194,1,1,0.49,0.47,0.263,202
mannequin,-0.195,2,64,1,1,0.427,0.302,0.295,66
hunch,-0.195,2,64,1,1,0.561,0.63,0.567,66
odds,-0.195,34,758,1,1,0.5,0.472,0.68,792
navy,-0.196,15,346,1,1,0.531,0.76,0.764,361
wink,-0.196,12,281,1,1,0.688,0.557,0.304,293
boost,-0.196,25,563,1,1,0.865,0.73,0.75,588
scandal,-0.196,12,281,1,1,0.122,0.821,0.557,293
motivation,-0.196,94,2060,1,1,0.854,0.784,0.802,2154
promo,-0.196,9,216,1,1,0.602,0.551,0.614,225
would,-0.197,6081,132045,1,1,0.493,0.412,0.427,138126
eyebrow,-0.197,6,151,1,1,0.51,0.198,0.222,157
come,-0.198,3644,79206,1,1,0.529,0.269,0.558,82850
sympathize,-0.198,14,325,1,1,0.77,0.627,0.644,339
put,-0.198,1406,30578,1,1,0.52,0.398,0.51,31984
dealings,-0.198,3,86,1,1,0.6,0.491,0.48,89
perpetrator,-0.198,3,86,1,1,0.229,0.765,0.538,89
sidekick,-0.198,3,86,1,1,0.602,0.439,0.509,89
lukewarm,-0.198,3,86,1,1,0.573,0.3,0.241,89
sewer,-0.198,3,86,1,1,0.286,0.367,0.282,89
touching,-0.198,67,1478,1,1,0.76,0.439,0.491,1545
flake,-0.198,11,260,1,1,0.385,0.388,0.289,271
lift,-0.199,109,2392,1,1,0.704,0.518,0.656,2501
education,-0.199,87,1914,1,1,0.896,0.275,0.84,2001
anatomy,-0.199,16,369,1,1,0.562,0.39,0.571,385
regard,-0.199,59,1305,1,1,0.802,0.336,0.809,1364
graphic,-0.199,12,282,1,1,0.602,0.494,0.491,294
entire,-0.199,532,11604,1,1,0.689,0.462,0.698,12136
bothering,-0.2,78,1720,1,1,0.208,0.764,0.449,1798
proven,-0.2,46,1023,1,1,0.724,0.311,0.611,1069
cake,-0.201,83,1830,1,1,0.81,0.375,0.287,1913
sweating,-0.201,14,326,1,1,0.292,0.667,0.265,340
stain,-0.201,9,217,1,1,0.453,0.324,0.264,226
category,-0.201,29,653,1,1,0.571,0.264,0.521,682
knee,-0.201,26,588,1,1,0.52,0.245,0.396,614
biz,-0.202,10,239,1,1,0.5,0.473,0.473,249
slack,-0.202,10,239,1,1,0.521,0.283,0.446,249
bases,-0.202,5,130,1,1,0.569,0.236,0.591,135
pea,-0.202,5,130,1,1,0.58,0.275,0.298,135
facility,-0.203,12,283,1,1,0.625,0.5,0.654,295
trigger,-0.203,47,1048,1,1,0.271,0.804,0.66,1095
prove,-0.204,138,3038,1,1,0.583,0.52,0.566,3176
t-shirt,-0.204,14,327,1,1,0.815,0.286,0.284,341
god,-0.204,3991,87350,1,1,0.758,0.518,0.886,91341
scum,-0.205,28,634,1,1,0.357,0.38,0.218,662
act,-0.206,474,10404,1,1,0.656,0.704,0.735,10878
today,-0.206,3209,70318,1,1,0.806,0.306,0.362,73527
nurse,-0.206,42,941,1,1,0.635,0.578,0.521,983
alarming,-0.206,10,240,1,1,0.204,0.89,0.585,250
pleased,-0.206,49,1095,1,1,0.939,0.548,0.795,1144
sunflower,-0.206,12,284,1,1,0.878,0.231,0.27,296
celebrity,-0.207,27,613,1,1,0.76,0.619,0.855,640
battled,-0.207,14,328,1,1,0.292,0.794,0.575,342
footage,-0.207,14,328,1,1,0.625,0.235,0.364,342
agenda,-0.207,51,1140,1,1,0.531,0.296,0.553,1191
minute,-0.207,299,6583,1,1,0.582,0.279,0.356,6882
joining,-0.208,63,1404,1,1,0.755,0.469,0.685,1467
agree,-0.208,505,11114,1,1,0.906,0.26,0.545,11619
snakes,-0.208,32,724,1,1,0.176,0.662,0.606,756
boat,-0.209,166,3671,1,1,0.516,0.42,0.554,3837
outcry,-0.21,1,43,1,1,0.271,0.773,0.718,44
congratulate,-0.21,6,153,1,1,0.927,0.724,0.784,159
truthful,-0.21,9,219,1,1,0.708,0.467,0.807,228
crumb,-0.21,1,43,1,1,0.417,0.255,0.216,44
cream,-0.21,88,1957,1,1,0.688,0.259,0.22,2045
balding,-0.21,1,43,1,1,0.302,0.363,0.368,44
apologist,-0.21,2,65,1,1,0.406,0.429,0.526,67
hourly,-0.21,3,87,1,1,0.469,0.418,0.491,90
endorsement,-0.21,2,65,1,1,0.834,0.36,0.611,67
pug,-0.21,3,87,1,1,0.6,0.298,0.462,90
overpaid,-0.21,1,43,1,1,0.429,0.67,0.585,44
humiliate,-0.21,3,87,1,1,0.052,0.714,0.275,90
clout,-0.21,13,307,1,1,0.584,0.636,0.704,320
derail,-0.21,1,43,1,1,0.108,0.802,0.375,44
wrongdoing,-0.21,1,43,1,1,0.112,0.745,0.451,44
splurge,-0.21,1,43,1,1,0.365,0.481,0.542,44
pronounced,-0.21,7,175,1,1,0.67,0.551,0.694,182
disdain,-0.21,11,263,1,1,0.153,0.446,0.441,274
livid,-0.21,5,131,1,1,0.469,0.788,0.49,136
yahoo,-0.21,3,87,1,1,0.643,0.583,0.522,90
peel,-0.21,5,131,1,1,0.439,0.25,0.279,136
overdrive,-0.21,3,87,1,1,0.303,0.715,0.732,90
idolizing,-0.21,1,43,1,1,0.676,0.712,0.643,44
heartless,-0.21,29,659,1,1,0.071,0.652,0.4,688
belong,-0.21,233,5148,1,1,0.643,0.405,0.569,5381
cost,-0.211,129,2861,1,1,0.365,0.42,0.439,2990
lonely,-0.212,3653,80537,1,1,0.25,0.226,0.238,84190
discussion,-0.212,54,1212,1,1,0.333,0.842,0.536,1266
replace,-0.212,51,1146,1,1,0.417,0.52,0.5,1197
thriller,-0.213,15,352,1,1,0.49,0.796,0.645,367
imagining,-0.213,31,705,1,1,0.765,0.458,0.545,736
suitable,-0.213,42,948,1,1,0.792,0.298,0.722,990
bean,-0.213,24,551,1,1,0.667,0.269,0.264,575
unlucky,-0.214,10,242,1,1,0.073,0.395,0.198,252
meat,-0.214,50,1126,1,1,0.612,0.421,0.413,1176
slide,-0.215,38,861,1,1,0.615,0.435,0.432,899
crumble,-0.215,17,397,1,1,0.333,0.48,0.423,414
designed,-0.216,63,1415,1,1,0.745,0.38,0.595,1478
insignificant,-0.216,30,685,1,1,0.083,0.306,0.114,715
drag,-0.216,89,1991,1,1,0.388,0.606,0.348,2080
start,-0.216,1366,30257,1,1,0.684,0.43,0.589,31623
glasses,-0.216,40,907,1,1,0.531,0.21,0.33,947
disrespect,-0.217,38,863,1,1,0.062,0.637,0.302,901
shut,-0.217,305,6780,1,1,0.24,0.352,0.311,7085
front,-0.217,387,8599,1,1,0.677,0.35,0.623,8986
goldfish,-0.217,5,132,1,1,0.786,0.296,0.317,137
defenseless,-0.217,5,132,1,1,0.143,0.357,0.105,137
snuggled,-0.217,5,132,1,1,0.552,0.439,0.314,137
go,-0.218,7429,164720,1,1,0.51,0.441,0.444,172149
murder,-0.218,75,1684,1,1,0.061,0.942,0.615,1759
abnormal,-0.218,16,376,1,1,0.137,0.604,0.309,392
super,-0.218,514,11426,1,1,0.844,0.663,0.78,11940
mainstream,-0.218,20,465,1,1,0.653,0.527,0.66,485
stressful,-0.219,97,2174,1,1,0.153,0.873,0.389,2271
blog,-0.219,55,1242,1,1,0.639,0.39,0.432,1297
transfer,-0.219,19,443,1,1,0.702,0.49,0.519,462
bumpy,-0.219,4,110,1,1,0.306,0.683,0.419,114
claim,-0.219,102,2286,1,1,0.255,0.76,0.473,2388
messy,-0.219,47,1065,1,1,0.26,0.635,0.14,1112
soulmate,-0.22,82,1843,1,1,0.89,0.5,0.628,1925
indecisive,-0.22,8,199,1,1,0.271,0.42,0.19,207
representing,-0.22,12,288,1,1,0.796,0.464,0.833,300
significant,-0.22,120,2689,1,1,0.827,0.649,0.786,2809
molester,-0.221,3,88,1,1,0.143,0.811,0.478,91
receipt,-0.221,3,88,1,1,0.542,0.23,0.415,91
powerless,-0.221,23,533,1,1,0.125,0.5,0.328,556
subscription,-0.221,11,266,1,1,0.583,0.333,0.651,277
virus,-0.221,11,266,1,1,0.277,0.74,0.443,277
dot,-0.221,15,355,1,1,0.434,0.29,0.391,370
lots,-0.221,484,10792,1,1,0.604,0.417,0.424,11276
lad,-0.222,21,489,1,1,0.637,0.388,0.336,510
mono,-0.222,35,801,1,1,0.5,0.39,0.273,836
judiciary,-0.223,6,155,1,1,0.439,0.74,0.897,161
options,-0.223,90,2027,1,1,0.622,0.327,0.473,2117
congratulations,-0.223,67,1515,1,1,0.96,0.755,0.719,1582
gypsy,-0.223,16,378,1,1,0.375,0.665,0.396,394
sob,-0.223,33,757,1,1,0.115,0.48,0.212,790
address,-0.224,69,1561,1,1,0.65,0.327,0.567,1630
alienated,-0.224,24,557,1,1,0.41,0.423,0.559,581
award,-0.224,33,758,1,1,0.865,0.745,0.66,791
likely,-0.225,273,6116,1,1,0.633,0.356,0.454,6389
understand,-0.225,2108,47084,1,1,0.76,0.374,0.643,49192
inconsistency,-0.225,2,66,1,1,0.125,0.48,0.314,68
sesame,-0.225,2,66,1,1,0.673,0.25,0.382,68
tinnitus,-0.225,5,133,1,1,0.384,0.536,0.411,138
surname,-0.225,2,66,1,1,0.67,0.25,0.493,68
gong,-0.225,2,66,1,1,0.49,0.529,0.462,68
husky,-0.225,5,133,1,1,0.63,0.45,0.49,138
egregious,-0.225,2,66,1,1,0.15,0.716,0.442,68
bail,-0.225,11,267,1,1,0.373,0.52,0.561,278
thinking,-0.225,1907,42629,1,1,0.72,0.308,0.595,44536
dancing,-0.225,164,3686,1,1,0.885,0.868,0.444,3850
morals,-0.226,21,491,1,1,0.646,0.43,0.611,512
greatful,-0.227,12,290,1,1,0.923,0.571,0.676,302
lining,-0.228,14,335,1,1,0.571,0.363,0.472,349
racial,-0.228,9,223,1,1,0.292,0.519,0.513,232
fearless,-0.228,24,559,1,1,0.81,0.806,0.76,583
discount,-0.229,11,268,1,1,0.724,0.53,0.302,279
screening,-0.229,11,268,1,1,0.562,0.57,0.709,279
patient,-0.229,119,2690,1,1,0.583,0.193,0.34,2809
calling,-0.229,273,6144,1,1,0.646,0.59,0.483,6417
sudden,-0.23,102,2310,1,1,0.449,0.66,0.435,2412
way,-0.231,5123,115107,1,1,0.48,0.275,0.42,120230
disaster,-0.231,42,965,1,1,0.082,0.892,0.433,1007
statement,-0.231,93,2111,1,1,0.688,0.608,0.825,2204
taboo,-0.231,18,426,1,1,0.198,0.794,0.482,444
creep,-0.231,51,1168,1,1,0.354,0.647,0.361,1219
year,-0.232,2503,56303,1,1,0.542,0.284,0.415,58806
cuff,-0.232,7,179,1,1,0.469,0.453,0.387,186
pouting,-0.232,3,89,1,1,0.263,0.471,0.27,92
negotiate,-0.232,7,179,1,1,0.612,0.708,0.769,186
freeway,-0.232,7,179,1,1,0.531,0.644,0.648,186
spank,-0.232,1,44,1,1,0.112,0.882,0.642,45
thrift,-0.232,1,44,1,1,0.76,0.217,0.649,45
profanity,-0.232,1,44,1,1,0.115,0.79,0.491,45
consensual,-0.232,3,89,1,1,0.663,0.417,0.655,92
goner,-0.232,1,44,1,1,0.41,0.461,0.274,45
graciously,-0.232,1,44,1,1,0.948,0.353,0.68,45
pap,-0.232,3,89,1,1,0.438,0.403,0.302,92
snuggles,-0.232,7,179,1,1,0.67,0.34,0.287,186
disagree,-0.232,75,1709,1,1,0.133,0.59,0.345,1784
swearing,-0.232,7,179,1,1,0.333,0.559,0.586,186
operative,-0.232,1,44,1,1,0.541,0.635,0.718,45
can,-0.233,18016,405524,1,1,0.662,0.36,0.454,423540
jump,-0.234,146,3311,1,1,0.625,0.865,0.611,3457
oppressed,-0.234,14,337,1,1,0.119,0.64,0.259,351
article,-0.234,128,2907,1,1,0.594,0.28,0.481,3035
suppress,-0.234,10,247,1,1,0.281,0.559,0.509,257
shambles,-0.234,10,247,1,1,0.271,0.696,0.287,257
reduce,-0.235,26,608,1,1,0.219,0.304,0.336,634
argh,-0.235,8,202,1,1,0.26,0.538,0.328,210
decent,-0.235,100,2278,1,1,0.823,0.296,0.653,2378
jar,-0.235,29,676,1,1,0.43,0.346,0.318,705
change,-0.235,1134,25615,1,1,0.625,0.575,0.606,26749
storming,-0.235,6,157,1,1,0.265,0.91,0.669,163
intoxicated,-0.235,6,157,1,1,0.079,0.824,0.246,163
gas,-0.236,62,1422,1,1,0.396,0.408,0.519,1484
ad,-0.237,51,1174,1,1,0.521,0.705,0.558,1225
sober,-0.237,74,1694,1,1,0.729,0.216,0.568,1768
hair,-0.237,264,5991,1,1,0.582,0.186,0.286,6255
pity,-0.237,119,2713,1,1,0.16,0.398,0.114,2832
silly,-0.238,96,2193,1,1,0.384,0.349,0.161,2289
pony,-0.238,7,180,1,1,0.812,0.413,0.315,187
loudly,-0.238,43,995,1,1,0.541,0.755,0.667,1038
expect,-0.239,298,6770,1,1,0.469,0.327,0.377,7068
dint,-0.24,5,135,1,1,0.378,0.48,0.492,140
merchandise,-0.24,2,67,1,1,0.594,0.46,0.621,69
curb,-0.24,8,203,1,1,0.472,0.371,0.402,211
thyroid,-0.24,2,67,1,1,0.234,0.455,0.373,69
disinformation,-0.24,2,67,1,1,0.23,0.577,0.26,69
slump,-0.24,8,203,1,1,0.194,0.438,0.13,211
yaw,-0.24,2,67,1,1,0.586,0.592,0.491,69
berlin,-0.24,18,430,1,1,0.592,0.423,0.571,448
explode,-0.241,28,657,1,1,0.277,0.885,0.773,685
smack,-0.241,12,294,1,1,0.323,0.662,0.381,306
unicorn,-0.241,9,226,1,1,0.776,0.51,0.48,235
mentality,-0.241,56,1293,1,1,0.711,0.415,0.726,1349
vocal,-0.241,36,839,1,1,0.583,0.352,0.34,875
killing,-0.242,171,3905,1,1,0.08,0.959,0.696,4076
drill,-0.242,6,158,1,1,0.25,0.602,0.573,164
retard,-0.242,6,158,1,1,0.194,0.347,0.222,164
toddler,-0.242,20,476,1,1,0.812,0.469,0.368,496
threatening,-0.242,24,567,1,1,0.071,0.875,0.652,591
campus,-0.242,74,1703,1,1,0.604,0.388,0.519,1777
sympathy,-0.243,61,1409,1,1,0.827,0.497,0.634,1470
edit,-0.243,34,795,1,1,0.51,0.41,0.544,829
stomp,-0.243,3,90,1,1,0.365,0.565,0.438,93
spew,-0.243,7,181,1,1,0.26,0.651,0.573,188
ping,-0.243,7,181,1,1,0.541,0.49,0.391,188
scrambled,-0.243,3,90,1,1,0.451,0.535,0.539,93
cohort,-0.243,3,90,1,1,0.459,0.551,0.566,93
skeptical,-0.243,7,181,1,1,0.207,0.5,0.452,188
gloves,-0.243,7,181,1,1,0.542,0.225,0.491,188
cookies,-0.244,39,910,1,1,0.823,0.451,0.316,949
prevalent,-0.245,8,204,1,1,0.694,0.43,0.669,212
waste,-0.245,190,4353,1,1,0.041,0.51,0.184,4543
watermelon,-0.246,4,113,1,1,0.714,0.23,0.239,117
piggy,-0.246,4,113,1,1,0.541,0.365,0.412,117
bladder,-0.246,4,113,1,1,0.406,0.412,0.33,117
ref,-0.246,10,250,1,1,0.469,0.38,0.368,260
homeboy,-0.247,5,136,1,1,0.602,0.255,0.436,141
puberty,-0.247,5,136,1,1,0.552,0.786,0.504,141
dramatic,-0.247,80,1849,1,1,0.367,0.78,0.443,1929
nightmare,-0.247,118,2717,1,1,0.005,0.81,0.436,2835
yesterday,-0.248,375,8589,1,1,0.5,0.286,0.253,8964
delusional,-0.248,28,662,1,1,0.219,0.745,0.327,690
pretty,-0.248,1036,23709,1,1,0.875,0.516,0.561,24745
vomit,-0.248,14,342,1,1,0.073,0.569,0.188,356
immoral,-0.249,7,182,1,1,0.143,0.622,0.385,189
deal,-0.249,910,20840,1,1,0.719,0.599,0.543,21750
kindness,-0.249,168,3866,1,1,0.938,0.35,0.508,4034
indigenous,-0.25,10,251,1,1,0.5,0.509,0.552,261
busted,-0.25,10,251,1,1,0.204,0.676,0.345,261
shook,-0.251,45,1053,1,1,0.163,0.759,0.509,1098
whole,-0.251,1548,35505,1,1,0.653,0.357,0.572,37053
movie,-0.251,533,12240,1,1,0.792,0.56,0.471,12773
wasting,-0.251,83,1925,1,1,0.051,0.417,0.207,2008
barely,-0.251,196,4516,1,1,0.448,0.183,0.268,4712
straight,-0.252,323,7431,1,1,0.667,0.298,0.669,7754
zombie,-0.252,20,481,1,1,0.214,0.648,0.415,501
listener,-0.253,29,688,1,1,0.667,0.375,0.403,717
admire,-0.253,86,1998,1,1,0.867,0.692,0.704,2084
excuse,-0.253,160,3699,1,1,0.24,0.696,0.318,3859
lawsuit,-0.254,5,137,1,1,0.219,0.794,0.611,142
inflammatory,-0.254,1,45,1,1,0.177,0.642,0.404,46
bombard,-0.254,1,45,1,1,0.156,0.961,0.777,46
poppy,-0.254,6,160,1,1,0.635,0.392,0.357,166
yon,-0.254,4,114,1,1,0.479,0.365,0.393,118
yap,-0.254,2,68,1,1,0.51,0.458,0.37,70
forensic,-0.254,3,91,1,1,0.439,0.627,0.436,94
mentor,-0.254,24,574,1,1,0.719,0.455,0.777,598
dye,-0.254,7,183,1,1,0.479,0.314,0.371,190
barb,-0.254,2,68,1,1,0.448,0.365,0.417,70
headstone,-0.254,1,45,1,1,0.24,0.378,0.349,46
wanker,-0.254,2,68,1,1,0.29,0.569,0.446,70
forefathers,-0.254,1,45,1,1,0.69,0.412,0.627,46
dribble,-0.254,1,45,1,1,0.417,0.551,0.465,46
oust,-0.254,1,45,1,1,0.296,0.716,0.444,46
roach,-0.254,5,137,1,1,0.146,0.598,0.259,142
boycott,-0.254,11,275,1,1,0.112,0.69,0.505,286
container,-0.254,7,183,1,1,0.551,0.396,0.561,190
goof,-0.254,3,91,1,1,0.448,0.49,0.272,94
leash,-0.254,5,137,1,1,0.32,0.347,0.427,142
shelters,-0.254,7,183,1,1,0.582,0.333,0.482,190
commissioner,-0.254,1,45,1,1,0.602,0.449,0.949,46
burke,-0.254,2,68,1,1,0.466,0.441,0.451,70
suspicions,-0.254,4,114,1,1,0.208,0.745,0.5,118
gunner,-0.254,1,45,1,1,0.25,0.853,0.817,46
polish,-0.254,10,252,1,1,0.604,0.412,0.533,262
misplace,-0.254,1,45,1,1,0.229,0.461,0.191,46
callous,-0.254,3,91,1,1,0.245,0.5,0.386,94
probe,-0.254,2,68,1,1,0.398,0.444,0.512,70
car,-0.255,538,12399,1,1,0.776,0.54,0.5,12937
store,-0.255,150,3473,1,1,0.646,0.538,0.407,3623
dean,-0.256,33,782,1,1,0.612,0.469,0.723,815
unpopular,-0.256,32,759,1,1,0.073,0.441,0.164,791
shrug,-0.257,13,322,1,1,0.208,0.296,0.278,335
complicated,-0.258,75,1753,1,1,0.211,0.66,0.455,1828
speaking,-0.258,312,7223,1,1,0.753,0.59,0.575,7535
awareness,-0.258,225,5217,1,1,0.684,0.422,0.81,5442
motel,-0.258,10,253,1,1,0.531,0.372,0.45,263
scream,-0.258,197,4571,1,1,0.188,0.863,0.594,4768
attractive,-0.259,60,1408,1,1,0.906,0.63,0.769,1468
doe,-0.26,14,346,1,1,0.55,0.336,0.336,360
uphill,-0.26,6,161,1,1,0.396,0.723,0.572,167
kicking,-0.261,50,1180,1,1,0.327,0.802,0.51,1230
spit,-0.261,18,439,1,1,0.149,0.545,0.436,457
toaster,-0.262,5,138,1,1,0.542,0.337,0.387,143
laundry,-0.262,65,1528,1,1,0.644,0.292,0.377,1593
quit,-0.262,139,3245,1,1,0.469,0.559,0.488,3384
nut,-0.263,25,602,1,1,0.365,0.31,0.25,627
virtual,-0.263,59,1391,1,1,0.598,0.532,0.463,1450
untrustworthy,-0.263,4,115,1,1,0.097,0.449,0.287,119
bodyguard,-0.263,4,115,1,1,0.51,0.71,0.754,119
ideology,-0.263,19,463,1,1,0.573,0.344,0.692,482
bun,-0.263,9,231,1,1,0.424,0.306,0.268,240
cord,-0.263,9,231,1,1,0.388,0.378,0.358,240
decision,-0.263,214,4988,1,1,0.646,0.51,0.839,5202
child,-0.264,625,14532,1,1,0.912,0.46,0.413,15157
fine,-0.264,1218,28299,1,1,0.823,0.24,0.647,29517
counter,-0.264,30,719,1,1,0.439,0.478,0.75,749
stuck,-0.264,364,8478,1,1,0.153,0.644,0.285,8842
articles,-0.264,29,696,1,1,0.552,0.324,0.565,725
thing,-0.265,3720,86506,1,1,0.449,0.222,0.26,90226
fishy,-0.265,3,92,1,1,0.224,0.601,0.471,95
hardcore,-0.265,15,371,1,1,0.25,0.721,0.585,386
reprehensible,-0.265,3,92,1,1,0.316,0.569,0.351,95
med,-0.266,18,441,1,1,0.375,0.429,0.606,459
debate,-0.266,48,1139,1,1,0.408,0.691,0.683,1187
twins,-0.266,35,837,1,1,0.76,0.473,0.602,872
kill,-0.266,485,11313,1,1,0.052,0.941,0.736,11798
pan,-0.267,23,558,1,1,0.734,0.182,0.364,581
screw,-0.267,43,1024,1,1,0.385,0.46,0.377,1067
furious,-0.267,19,465,1,1,0.062,0.953,0.598,484
homework,-0.267,42,1001,1,1,0.396,0.412,0.459,1043
huge,-0.268,368,8605,1,1,0.573,0.625,0.783,8973
group,-0.268,696,16255,1,1,0.573,0.423,0.48,16951
down,-0.268,2577,60130,1,1,0.208,0.33,0.264,62707
inconsistent,-0.269,8,209,1,1,0.271,0.431,0.295,217
peice,-0.269,2,69,1,1,0.479,0.422,0.398,71
atrocity,-0.269,2,69,1,1,0.115,0.844,0.593,71
teeny,-0.269,2,69,1,1,0.427,0.418,0.216,71
dyke,-0.269,2,69,1,1,0.438,0.396,0.566,71
loyal,-0.269,73,1726,1,1,0.896,0.265,0.657,1799
geez,-0.272,19,467,1,1,0.417,0.396,0.39,486
restrict,-0.272,4,116,1,1,0.115,0.539,0.577,120
airline,-0.272,4,116,1,1,0.65,0.482,0.688,120
barks,-0.272,4,116,1,1,0.427,0.694,0.325,120
deployment,-0.272,4,116,1,1,0.51,0.52,0.612,120
committee,-0.272,16,397,1,1,0.592,0.392,0.721,413
revenue,-0.273,6,163,1,1,0.873,0.51,0.854,169
warped,-0.273,6,163,1,1,0.219,0.663,0.304,169
explain,-0.273,252,5928,1,1,0.719,0.517,0.736,6180
whine,-0.274,21,515,1,1,0.342,0.686,0.218,536
boston,-0.274,23,562,1,1,0.643,0.38,0.58,585
informed,-0.274,29,703,1,1,0.543,0.298,0.617,732
court,-0.274,78,1853,1,1,0.479,0.769,0.827,1931
assistance,-0.274,31,750,1,1,0.656,0.519,0.633,781
inform,-0.275,16,398,1,1,0.723,0.582,0.679,414
amen,-0.275,116,2746,1,1,0.781,0.182,0.542,2862
unsure,-0.275,34,821,1,1,0.143,0.58,0.217,855
deserved,-0.275,77,1831,1,1,0.781,0.582,0.689,1908
escalating,-0.276,1,46,1,1,0.646,0.724,0.518,47
stationery,-0.276,1,46,1,1,0.57,0.12,0.455,47
coordination,-0.276,1,46,1,1,0.677,0.454,0.789,47
organizer,-0.276,1,46,1,1,0.604,0.577,0.846,47
cereals,-0.276,1,46,1,1,0.719,0.224,0.311,47
vagina,-0.276,11,281,1,1,0.551,0.87,0.5,292
scoot,-0.276,1,46,1,1,0.51,0.49,0.412,47
ancestry,-0.276,1,46,1,1,0.708,0.519,0.717,47
bystander,-0.276,1,46,1,1,0.48,0.462,0.491,47
hyena,-0.276,1,46,1,1,0.396,0.719,0.464,47
fights,-0.276,41,986,1,1,0.07,0.92,0.712,1027
breakers,-0.276,1,46,1,1,0.469,0.588,0.439,47
refusing,-0.277,24,587,1,1,0.143,0.67,0.203,611
profit,-0.277,18,446,1,1,0.93,0.462,0.721,464
corn,-0.277,14,352,1,1,0.594,0.196,0.292,366
network,-0.278,72,1719,1,1,0.531,0.337,0.466,1791
discourage,-0.279,6,164,1,1,0.184,0.443,0.267,170
reasonable,-0.279,32,777,1,1,0.902,0.337,0.726,809
recruit,-0.28,4,117,1,1,0.551,0.654,0.633,121
borderline,-0.281,17,424,1,1,0.449,0.52,0.49,441
smallest,-0.281,25,613,1,1,0.281,0.34,0.129,638
hind,-0.281,7,188,1,1,0.483,0.644,0.337,195
political,-0.281,156,3709,1,1,0.347,0.73,0.875,3865
sing,-0.282,262,6217,1,1,0.858,0.606,0.42,6479
wag,-0.282,13,330,1,1,0.448,0.49,0.481,343
hypocrite,-0.282,19,472,1,1,0.082,0.673,0.306,491
pant,-0.283,2,70,1,1,0.448,0.463,0.409,72
grandchild,-0.283,2,70,1,1,0.781,0.433,0.465,72
audit,-0.283,2,70,1,1,0.375,0.562,0.735,72
urine,-0.283,2,70,1,1,0.375,0.361,0.169,72
herpes,-0.283,2,70,1,1,0.11,0.6,0.309,72
copying,-0.283,2,70,1,1,0.448,0.315,0.404,72
jacks,-0.283,2,70,1,1,0.49,0.4,0.505,72
pistol,-0.283,2,70,1,1,0.17,0.9,0.677,72
tally,-0.283,2,70,1,1,0.542,0.42,0.518,72
attempted,-0.283,33,804,1,1,0.594,0.58,0.567,837
innocent,-0.284,81,1941,1,1,0.729,0.206,0.34,2022
irritates,-0.284,9,236,1,1,0.173,0.81,0.295,245
confess,-0.284,29,710,1,1,0.36,0.712,0.431,739
head,-0.284,1273,30199,1,1,0.53,0.472,0.558,31472
drastic,-0.285,6,165,1,1,0.194,0.839,0.657,171
biggie,-0.285,6,165,1,1,0.531,0.481,0.5,171
madam,-0.285,13,331,1,1,0.58,0.308,0.571,344
advertising,-0.285,10,260,1,1,0.622,0.608,0.632,270
covering,-0.286,25,616,1,1,0.615,0.382,0.583,641
surviving,-0.286,35,854,1,1,0.646,0.836,0.721,889
conjuring,-0.286,3,94,1,1,0.224,0.653,0.694,97
custody,-0.286,11,284,1,1,0.494,0.472,0.675,295
broom,-0.286,3,94,1,1,0.385,0.154,0.302,97
scrap,-0.286,3,94,1,1,0.156,0.339,0.173,97
woof,-0.288,4,118,1,1,0.354,0.509,0.404,122
griffin,-0.288,4,118,1,1,0.418,0.337,0.36,122
rifle,-0.288,4,118,1,1,0.329,0.9,0.718,122
microphone,-0.288,4,118,1,1,0.551,0.431,0.462,122
courts,-0.288,9,237,1,1,0.367,0.71,0.816,246
rite,-0.289,10,261,1,1,0.378,0.57,0.606,271
parade,-0.289,16,404,1,1,0.792,0.685,0.509,420
courageous,-0.29,39,952,1,1,0.918,0.587,0.879,991
thirsty,-0.29,22,547,1,1,0.281,0.66,0.31,569
harass,-0.29,11,285,1,1,0.16,0.775,0.62,296
holocaust,-0.29,5,142,1,1,0.062,0.918,0.618,147
international,-0.291,46,1120,1,1,0.8,0.519,0.702,1166
troll,-0.291,27,667,1,1,0.378,0.627,0.327,694
patriotism,-0.291,6,166,1,1,0.708,0.635,0.848,172
predatory,-0.291,6,166,1,1,0.083,0.865,0.731,172
convince,-0.291,97,2338,1,1,0.708,0.539,0.763,2435
basis,-0.291,76,1837,1,1,0.602,0.26,0.426,1913
grandchildren,-0.292,16,405,1,1,0.796,0.545,0.426,421
owner,-0.292,42,1026,1,1,0.776,0.449,0.92,1068
butter,-0.293,29,716,1,1,0.65,0.292,0.202,745
comforting,-0.293,269,6457,1,1,0.906,0.337,0.62,6726
damaged,-0.294,37,908,1,1,0.104,0.635,0.182,945
lot,-0.294,2801,67043,1,1,0.531,0.215,0.37,69844
disgust,-0.294,27,669,1,1,0.052,0.775,0.317,696
wrist,-0.294,15,382,1,1,0.706,0.34,0.265,397
thankful,-0.294,288,6918,1,1,0.969,0.344,0.714,7206
narcissistic,-0.295,19,478,1,1,0.323,0.708,0.655,497
logo,-0.295,20,502,1,1,0.469,0.296,0.565,522
shoot,-0.295,84,2035,1,1,0.092,0.926,0.625,2119
imagine,-0.295,634,15210,1,1,0.759,0.48,0.587,15844
harm,-0.295,101,2443,1,1,0.073,0.679,0.423,2544
pig,-0.295,29,718,1,1,0.343,0.368,0.324,747
get,-0.296,9589,229900,1,1,0.74,0.594,0.667,239489
alive,-0.296,413,9930,1,1,0.816,0.637,0.731,10343
disheartened,-0.297,5,143,1,1,0.153,0.343,0.238,148
shorten,-0.297,3,95,1,1,0.302,0.382,0.46,98
lightbulb,-0.297,1,47,1,1,0.573,0.255,0.302,48
abhorrent,-0.297,5,143,1,1,0.229,0.75,0.474,148
finance,-0.297,10,263,1,1,0.753,0.431,0.843,273
prohibited,-0.297,1,47,1,1,0.115,0.77,0.482,48
psychiatrist,-0.297,17,431,1,1,0.489,0.627,0.765,448
nephew,-0.297,28,695,1,1,0.719,0.337,0.412,723
forum,-0.297,16,407,1,1,0.556,0.49,0.632,423
mir,-0.297,1,47,1,1,0.417,0.339,0.355,48
corroborate,-0.297,1,47,1,1,0.671,0.471,0.616,48
physician,-0.297,5,143,1,1,0.583,0.49,0.843,148
sponsor,-0.297,7,191,1,1,0.729,0.537,0.8,198
vendor,-0.297,1,47,1,1,0.541,0.541,0.627,48
divert,-0.297,3,95,1,1,0.344,0.622,0.407,98
pricey,-0.297,1,47,1,1,0.34,0.567,0.43,48
trickle,-0.297,1,47,1,1,0.5,0.196,0.231,48
ripple,-0.297,3,95,1,1,0.5,0.453,0.37,98
obesity,-0.297,3,95,1,1,0.215,0.37,0.328,98
harry,-0.297,84,2039,1,1,0.52,0.409,0.39,2123
hairdresser,-0.297,1,47,1,1,0.708,0.509,0.407,48
defamation,-0.297,1,47,1,1,0.11,0.67,0.481,48
whiff,-0.297,1,47,1,1,0.459,0.4,0.331,48
repeal,-0.297,1,47,1,1,0.26,0.48,0.482,48
heck,-0.298,64,1560,1,1,0.24,0.728,0.56,1624
boring,-0.298,276,6656,1,1,0.194,0.217,0.125,6932
illusion,-0.298,89,2162,1,1,0.562,0.49,0.387,2251
video,-0.299,489,11781,1,1,0.646,0.577,0.427,12270
admitted,-0.3,30,745,1,1,0.72,0.49,0.767,775
aye,-0.3,40,986,1,1,0.562,0.42,0.392,1026
teasing,-0.3,11,288,1,1,0.235,0.725,0.352,299
stray,-0.3,47,1155,1,1,0.133,0.76,0.281,1202
whistle,-0.301,10,264,1,1,0.653,0.551,0.463,274
sleep,-0.301,1196,28844,1,1,0.719,0.09,0.339,30040
split,-0.301,46,1132,1,1,0.344,0.618,0.41,1178
paralyzed,-0.301,8,216,1,1,0.194,0.48,0.198,224
pickle,-0.303,6,168,1,1,0.593,0.449,0.288,174
bang,-0.303,41,1013,1,1,0.265,0.951,0.74,1054
eat,-0.303,777,18790,1,1,0.731,0.5,0.464,19567
fun,-0.303,1048,25337,1,1,0.918,0.843,0.667,26385
touched,-0.303,83,2028,1,1,0.592,0.38,0.404,2111
mail,-0.304,30,748,1,1,0.615,0.231,0.548,778
cope,-0.304,156,3793,1,1,0.592,0.647,0.709,3949
rubbing,-0.304,16,410,1,1,0.406,0.569,0.44,426
stick,-0.304,176,4279,1,1,0.396,0.364,0.382,4455
ridiculed,-0.305,9,241,1,1,0.112,0.806,0.212,250
irrelevant,-0.305,28,701,1,1,0.138,0.311,0.296,729
legally,-0.306,17,435,1,1,0.771,0.482,0.842,452
facts,-0.306,143,3488,1,1,0.688,0.471,0.693,3631
people,-0.307,15296,370794,1,1,0.604,0.4,0.5,386090
nuts,-0.307,53,1308,1,1,0.594,0.25,0.291,1361
eighteen,-0.307,3,96,1,1,0.523,0.34,0.404,99
ruff,-0.307,3,96,1,1,0.365,0.51,0.375,99
aaaah,-0.307,3,96,1,1,0.52,0.636,0.282,99
civility,-0.307,3,96,1,1,0.76,0.306,0.679,99
representative,-0.307,11,290,1,1,0.704,0.366,0.694,301
backfire,-0.307,3,96,1,1,0.265,0.612,0.491,99
viewer,-0.307,7,193,1,1,0.592,0.358,0.558,200
severely,-0.307,19,484,1,1,0.219,0.673,0.7,503
unhelpful,-0.307,3,96,1,1,0.104,0.32,0.118,99
stayed,-0.308,189,4610,1,1,0.497,0.27,0.395,4799
bus,-0.309,129,3156,1,1,0.407,0.411,0.4,3285
push,-0.309,298,7261,1,1,0.417,0.608,0.524,7559
survey,-0.309,16,412,1,1,0.58,0.357,0.379,428
lance,-0.309,16,412,1,1,0.406,0.62,0.587,428
supposed,-0.309,374,9111,1,1,0.296,0.378,0.379,9485
left,-0.31,1925,46824,1,1,0.354,0.37,0.361,48749
reason,-0.31,1213,29518,1,1,0.781,0.455,0.712,30731
big,-0.31,1263,30751,1,1,0.802,0.588,0.812,32014
govern,-0.311,5,145,1,1,0.573,0.702,0.98,150
payer,-0.311,2,72,1,1,0.313,0.63,0.638,74
pronunciation,-0.311,2,72,1,1,0.531,0.431,0.588,74
crotch,-0.311,2,72,1,1,0.521,0.637,0.447,74
shocker,-0.311,2,72,1,1,0.235,0.804,0.616,74
thundering,-0.311,2,72,1,1,0.337,0.778,0.7,74
infuriates,-0.311,2,72,1,1,0.135,0.913,0.627,74
editorial,-0.311,2,72,1,1,0.583,0.33,0.57,74
preschool,-0.311,2,72,1,1,0.604,0.382,0.393,74
ignorant,-0.312,69,1704,1,1,0.102,0.461,0.223,1773
reasons,-0.312,346,8451,1,1,0.583,0.46,0.571,8797
ton,-0.312,65,1607,1,1,0.56,0.418,0.604,1672
secretary,-0.312,10,267,1,1,0.612,0.426,0.561,277
snap,-0.313,67,1657,1,1,0.344,0.517,0.352,1724
shuffle,-0.313,14,365,1,1,0.459,0.45,0.556,379
petty,-0.313,39,975,1,1,0.21,0.537,0.236,1014
fuming,-0.313,4,121,1,1,0.24,0.66,0.481,125
surprised,-0.314,150,3684,1,1,0.784,0.855,0.539,3834
suspected,-0.315,6,170,1,1,0.173,0.755,0.452,176
furry,-0.315,22,561,1,1,0.428,0.4,0.333,583
discuss,-0.315,63,1563,1,1,0.396,0.769,0.509,1626
officer,-0.315,24,610,1,1,0.542,0.43,0.877,634
soup,-0.315,33,830,1,1,0.602,0.245,0.269,863
sub,-0.315,28,708,1,1,0.51,0.37,0.312,736
notice,-0.316,208,5110,1,1,0.646,0.408,0.491,5318
dinner,-0.316,236,5795,1,1,0.823,0.392,0.379,6031
floor,-0.316,198,4868,1,1,0.43,0.23,0.25,5066
close,-0.316,1036,25373,1,1,0.292,0.26,0.263,26409
homesick,-0.316,18,464,1,1,0.436,0.304,0.347,482
clip,-0.317,30,758,1,1,0.438,0.31,0.381,788
data,-0.317,58,1444,1,1,0.5,0.25,0.426,1502
inaccurate,-0.317,3,97,1,1,0.135,0.45,0.25,100
dicks,-0.317,13,342,1,1,0.31,0.694,0.358,355
insure,-0.317,1,48,1,1,0.7,0.415,0.698,49
meanie,-0.317,1,48,1,1,0.388,0.42,0.404,49
laughable,-0.317,5,146,1,1,0.592,0.627,0.298,151
worrying,-0.317,89,2204,1,1,0.047,0.75,0.296,2293
valium,-0.317,1,48,1,1,0.419,0.398,0.443,49
used,-0.318,2073,50833,1,1,0.354,0.306,0.287,52906
princess,-0.318,92,2279,1,1,0.885,0.557,0.62,2371
karma,-0.319,48,1201,1,1,0.5,0.51,0.537,1249
household,-0.319,42,1054,1,1,0.781,0.23,0.667,1096
respond,-0.319,93,2306,1,1,0.573,0.435,0.594,2399
kitten,-0.32,22,564,1,1,0.816,0.343,0.26,586
educated,-0.32,29,736,1,1,0.816,0.297,0.625,765
angel,-0.32,168,4151,1,1,0.906,0.158,0.704,4319
join,-0.32,386,9508,1,1,0.729,0.479,0.684,9894
bummed,-0.321,16,417,1,1,0.296,0.43,0.227,433
chemistry,-0.322,19,491,1,1,0.625,0.52,0.694,510
streaming,-0.322,72,1796,1,1,0.592,0.481,0.582,1868
unworthy,-0.323,23,590,1,1,0.194,0.433,0.226,613
guinea,-0.323,7,196,1,1,0.521,0.44,0.396,203
sticking,-0.323,29,738,1,1,0.486,0.425,0.356,767
mane,-0.323,13,344,1,1,0.521,0.277,0.373,357
speak,-0.324,779,19226,1,1,0.765,0.472,0.5,20005
lung,-0.324,8,221,1,1,0.51,0.292,0.629,229
advised,-0.324,8,221,1,1,0.823,0.33,0.509,229
fossil,-0.324,2,73,1,1,0.48,0.292,0.38,75
mince,-0.324,2,73,1,1,0.417,0.529,0.378,75
qualify,-0.324,8,221,1,1,0.73,0.594,0.52,229
distressing,-0.324,5,147,1,1,0.075,0.75,0.375,152
wasteful,-0.324,2,73,1,1,0.173,0.73,0.409,75
slang,-0.324,2,73,1,1,0.479,0.418,0.491,75
pet,-0.326,128,3185,1,1,0.875,0.327,0.305,3313
windy,-0.326,16,419,1,1,0.33,0.541,0.528,435
cat,-0.326,442,10944,1,1,0.667,0.26,0.37,11386
starving,-0.326,20,518,1,1,0.163,0.67,0.336,538
difficulties,-0.326,31,790,1,1,0.082,0.784,0.357,821
summertime,-0.327,10,271,1,1,0.837,0.5,0.455,281
dried,-0.327,10,271,1,1,0.427,0.26,0.385,281
pussy,-0.327,70,1755,1,1,0.323,0.759,0.409,1825
seem,-0.327,575,14251,1,1,0.471,0.302,0.298,14826
job,-0.328,633,15690,1,1,0.694,0.541,0.717,16323
manageable,-0.328,7,197,1,1,0.75,0.361,0.655,204
prediction,-0.328,7,197,1,1,0.562,0.635,0.585,204
misled,-0.328,3,98,1,1,0.177,0.606,0.353,101
extraterrestrial,-0.328,3,98,1,1,0.51,0.833,0.792,101
resource,-0.328,15,395,1,1,0.74,0.357,0.749,410
look,-0.328,1978,49016,1,1,0.719,0.429,0.615,50994
let,-0.329,4437,110033,1,1,0.427,0.373,0.307,114470
shame,-0.33,264,6570,1,1,0.06,0.67,0.155,6834
diabetic,-0.33,4,123,1,1,0.125,0.269,0.237,127
syrup,-0.33,4,123,1,1,0.62,0.223,0.318,127
cupcake,-0.33,4,123,1,1,0.656,0.333,0.344,127
juice,-0.33,29,743,1,1,0.776,0.281,0.352,772
try,-0.33,1719,42662,1,1,0.604,0.551,0.556,44381
common,-0.33,255,6352,1,1,0.6,0.127,0.318,6607
coffin,-0.331,11,297,1,1,0.073,0.432,0.343,308
appointment,-0.331,35,893,1,1,0.688,0.594,0.547,928
bunny,-0.331,23,595,1,1,0.74,0.325,0.194,618
vegan,-0.331,24,620,1,1,0.49,0.226,0.357,644
inadequate,-0.332,12,322,1,1,0.122,0.45,0.223,334
tier,-0.332,12,322,1,1,0.52,0.245,0.56,334
consent,-0.332,21,546,1,1,0.75,0.5,0.62,567
button,-0.332,43,1093,1,1,0.52,0.22,0.343,1136
kick,-0.332,129,3232,1,1,0.271,0.791,0.526,3361
loss,-0.332,298,7435,1,1,0.062,0.567,0.211,7733
incapable,-0.333,38,969,1,1,0.156,0.529,0.155,1007
pick,-0.333,340,8481,1,1,0.5,0.464,0.525,8821
gag,-0.333,7,198,1,1,0.323,0.66,0.398,205
auto,-0.333,15,397,1,1,0.571,0.569,0.5,412
younger,-0.333,140,3508,1,1,0.781,0.457,0.558,3648
successful,-0.334,99,2489,1,1,0.949,0.724,0.938,2588
worries,-0.334,124,3113,1,1,0.094,0.679,0.363,3237
tease,-0.335,12,323,1,1,0.317,0.79,0.432,335
totally,-0.335,452,11291,1,1,0.82,0.422,0.702,11743
handle,-0.335,399,9973,1,1,0.698,0.571,0.558,10372
sucking,-0.336,18,473,1,1,0.227,0.528,0.377,491
rejected,-0.336,66,1671,1,1,0.102,0.48,0.25,1737
lost,-0.336,1459,36438,1,1,0.199,0.663,0.148,37897
university,-0.336,66,1672,1,1,0.735,0.574,0.741,1738
mite,-0.338,1,49,1,1,0.29,0.584,0.271,50
flinch,-0.338,2,74,1,1,0.35,0.804,0.555,76
tat,-0.338,7,199,1,1,0.429,0.38,0.404,206
ethics,-0.338,9,249,1,1,0.658,0.296,0.731,258
silliness,-0.338,1,49,1,1,0.327,0.368,0.192,50
prostitute,-0.338,3,99,1,1,0.167,0.86,0.427,102
comedian,-0.338,6,174,1,1,0.812,0.735,0.598,180
badge,-0.338,7,199,1,1,0.567,0.488,0.691,206
rump,-0.338,1,49,1,1,0.449,0.425,0.396,50
dossier,-0.338,1,49,1,1,0.357,0.38,0.544,50
boasting,-0.338,1,49,1,1,0.417,0.62,0.602,50
sparkle,-0.338,4,124,1,1,0.819,0.765,0.51,128
booster,-0.338,2,74,1,1,0.755,0.6,0.8,76
pee,-0.338,37,949,1,1,0.449,0.529,0.391,986
clapper,-0.338,1,49,1,1,0.5,0.229,0.42,50
flick,-0.338,5,149,1,1,0.688,0.541,0.515,154
rib,-0.338,7,199,1,1,0.49,0.349,0.351,206
bedside,-0.338,5,149,1,1,0.604,0.167,0.375,154
ammunition,-0.338,1,49,1,1,0.338,0.635,0.667,50
detergent,-0.338,1,49,1,1,0.458,0.304,0.426,50
cussed,-0.338,1,49,1,1,0.156,0.625,0.454,50
prematurely,-0.338,1,49,1,1,0.292,0.657,0.289,50
bureau,-0.338,1,49,1,1,0.562,0.373,0.618,50
fact,-0.338,1039,26010,1,1,0.683,0.333,0.618,27049
knock,-0.339,82,2076,1,1,0.312,0.531,0.527,2158
hear,-0.339,1543,38641,1,1,0.76,0.429,0.444,40184
shower,-0.34,184,4634,1,1,0.669,0.346,0.336,4818
accidentally,-0.34,54,1377,1,1,0.333,0.741,0.333,1431
nose,-0.34,53,1352,1,1,0.582,0.27,0.245,1405
android,-0.34,15,400,1,1,0.663,0.436,0.5,415
tunnel,-0.341,39,1002,1,1,0.312,0.49,0.412,1041
hurry,-0.341,39,1002,1,1,0.422,0.735,0.481,1041
inclusive,-0.341,11,300,1,1,0.604,0.42,0.564,311
multiple,-0.341,137,3461,1,1,0.66,0.51,0.578,3598
venom,-0.341,10,275,1,1,0.125,0.77,0.491,285
profile,-0.342,58,1481,1,1,0.689,0.293,0.529,1539
adult,-0.342,216,5450,1,1,0.815,0.491,0.787,5666
smiling,-0.343,120,3040,1,1,0.981,0.679,0.625,3160
pup,-0.344,25,653,1,1,0.755,0.427,0.302,678
dollar,-0.344,24,628,1,1,0.755,0.632,0.694,652
luggage,-0.344,5,150,1,1,0.561,0.226,0.319,155
prosecutor,-0.346,4,125,1,1,0.45,0.491,0.796,129
platform,-0.346,75,1915,1,1,0.602,0.34,0.718,1990
shameful,-0.347,21,554,1,1,0.04,0.68,0.264,575
tomorrow,-0.347,680,17181,1,1,0.792,0.377,0.407,17861
have,-0.347,21682,547204,1,1,0.757,0.389,0.593,568886
cop,-0.347,20,529,1,1,0.327,0.77,0.836,549
topic,-0.347,77,1968,1,1,0.52,0.276,0.427,2045
controversy,-0.348,3,100,1,1,0.25,0.819,0.6,103
discouraging,-0.348,7,201,1,1,0.167,0.469,0.281,208
outreach,-0.348,3,100,1,1,0.54,0.462,0.672,103
spaghetti,-0.348,11,302,1,1,0.729,0.353,0.288,313
mashed,-0.348,3,100,1,1,0.531,0.337,0.194,103
nationality,-0.348,3,100,1,1,0.642,0.4,0.772,103
fooling,-0.348,7,201,1,1,0.167,0.755,0.384,208
horror,-0.348,153,3888,1,1,0.115,0.85,0.438,4041
confused,-0.348,216,5480,1,1,0.22,0.65,0.179,5696
behave,-0.349,32,833,1,1,0.677,0.363,0.747,865
upbeat,-0.349,6,176,1,1,0.878,0.531,0.802,182
rookie,-0.349,6,176,1,1,0.583,0.37,0.198,182
speaker,-0.35,31,809,1,1,0.604,0.66,0.723,840
grappling,-0.351,2,75,1,1,0.448,0.676,0.516,77
clerk,-0.351,2,75,1,1,0.5,0.579,0.509,77
waffle,-0.351,5,151,1,1,0.708,0.394,0.327,156
retaliation,-0.351,2,75,1,1,0.156,0.812,0.491,77
gummy,-0.351,5,151,1,1,0.521,0.302,0.291,156
sac,-0.351,2,75,1,1,0.344,0.245,0.226,77
condone,-0.351,5,151,1,1,0.571,0.441,0.619,156
frustrate,-0.351,2,75,1,1,0.1,0.809,0.243,77
faith,-0.352,376,9556,1,1,0.833,0.22,0.763,9932
blow,-0.352,75,1927,1,1,0.316,0.75,0.57,2002
typo,-0.353,7,202,1,1,0.224,0.415,0.255,209
delete,-0.354,69,1778,1,1,0.292,0.298,0.409,1847
fixed,-0.355,49,1271,1,1,0.684,0.167,0.509,1320
leave,-0.356,2048,52157,1,1,0.375,0.315,0.295,54205
membership,-0.356,16,432,1,1,0.698,0.411,0.778,448
financial,-0.357,60,1553,1,1,0.667,0.5,0.722,1613
wit,-0.357,156,4000,1,1,0.844,0.484,0.775,4156
stool,-0.357,3,101,1,1,0.448,0.269,0.302,104
deport,-0.357,1,50,1,1,0.167,0.667,0.546,51
inequality,-0.357,3,101,1,1,0.122,0.575,0.259,104
reversal,-0.357,1,50,1,1,0.38,0.51,0.591,51
infrastructure,-0.357,7,203,1,1,0.604,0.46,0.694,210
unconscionable,-0.357,1,50,1,1,0.208,0.618,0.429,51
hiccup,-0.357,1,50,1,1,0.271,0.549,0.24,51
blackface,-0.357,1,50,1,1,0.302,0.49,0.441,51
encourage,-0.357,95,2447,1,1,0.896,0.58,0.704,2542
inexcusable,-0.357,1,50,1,1,0.271,0.582,0.546,51
fest,-0.357,9,254,1,1,0.704,0.574,0.402,263
vertigo,-0.357,3,101,1,1,0.292,0.655,0.445,104
brightens,-0.357,3,101,1,1,0.771,0.611,0.613,104
camel,-0.357,1,50,1,1,0.54,0.282,0.314,51
workplace,-0.358,22,586,1,1,0.592,0.431,0.583,608
wrestling,-0.358,20,535,1,1,0.449,0.868,0.774,555
case,-0.359,372,9522,1,1,0.427,0.275,0.441,9894
mother,-0.359,500,12793,1,1,0.931,0.408,0.725,13293
insult,-0.359,25,663,1,1,0.085,0.831,0.389,688
wrong,-0.359,1493,38172,1,1,0.042,0.582,0.48,39665
accountable,-0.36,26,689,1,1,0.709,0.282,0.777,715
comforter,-0.36,8,229,1,1,0.618,0.275,0.302,237
broken,-0.36,477,12219,1,1,0.062,0.5,0.293,12696
potato,-0.36,22,587,1,1,0.541,0.235,0.265,609
scoop,-0.36,6,178,1,1,0.583,0.543,0.64,184
tomato,-0.36,6,178,1,1,0.55,0.183,0.275,184
pastor,-0.361,28,741,1,1,0.698,0.236,0.746,769
toxic,-0.361,373,9569,1,1,0.008,0.885,0.492,9942
grilled,-0.361,4,127,1,1,0.702,0.5,0.373,131
trillion,-0.361,4,127,1,1,0.592,0.42,0.623,131
lass,-0.361,4,127,1,1,0.656,0.536,0.433,131
single,-0.362,1576,40406,1,1,0.291,0.354,0.259,41982
shake,-0.362,82,2126,1,1,0.439,0.689,0.539,2208
argument,-0.363,54,1409,1,1,0.51,0.464,0.698,1463
pill,-0.363,30,794,1,1,0.573,0.407,0.368,824
disloyal,-0.364,2,76,1,1,0.062,0.582,0.245,78
brandy,-0.364,2,76,1,1,0.6,0.59,0.487,78
veto,-0.364,2,76,1,1,0.271,0.462,0.509,78
spook,-0.364,2,76,1,1,0.327,0.887,0.322,78
precedent,-0.364,2,76,1,1,0.574,0.392,0.721,78
psoriasis,-0.364,2,76,1,1,0.125,0.674,0.33,78
bale,-0.364,2,76,1,1,0.437,0.363,0.412,78
cramp,-0.364,2,76,1,1,0.194,0.796,0.34,78
upload,-0.365,12,333,1,1,0.638,0.683,0.696,345
moderate,-0.365,9,256,1,1,0.582,0.19,0.453,265
apex,-0.366,10,282,1,1,0.57,0.433,0.418,292
investigate,-0.367,14,385,1,1,0.64,0.5,0.781,399
cooperate,-0.367,3,102,1,1,0.898,0.451,0.582,105
receipts,-0.367,3,102,1,1,0.32,0.333,0.381,105
mouse,-0.368,16,437,1,1,0.427,0.441,0.206,453
sleeping,-0.368,292,7551,1,1,0.704,0.091,0.312,7843
wipe,-0.369,27,721,1,1,0.663,0.427,0.551,748
goddamn,-0.369,52,1366,1,1,0.125,0.76,0.422,1418
deliver,-0.369,44,1160,1,1,0.583,0.37,0.582,1204
compulsive,-0.369,4,128,1,1,0.347,0.871,0.573,132
employ,-0.369,4,128,1,1,0.729,0.481,0.702,132
advise,-0.37,27,722,1,1,0.76,0.393,0.705,749
hell,-0.37,704,18204,1,1,0.02,0.918,0.565,18908
shorts,-0.37,16,438,1,1,0.622,0.481,0.287,454
lineup,-0.37,5,154,1,1,0.635,0.427,0.638,159
noodle,-0.37,5,154,1,1,0.633,0.216,0.225,159
obese,-0.37,5,154,1,1,0.133,0.427,0.25,159
commercial,-0.371,19,516,1,1,0.806,0.49,0.528,535
mouth,-0.372,124,3234,1,1,0.734,0.294,0.336,3358
organization,-0.372,24,646,1,1,0.81,0.535,0.851,670
flawed,-0.372,16,439,1,1,0.133,0.49,0.194,455
pineapple,-0.373,8,232,1,1,0.677,0.316,0.245,240
panda,-0.373,9,258,1,1,0.646,0.194,0.406,267
beg,-0.374,68,1787,1,1,0.292,0.608,0.328,1855
daisy,-0.374,11,310,1,1,0.562,0.367,0.333,321
room,-0.374,2217,57491,1,1,0.729,0.283,0.445,59708
son,-0.374,374,9720,1,1,0.792,0.365,0.528,10094
legitimate,-0.374,12,336,1,1,0.792,0.363,0.841,348
expenses,-0.374,12,336,1,1,0.24,0.633,0.396,348
courage,-0.375,229,5965,1,1,0.83,0.728,0.849,6194
aids,-0.375,16,440,1,1,0.561,0.48,0.5,456
pushing,-0.375,165,4308,1,1,0.396,0.644,0.731,4473
feminist,-0.375,24,648,1,1,0.51,0.56,0.585,672
lucky,-0.376,225,5867,1,1,0.96,0.61,0.793,6092
pervert,-0.377,8,233,1,1,0.082,0.863,0.5,241
buildup,-0.377,0,25,1,1,0.49,0.509,0.623,25
turnaround,-0.377,0,25,1,1,0.56,0.654,0.407,25
fjord,-0.377,0,25,1,1,0.51,0.404,0.463,25
broth,-0.377,0,25,1,1,0.5,0.245,0.168,25
complicity,-0.377,1,51,1,1,0.323,0.684,0.67,52
overplayed,-0.377,0,25,1,1,0.224,0.798,0.586,25
drier,-0.377,0,25,1,1,0.306,0.347,0.392,25
civic,-0.377,2,77,1,1,0.653,0.24,0.573,79
malnutrition,-0.377,0,25,1,1,0.024,0.592,0.277,25
simples,-0.377,0,25,1,1,0.724,0.24,0.263,25
transsexual,-0.377,0,25,1,1,0.264,0.815,0.423,25
oat,-0.377,0,25,1,1,0.622,0.17,0.298,25
correctness,-0.377,1,51,1,1,0.796,0.45,0.649,52
impregnate,-0.377,0,25,1,1,0.51,0.721,0.655,25
improper,-0.377,1,51,1,1,0.229,0.52,0.259,52
blazer,-0.377,0,25,1,1,0.635,0.385,0.417,25
divorcee,-0.377,0,25,1,1,0.153,0.61,0.481,25
annoyin,-0.377,0,25,1,1,0.26,0.573,0.352,25
tailgate,-0.377,0,25,1,1,0.323,0.34,0.398,25
caveman,-0.377,1,51,1,1,0.235,0.644,0.482,52
kisser,-0.377,0,25,1,1,0.844,0.682,0.618,25
nylons,-0.377,0,25,1,1,0.556,0.379,0.32,25
wallpaper,-0.377,4,129,1,1,0.673,0.173,0.308,133
taper,-0.377,0,25,1,1,0.541,0.41,0.415,25
echelon,-0.377,0,25,1,1,0.49,0.404,0.425,25
warned,-0.377,21,571,1,1,0.302,0.604,0.547,592
kilo,-0.377,0,25,1,1,0.438,0.358,0.461,25
gimmick,-0.377,1,51,1,1,0.38,0.663,0.519,52
plausible,-0.377,3,103,1,1,0.714,0.404,0.51,106
shave,-0.377,10,285,1,1,0.521,0.41,0.48,295
vise,-0.377,1,51,1,1,0.533,0.391,0.451,52
corpus,-0.377,1,51,1,1,0.543,0.34,0.49,52
coerce,-0.377,0,25,1,1,0.26,0.741,0.517,25
egomaniac,-0.377,0,25,1,1,0.133,0.708,0.596,25
selfharm,-0.377,0,25,1,1,0.35,0.62,0.407,25
stalls,-0.377,3,103,1,1,0.582,0.378,0.451,106
lyrics,-0.379,176,4611,1,1,0.582,0.214,0.333,4787
open,-0.38,1095,28577,1,1,0.62,0.48,0.569,29672
cooking,-0.381,108,2846,1,1,0.694,0.51,0.434,2954
positive,-0.382,389,10188,1,1,0.959,0.51,0.855,10577
obvious,-0.382,101,2664,1,1,0.625,0.336,0.585,2765
mason,-0.382,6,182,1,1,0.541,0.442,0.58,188
federal,-0.383,25,679,1,1,0.53,0.459,0.859,704
traitor,-0.383,25,679,1,1,0.112,0.796,0.491,704
amber,-0.384,16,444,1,1,0.635,0.308,0.369,460
dysfunctional,-0.384,10,287,1,1,0.125,0.558,0.307,297
manipulate,-0.385,14,392,1,1,0.255,0.7,0.772,406
disingenuous,-0.385,4,130,1,1,0.194,0.509,0.204,134
misfit,-0.385,8,235,1,1,0.173,0.5,0.393,243
toilet,-0.386,92,2438,1,1,0.49,0.29,0.233,2530
throat,-0.386,56,1494,1,1,0.35,0.538,0.346,1550
fair,-0.386,193,5089,1,1,0.812,0.557,0.643,5282
sweetener,-0.386,3,104,1,1,0.67,0.333,0.33,107
panicky,-0.386,3,104,1,1,0.284,0.962,0.393,107
warn,-0.387,14,393,1,1,0.429,0.647,0.564,407
motherfucker,-0.388,17,472,1,1,0.122,0.827,0.351,489
dab,-0.388,6,183,1,1,0.51,0.337,0.34,189
home,-0.388,3914,102923,1,1,0.854,0.27,0.545,106837
buy,-0.388,362,9543,1,1,0.771,0.769,0.612,9905
slander,-0.388,9,262,1,1,0.184,0.604,0.454,271
thingy,-0.388,9,262,1,1,0.458,0.312,0.158,271
click,-0.389,34,920,1,1,0.536,0.365,0.268,954
cabinet,-0.39,17,473,1,1,0.552,0.306,0.465,490
vat,-0.39,2,78,1,1,0.333,0.491,0.509,80
emo,-0.39,59,1579,1,1,0.354,0.314,0.226,1638
manufacturing,-0.39,2,78,1,1,0.653,0.613,0.804,80
ago,-0.39,732,19304,1,1,0.317,0.28,0.404,20036
thanksgiving,-0.39,36,974,1,1,0.927,0.449,0.637,1010
student,-0.39,123,3267,1,1,0.634,0.318,0.537,3390
save,-0.391,519,13710,1,1,0.77,0.439,0.682,14229
thx,-0.391,55,1476,1,1,0.562,0.425,0.461,1531
sniff,-0.391,7,210,1,1,0.396,0.5,0.318,217
generation,-0.391,96,2558,1,1,0.903,0.48,0.685,2654
horrifying,-0.392,17,474,1,1,0.01,0.76,0.352,491
teenager,-0.392,32,870,1,1,0.781,0.593,0.527,902
response,-0.392,125,3325,1,1,0.615,0.5,0.472,3450
house,-0.392,1956,51661,1,1,0.587,0.135,0.533,53617
atrocious,-0.392,4,131,1,1,0.073,0.811,0.445,135
wanting,-0.393,761,20134,1,1,0.76,0.433,0.593,20895
jury,-0.393,6,184,1,1,0.479,0.607,0.789,190
rely,-0.393,99,2642,1,1,0.812,0.429,0.616,2741
forbid,-0.394,17,475,1,1,0.115,0.686,0.598,492
meter,-0.394,8,237,1,1,0.438,0.3,0.463,245
confirm,-0.394,35,951,1,1,0.802,0.439,0.806,986
position,-0.394,137,3649,1,1,0.604,0.451,0.538,3786
honest,-0.394,328,8702,1,1,0.927,0.254,0.75,9030
doubt,-0.395,251,6670,1,1,0.395,0.351,0.231,6921
criminality,-0.396,1,52,1,1,0.122,0.863,0.58,53
synopsis,-0.396,1,52,1,1,0.541,0.39,0.482,53
audition,-0.396,3,105,1,1,0.75,0.685,0.615,108
allergy,-0.396,5,158,1,1,0.296,0.606,0.389,163
polygamy,-0.396,1,52,1,1,0.365,0.647,0.563,53
alarm,-0.396,35,953,1,1,0.241,0.882,0.698,988
yearbook,-0.396,1,52,1,1,0.562,0.231,0.509,53
sewing,-0.396,3,105,1,1,0.625,0.337,0.356,108
violation,-0.396,5,158,1,1,0.083,0.892,0.413,163
structural,-0.396,1,52,1,1,0.582,0.425,0.69,53
heartbreaker,-0.396,1,52,1,1,0.265,0.685,0.58,53
spouse,-0.396,40,1086,1,1,0.75,0.6,0.645,1126
party,-0.397,533,14158,1,1,0.948,0.84,0.547,14691
doll,-0.397,24,662,1,1,0.729,0.321,0.33,686
coke,-0.397,14,397,1,1,0.404,0.461,0.397,411
empower,-0.398,21,583,1,1,0.694,0.779,0.891,604
abroad,-0.398,37,1008,1,1,0.677,0.596,0.561,1045
transferred,-0.399,6,185,1,1,0.48,0.45,0.409,191
discord,-0.4,46,1250,1,1,0.115,0.882,0.465,1296
facial,-0.401,10,292,1,1,0.594,0.429,0.433,302
wait,-0.402,1200,32010,1,1,0.224,0.167,0.264,33210
listen,-0.402,1214,32397,1,1,0.771,0.36,0.445,33611
insider,-0.402,2,79,1,1,0.625,0.562,0.75,81
stud,-0.402,2,79,1,1,0.564,0.531,0.509,81
deserving,-0.403,18,506,1,1,0.802,0.596,0.858,524
normal,-0.403,395,10570,1,1,0.74,0.127,0.38,10965
corrupt,-0.404,50,1361,1,1,0.02,0.806,0.5,1411
ceiling,-0.404,27,747,1,1,0.52,0.224,0.366,774
litter,-0.404,6,186,1,1,0.255,0.551,0.11,192
ranting,-0.405,18,507,1,1,0.181,0.755,0.5,525
advertise,-0.405,3,106,1,1,0.5,0.529,0.58,109
donkey,-0.405,7,213,1,1,0.406,0.367,0.245,220
soda,-0.407,13,374,1,1,0.688,0.314,0.364,387
rice,-0.407,28,776,1,1,0.667,0.208,0.33,804
wishing,-0.407,172,4635,1,1,0.755,0.6,0.491,4807
praying,-0.408,245,6594,1,1,0.646,0.235,0.415,6839
dismiss,-0.408,10,294,1,1,0.167,0.541,0.509,304
makeup,-0.408,44,1206,1,1,0.74,0.333,0.331,1250
fellow,-0.409,188,5071,1,1,0.745,0.298,0.57,5259
predator,-0.409,18,509,1,1,0.143,0.76,0.777,527
terrible,-0.409,263,7088,1,1,0.061,0.849,0.604,7351
injury,-0.41,22,617,1,1,0.049,0.769,0.287,639
succeed,-0.41,51,1397,1,1,0.926,0.755,0.926,1448
inactive,-0.411,8,241,1,1,0.271,0.167,0.159,249
dizzy,-0.411,8,241,1,1,0.199,0.582,0.193,249
sociopath,-0.411,8,241,1,1,0.104,0.863,0.439,249
chest,-0.411,128,3470,1,1,0.52,0.429,0.481,3598
waiting,-0.412,657,17716,1,1,0.239,0.339,0.333,18373
foreign,-0.412,90,2450,1,1,0.573,0.681,0.385,2540
load,-0.413,42,1158,1,1,0.385,0.417,0.528,1200
date,-0.415,424,11473,1,1,0.604,0.231,0.4,11897
deficit,-0.415,3,107,1,1,0.358,0.5,0.269,110
sou,-0.415,3,107,1,1,0.48,0.39,0.412,110
termination,-0.415,0,26,1,1,0.344,0.472,0.545,26
gunpoint,-0.415,0,26,1,1,0.188,0.817,0.719,26
disprove,-0.415,0,26,1,1,0.375,0.625,0.613,26
truss,-0.415,0,26,1,1,0.521,0.482,0.569,26
blameless,-0.415,0,26,1,1,0.759,0.196,0.343,26
spat,-0.415,2,80,1,1,0.427,0.413,0.309,82
pus,-0.415,0,26,1,1,0.135,0.431,0.226,26
contestant,-0.415,1,53,1,1,0.76,0.53,0.602,54
contender,-0.415,1,53,1,1,0.48,0.79,0.681,54
dentists,-0.415,1,53,1,1,0.364,0.6,0.582,54
recession,-0.415,2,80,1,1,0.368,0.398,0.373,82
dole,-0.415,0,26,1,1,0.448,0.402,0.348,26
urn,-0.415,0,26,1,1,0.194,0.52,0.295,26
ulcer,-0.415,0,26,1,1,0.286,0.596,0.377,26
unconcerned,-0.415,0,26,1,1,0.562,0.283,0.298,26
bullpen,-0.415,0,26,1,1,0.48,0.549,0.5,26
temperamental,-0.415,0,26,1,1,0.316,0.774,0.608,26
fluke,-0.415,0,26,1,1,0.446,0.45,0.432,26
hertz,-0.415,0,26,1,1,0.396,0.417,0.506,26
stubble,-0.415,0,26,1,1,0.333,0.442,0.264,26
emetophobia,-0.415,0,26,1,1,0.243,0.62,0.403,26
loophole,-0.415,0,26,1,1,0.406,0.755,0.491,26
goodmorning,-0.415,7,215,1,1,0.922,0.461,0.552,222
wireless,-0.415,2,80,1,1,0.635,0.444,0.537,82
gage,-0.415,0,26,1,1,0.552,0.451,0.473,26
xanax,-0.415,4,134,1,1,0.427,0.402,0.446,138
nitro,-0.415,0,26,1,1,0.5,0.647,0.639,26
appliance,-0.415,0,26,1,1,0.582,0.453,0.538,26
speculate,-0.415,1,53,1,1,0.398,0.602,0.553,54
shocking,-0.416,23,648,1,1,0.378,0.853,0.833,671
hopeful,-0.416,44,1216,1,1,0.947,0.357,0.627,1260
like,-0.417,18895,511247,1,1,0.719,0.353,0.446,530142
chemical,-0.418,10,297,1,1,0.337,0.56,0.508,307
hype,-0.418,50,1381,1,1,0.51,0.5,0.586,1431
twat,-0.418,9,270,1,1,0.292,0.459,0.404,279
obstacle,-0.418,9,270,1,1,0.204,0.708,0.336,279
user,-0.418,19,541,1,1,0.629,0.347,0.442,560
do,-0.418,11271,305492,1,1,0.67,0.548,0.536,316763
cutie,-0.419,18,514,1,1,0.638,0.528,0.464,532
block,-0.419,99,2710,1,1,0.286,0.35,0.402,2809
tornado,-0.419,8,243,1,1,0.26,0.896,0.784,251
adorable,-0.419,35,975,1,1,0.969,0.519,0.457,1010
constitution,-0.419,22,623,1,1,0.59,0.38,0.889,645
raise,-0.42,116,3175,1,1,0.885,0.685,0.765,3291
including,-0.42,170,4641,1,1,0.7,0.378,0.518,4811
brighter,-0.42,39,1085,1,1,0.918,0.698,0.833,1124
char,-0.421,11,325,1,1,0.554,0.361,0.404,336
bleach,-0.421,5,162,1,1,0.336,0.282,0.337,167
doorbell,-0.421,5,162,1,1,0.564,0.5,0.307,167
satellite,-0.422,4,135,1,1,0.562,0.409,0.764,139
epidemic,-0.423,13,380,1,1,0.092,0.83,0.611,393
newborn,-0.423,8,244,1,1,0.918,0.58,0.372,252
ask,-0.423,960,26163,1,1,0.531,0.44,0.459,27123
bump,-0.423,21,598,1,1,0.286,0.458,0.368,619
wedding,-0.423,77,2123,1,1,0.875,0.802,0.642,2200
fry,-0.424,7,217,1,1,0.52,0.61,0.324,224
flashback,-0.424,7,217,1,1,0.265,0.4,0.485,224
died,-0.424,275,7522,1,1,0.021,0.65,0.327,7797
lewd,-0.425,6,190,1,1,0.188,0.673,0.412,196
pay,-0.425,377,10316,1,1,0.514,0.588,0.592,10693
unmarried,-0.426,9,272,1,1,0.438,0.48,0.545,281
count,-0.426,188,5159,1,1,0.594,0.389,0.492,5347
poorly,-0.426,22,627,1,1,0.077,0.62,0.196,649
appointments,-0.426,12,354,1,1,0.745,0.677,0.625,366
will,-0.426,11853,323836,1,1,0.698,0.408,0.735,335689
allegiance,-0.427,2,81,1,1,0.917,0.398,0.75,83
takeover,-0.427,2,81,1,1,0.663,0.531,0.861,83
council,-0.427,23,655,1,1,0.875,0.279,0.635,678
opponent,-0.427,8,245,1,1,0.08,0.741,0.716,253
tong,-0.427,2,81,1,1,0.475,0.48,0.37,83
email,-0.428,70,1941,1,1,0.698,0.23,0.456,2011
questioning,-0.428,45,1258,1,1,0.438,0.696,0.509,1303
carrot,-0.429,4,136,1,1,0.5,0.235,0.279,140
dumbasses,-0.429,4,136,1,1,0.316,0.59,0.363,140
vibrator,-0.429,4,136,1,1,0.479,0.798,0.5,140
intruder,-0.429,4,136,1,1,0.146,0.74,0.324,140
size,-0.429,56,1561,1,1,0.531,0.336,0.569,1617
economy,-0.43,33,931,1,1,0.583,0.434,0.771,964
diabetes,-0.43,11,328,1,1,0.051,0.472,0.279,339
choke,-0.43,20,575,1,1,0.167,0.788,0.676,595
squeeze,-0.43,13,383,1,1,0.458,0.676,0.532,396
mad,-0.431,408,11220,1,1,0.219,0.873,0.277,11628
bed,-0.431,895,24587,1,1,0.604,0.173,0.327,25482
visibility,-0.431,8,246,1,1,0.75,0.444,0.676,254
coward,-0.431,35,987,1,1,0.102,0.49,0.149,1022
parental,-0.431,8,246,1,1,0.76,0.43,0.627,254
license,-0.431,19,548,1,1,0.5,0.394,0.702,567
popcorn,-0.432,18,521,1,1,0.875,0.441,0.231,539
song,-0.432,944,25965,1,1,0.854,0.413,0.5,26909
kos,-0.433,1,54,1,1,0.5,0.471,0.407,55
conservatism,-0.433,1,54,1,1,0.406,0.369,0.633,55
poof,-0.433,3,109,1,1,0.469,0.387,0.21,112
prude,-0.433,1,54,1,1,0.327,0.41,0.333,55
electrician,-0.433,1,54,1,1,0.449,0.59,0.62,55
consenting,-0.433,1,54,1,1,0.727,0.406,0.693,55
vogue,-0.433,1,54,1,1,0.74,0.491,0.538,55
vigilant,-0.433,7,219,1,1,0.469,0.643,0.791,226
transmission,-0.433,1,54,1,1,0.688,0.49,0.611,55
nix,-0.433,1,54,1,1,0.33,0.38,0.404,55
wobble,-0.433,1,54,1,1,0.375,0.62,0.35,55
sandstorm,-0.433,1,54,1,1,0.324,0.821,0.629,55
credence,-0.433,1,54,1,1,0.76,0.46,0.737,55
craig,-0.435,8,247,1,1,0.448,0.449,0.49,255
afford,-0.435,163,4519,1,1,0.571,0.58,0.575,4682
liver,-0.436,6,192,1,1,0.439,0.29,0.385,198
born,-0.436,596,16462,1,1,0.865,0.509,0.591,17058
gang,-0.436,61,1709,1,1,0.217,0.85,0.629,1770
psychologist,-0.436,11,330,1,1,0.375,0.308,0.658,341
leftovers,-0.436,11,330,1,1,0.219,0.35,0.116,341
bored,-0.436,339,9378,1,1,0.153,0.167,0.196,9717
buying,-0.437,91,2538,1,1,0.665,0.784,0.589,2629
weirdo,-0.437,37,1048,1,1,0.173,0.539,0.328,1085
billy,-0.437,25,717,1,1,0.49,0.397,0.375,742
mafia,-0.438,7,220,1,1,0.204,0.867,0.676,227
stunt,-0.438,7,220,1,1,0.387,0.555,0.526,227
piss,-0.438,44,1243,1,1,0.354,0.462,0.268,1287
mean,-0.438,1587,43906,1,1,0.44,0.467,0.62,45493
worthy,-0.439,115,3207,1,1,0.812,0.34,0.796,3322
warms,-0.439,14,414,1,1,0.594,0.58,0.632,428
lousy,-0.439,5,165,1,1,0.125,0.482,0.234,170
sweets,-0.439,11,331,1,1,0.91,0.422,0.321,342
pep,-0.439,8,248,1,1,0.51,0.51,0.364,256
purring,-0.439,2,82,1,1,0.748,0.33,0.271,84
semester,-0.439,55,1549,1,1,0.521,0.327,0.482,1604
idiots,-0.44,52,1467,1,1,0.143,0.6,0.144,1519
driver,-0.441,55,1551,1,1,0.553,0.538,0.637,1606
concussion,-0.442,3,110,1,1,0.072,0.708,0.482,113
boob,-0.442,3,110,1,1,0.694,0.6,0.392,113
whip,-0.442,11,332,1,1,0.208,0.899,0.509,343
autism,-0.443,29,832,1,1,0.235,0.5,0.447,861
story,-0.443,839,23323,1,1,0.653,0.406,0.704,24162
standard,-0.443,42,1193,1,1,0.673,0.143,0.605,1235
fairness,-0.443,8,249,1,1,0.74,0.317,0.552,257
spray,-0.443,17,499,1,1,0.438,0.41,0.333,516
skip,-0.444,46,1306,1,1,0.458,0.804,0.439,1352
saw,-0.445,578,16115,1,1,0.316,0.541,0.518,16693
arm,-0.446,81,2283,1,1,0.552,0.285,0.469,2364
coach,-0.446,37,1058,1,1,0.633,0.823,0.735,1095
hoping,-0.446,232,6493,1,1,0.684,0.469,0.454,6725
wheelchair,-0.447,7,222,1,1,0.24,0.337,0.245,229
penis,-0.447,15,445,1,1,0.354,0.81,0.556,460
update,-0.447,101,2843,1,1,0.698,0.535,0.802,2944
encouraged,-0.447,34,975,1,1,0.953,0.702,0.657,1009
tipsy,-0.447,8,250,1,1,0.51,0.625,0.57,258
funny,-0.447,424,11853,1,1,0.918,0.61,0.566,12277
confirmed,-0.448,37,1060,1,1,0.76,0.49,0.764,1097
asap,-0.449,50,1424,1,1,0.571,0.5,0.552,1474
class,-0.45,306,8586,1,1,0.656,0.314,0.522,8892
dismayed,-0.451,4,139,1,1,0.165,0.735,0.389,143
overslept,-0.451,0,27,1,1,0.408,0.315,0.3,27
custodian,-0.451,0,27,1,1,0.594,0.625,0.528,27
aback,-0.451,1,55,1,1,0.385,0.407,0.288,56
recurrent,-0.451,0,27,1,1,0.552,0.5,0.561,27
traction,-0.451,2,83,1,1,0.429,0.585,0.648,85
fainting,-0.451,1,55,1,1,0.333,0.51,0.214,56
septic,-0.451,0,27,1,1,0.281,0.462,0.425,27
fireball,-0.451,0,27,1,1,0.302,0.777,0.664,27
surgeon,-0.451,3,111,1,1,0.5,0.598,0.793,114
gubernatorial,-0.451,0,27,1,1,0.552,0.604,0.897,27
impunity,-0.451,1,55,1,1,0.313,0.721,0.602,56
unmanageable,-0.451,0,27,1,1,0.177,0.666,0.482,27
bandage,-0.451,1,55,1,1,0.22,0.327,0.286,56
impotent,-0.451,2,83,1,1,0.146,0.587,0.333,85
eyeliner,-0.451,1,55,1,1,0.688,0.349,0.347,56
sleazy,-0.451,1,55,1,1,0.292,0.674,0.37,56
firefly,-0.451,1,55,1,1,0.622,0.41,0.363,56
midwife,-0.451,1,55,1,1,0.531,0.57,0.453,56
implanted,-0.451,0,27,1,1,0.347,0.5,0.679,27
dislocated,-0.451,0,27,1,1,0.125,0.625,0.2,27
competency,-0.451,0,27,1,1,0.768,0.775,0.764,27
directive,-0.451,0,27,1,1,0.604,0.53,0.918,27
sturgeon,-0.451,0,27,1,1,0.417,0.473,0.465,27
supplementary,-0.451,0,27,1,1,0.625,0.352,0.541,27
geographic,-0.451,1,55,1,1,0.698,0.33,0.664,56
cornbread,-0.451,0,27,1,1,0.643,0.304,0.302,27
commonwealth,-0.451,2,83,1,1,0.63,0.406,0.702,85
fleece,-0.451,0,27,1,1,0.561,0.25,0.381,27
ante,-0.451,0,27,1,1,0.448,0.32,0.417,27
infanticide,-0.451,1,55,1,1,0.167,0.856,0.443,56
applesauce,-0.451,0,27,1,1,0.75,0.167,0.291,27
chewy,-0.451,0,27,1,1,0.625,0.418,0.39,27
lazy,-0.453,93,2635,1,1,0.392,0.264,0.096,2728
fund,-0.453,21,616,1,1,0.521,0.36,0.426,637
drugs,-0.453,103,2916,1,1,0.167,0.75,0.368,3019
team,-0.453,350,9851,1,1,0.708,0.461,0.688,10201
embarrass,-0.455,9,280,1,1,0.082,0.667,0.364,289
predict,-0.455,9,280,1,1,0.615,0.486,0.654,289
randomly,-0.455,54,1545,1,1,0.41,0.594,0.302,1599
mil,-0.455,8,252,1,1,0.534,0.388,0.347,260
nation,-0.455,116,3289,1,1,0.594,0.443,0.821,3405
stance,-0.456,21,618,1,1,0.604,0.333,0.609,639
garlic,-0.456,6,196,1,1,0.46,0.323,0.277,202
defender,-0.456,6,196,1,1,0.639,0.708,0.75,202
swap,-0.456,6,196,1,1,0.552,0.5,0.509,202
number,-0.457,262,7405,1,1,0.406,0.231,0.471,7667
worker,-0.457,29,844,1,1,0.719,0.598,0.684,873
acting,-0.457,138,3915,1,1,0.698,0.643,0.5,4053
info,-0.458,59,1690,1,1,0.75,0.33,0.642,1749
mister,-0.458,9,281,1,1,0.604,0.406,0.663,290
flu,-0.458,19,563,1,1,0.23,0.547,0.25,582
curved,-0.458,4,140,1,1,0.542,0.407,0.337,144
shock,-0.459,36,1043,1,1,0.286,0.821,0.453,1079
think,-0.459,6491,183221,1,1,0.786,0.408,0.618,189712
positivity,-0.459,59,1693,1,1,0.959,0.549,0.87,1752
gentleman,-0.459,20,592,1,1,0.823,0.439,0.712,612
trending,-0.459,20,592,1,1,0.75,0.472,0.6,612
moronic,-0.46,3,112,1,1,0.122,0.5,0.224,115
veggie,-0.46,3,112,1,1,0.602,0.245,0.409,115
lame,-0.46,53,1525,1,1,0.145,0.41,0.217,1578
happy,-0.461,3299,93293,1,1,1,0.735,0.772,96592
bug,-0.461,43,1243,1,1,0.286,0.5,0.246,1286
wearing,-0.461,128,3648,1,1,0.646,0.52,0.461,3776
hank,-0.462,9,282,1,1,0.51,0.375,0.339,291
stuff,-0.462,686,19446,1,1,0.622,0.367,0.263,20132
bam,-0.462,12,367,1,1,0.427,0.472,0.39,379
dirty,-0.462,84,2406,1,1,0.153,0.46,0.17,2490
sum,-0.463,45,1302,1,1,0.792,0.34,0.42,1347
treatable,-0.463,2,84,1,1,0.78,0.302,0.56,86
lawyer,-0.463,17,509,1,1,0.521,0.569,0.784,526
monogamous,-0.463,2,84,1,1,0.51,0.335,0.402,86
mumble,-0.463,2,84,1,1,0.292,0.444,0.245,86
pat,-0.463,25,736,1,1,0.418,0.377,0.34,761
swift,-0.464,27,793,1,1,0.76,0.776,0.698,820
sexy,-0.465,107,3065,1,1,0.865,0.945,0.802,3172
fighter,-0.465,29,851,1,1,0.637,0.76,0.898,880
college,-0.467,308,8787,1,1,0.7,0.467,0.746,9095
tangled,-0.468,18,540,1,1,0.26,0.539,0.316,558
butt,-0.468,45,1309,1,1,0.347,0.725,0.336,1354
unreliable,-0.469,3,113,1,1,0.108,0.48,0.24,116
fax,-0.469,1,56,1,1,0.406,0.368,0.304,57
ingrained,-0.469,5,170,1,1,0.531,0.49,0.712,175
flaky,-0.469,1,56,1,1,0.363,0.509,0.279,57
subspace,-0.469,1,56,1,1,0.47,0.453,0.475,57
fronting,-0.469,1,56,1,1,0.5,0.48,0.509,57
absentee,-0.469,1,56,1,1,0.235,0.33,0.279,57
cartel,-0.469,1,56,1,1,0.438,0.394,0.602,57
realize,-0.469,1012,28871,1,1,0.757,0.462,0.647,29883
grieving,-0.469,36,1054,1,1,0.093,0.673,0.403,1090
psychopath,-0.47,10,313,1,1,0.04,0.943,0.536,323
row,-0.471,61,1770,1,1,0.427,0.275,0.406,1831
trauma,-0.471,104,2999,1,1,0.112,0.792,0.453,3103
boss,-0.471,94,2714,1,1,0.31,0.627,0.954,2808
trend,-0.472,28,828,1,1,0.625,0.458,0.706,856
failure,-0.472,134,3860,1,1,0.167,0.575,0.139,3994
manage,-0.473,99,2860,1,1,0.56,0.53,0.719,2959
immigrant,-0.473,10,314,1,1,0.357,0.663,0.509,324
starve,-0.473,21,629,1,1,0.073,0.729,0.402,650
supermarket,-0.475,8,257,1,1,0.69,0.547,0.571,265
candor,-0.475,2,85,1,1,0.74,0.389,0.607,87
spinal,-0.475,2,85,1,1,0.312,0.491,0.296,87
diploma,-0.475,2,85,1,1,0.75,0.462,0.731,87
check,-0.475,424,12184,1,1,0.523,0.552,0.602,12608
treat,-0.476,233,6716,1,1,0.573,0.571,0.436,6949
yessss,-0.476,16,487,1,1,0.719,0.796,0.415,503
clever,-0.476,16,487,1,1,0.896,0.353,0.729,503
motivate,-0.476,23,688,1,1,0.812,0.776,0.873,711
badly,-0.476,104,3014,1,1,0.073,0.509,0.286,3118
percentage,-0.479,9,287,1,1,0.469,0.4,0.553,296
menopause,-0.479,4,143,1,1,0.204,0.46,0.306,147
mustard,-0.479,4,143,1,1,0.5,0.346,0.275,147
blushing,-0.479,4,143,1,1,0.51,0.789,0.288,147
heartbreaking,-0.48,75,2190,1,1,0.146,0.811,0.423,2265
news,-0.48,326,9427,1,1,0.633,0.58,0.61,9753
nanny,-0.481,6,201,1,1,0.615,0.37,0.528,207
ignore,-0.482,181,5256,1,1,0.146,0.23,0.295,5437
viral,-0.482,8,259,1,1,0.24,0.612,0.518,267
stop,-0.482,1389,40155,1,1,0.28,0.51,0.49,41544
fix,-0.483,212,6156,1,1,0.76,0.538,0.519,6368
right,-0.483,3853,111452,1,1,0.74,0.352,0.71,115305
cash,-0.483,36,1069,1,1,0.867,0.552,0.714,1105
lesbian,-0.483,38,1127,1,1,0.385,0.66,0.415,1165
stroke,-0.485,21,636,1,1,0.562,0.44,0.57,657
unpunished,-0.486,0,28,1,1,0.292,0.594,0.519,28
granddad,-0.486,1,57,1,1,0.74,0.248,0.461,58
paralyze,-0.486,0,28,1,1,0.188,0.367,0.471,28
reelection,-0.486,0,28,1,1,0.541,0.673,0.681,28
reckoning,-0.486,7,231,1,1,0.418,0.622,0.532,238
polygraph,-0.486,0,28,1,1,0.427,0.491,0.602,28
wasp,-0.486,3,115,1,1,0.39,0.62,0.406,118
stun,-0.486,0,28,1,1,0.333,0.71,0.451,28
yodel,-0.486,0,28,1,1,0.51,0.454,0.389,28
prenatal,-0.486,0,28,1,1,0.74,0.422,0.445,28
circling,-0.486,2,86,1,1,0.51,0.654,0.336,88
abrasive,-0.486,0,28,1,1,0.392,0.61,0.593,28
disobey,-0.486,0,28,1,1,0.143,0.556,0.491,28
binder,-0.486,1,57,1,1,0.438,0.25,0.308,58
goody,-0.486,0,28,1,1,0.786,0.337,0.57,28
quits,-0.486,3,115,1,1,0.229,0.48,0.352,118
mailman,-0.486,0,28,1,1,0.659,0.418,0.462,28
mammy,-0.486,0,28,1,1,0.68,0.415,0.436,28
impartial,-0.486,1,57,1,1,0.531,0.406,0.685,58
hustler,-0.486,0,28,1,1,0.26,0.821,0.627,28
smoker,-0.486,3,115,1,1,0.208,0.528,0.311,118
sycamore,-0.486,0,28,1,1,0.5,0.401,0.527,28
meatloaf,-0.486,0,28,1,1,0.625,0.389,0.375,28
ope,-0.486,1,57,1,1,0.375,0.38,0.395,58
ops,-0.486,5,173,1,1,0.417,0.55,0.528,178
lobbyist,-0.486,0,28,1,1,0.385,0.527,0.565,28
stillbirth,-0.486,0,28,1,1,0.092,0.809,0.291,28
randy,-0.486,4,144,1,1,0.49,0.394,0.481,148
arghh,-0.486,0,28,1,1,0.292,0.536,0.397,28
collusion,-0.486,7,231,1,1,0.365,0.51,0.4,238
bridesmaid,-0.486,0,28,1,1,0.748,0.519,0.618,28
compute,-0.486,0,28,1,1,0.531,0.408,0.564,28
hearted,-0.486,23,695,1,1,0.823,0.41,0.805,718
suitcase,-0.486,4,144,1,1,0.562,0.212,0.318,148
zilch,-0.486,0,28,1,1,0.409,0.451,0.361,28
heheh,-0.486,4,144,1,1,0.625,0.51,0.278,148
divulge,-0.486,0,28,1,1,0.531,0.718,0.467,28
hormonal,-0.486,3,115,1,1,0.5,0.62,0.551,118
ensure,-0.487,40,1189,1,1,0.737,0.406,0.759,1229
attacking,-0.487,27,812,1,1,0.276,0.837,0.642,839
call,-0.488,1243,36148,1,1,0.594,0.627,0.558,37391
recovery,-0.489,75,2209,1,1,0.781,0.402,0.737,2284
annoy,-0.489,46,1366,1,1,0.094,0.765,0.286,1412
pump,-0.489,10,319,1,1,0.417,0.882,0.681,329
condo,-0.489,20,610,1,1,0.439,0.288,0.607,630
babysit,-0.49,8,261,1,1,0.719,0.587,0.398,269
failing,-0.49,51,1513,1,1,0.125,0.49,0.268,1564
caution,-0.491,6,203,1,1,0.552,0.712,0.547,209
ticket,-0.491,86,2535,1,1,0.684,0.387,0.434,2621
campaigning,-0.492,5,174,1,1,0.531,0.663,0.741,179
kidding,-0.492,58,1720,1,1,0.622,0.625,0.457,1778
comment,-0.493,120,3531,1,1,0.667,0.417,0.379,3651
cheering,-0.493,40,1196,1,1,0.815,0.824,0.642,1236
promotion,-0.493,9,291,1,1,0.906,0.755,0.769,300
billboard,-0.493,4,145,1,1,0.594,0.317,0.481,149
terrorism,-0.494,12,379,1,1,0.06,0.971,0.673,391
clowns,-0.494,16,496,1,1,0.6,0.673,0.391,512
compensation,-0.495,3,116,1,1,0.775,0.469,0.598,119
curfew,-0.495,3,116,1,1,0.219,0.618,0.623,119
upgrade,-0.495,23,701,1,1,0.786,0.5,0.67,724
clothes,-0.495,118,3480,1,1,0.833,0.27,0.414,3598
cock,-0.495,18,555,1,1,0.418,0.562,0.392,573
hysterical,-0.496,6,204,1,1,0.29,0.942,0.398,210
hilarious,-0.496,43,1288,1,1,0.75,0.64,0.537,1331
bye,-0.497,149,4396,1,1,0.375,0.398,0.321,4545
sauce,-0.497,18,556,1,1,0.562,0.515,0.288,574
jab,-0.498,2,87,1,1,0.385,0.519,0.482,89
funeral,-0.498,45,1349,1,1,0.073,0.38,0.393,1394
money,-0.499,656,19304,1,1,0.844,0.608,0.827,19960
hater,-0.5,11,352,1,1,0.052,0.702,0.422,363
smiled,-0.501,52,1559,1,1,0.949,0.53,0.536,1611
percent,-0.503,24,736,1,1,0.47,0.35,0.356,760
violence,-0.503,96,2859,1,1,0.061,0.933,0.719,2955
low,-0.503,333,9851,1,1,0.292,0.22,0.102,10184
tan,-0.503,13,412,1,1,0.643,0.46,0.444,425
deceived,-0.503,5,176,1,1,0.059,0.673,0.302,181
motherland,-0.503,1,58,1,1,0.677,0.375,0.731,59
turnover,-0.503,1,58,1,1,0.49,0.392,0.512,59
printer,-0.503,3,117,1,1,0.479,0.345,0.471,120
personnel,-0.503,3,117,1,1,0.729,0.344,0.587,120
kale,-0.503,1,58,1,1,0.469,0.226,0.411,59
caucus,-0.503,1,58,1,1,0.418,0.311,0.491,59
sir,-0.503,222,6578,1,1,0.622,0.306,0.778,6800
advice,-0.504,250,7408,1,1,0.698,0.408,0.688,7658
lend,-0.504,26,796,1,1,0.52,0.461,0.508,822
suddenly,-0.504,266,7881,1,1,0.67,0.51,0.456,8147
target,-0.504,45,1357,1,1,0.633,0.573,0.798,1402
country,-0.504,560,16568,1,1,0.698,0.394,0.693,17128
luck,-0.505,209,6203,1,1,0.854,0.49,0.717,6412
guarantee,-0.505,42,1270,1,1,0.949,0.337,0.805,1312
sticker,-0.506,6,206,1,1,0.583,0.306,0.346,212
bullshit,-0.506,223,6623,1,1,0.042,0.676,0.183,6846
picky,-0.506,46,1389,1,1,0.257,0.729,0.598,1435
hubby,-0.506,33,1005,1,1,0.548,0.435,0.43,1038
corny,-0.506,16,502,1,1,0.448,0.37,0.221,518
goo,-0.507,4,147,1,1,0.439,0.396,0.312,151
chuck,-0.507,17,532,1,1,0.542,0.509,0.413,549
interview,-0.507,61,1835,1,1,0.573,0.77,0.619,1896
rent,-0.507,96,2872,1,1,0.344,0.429,0.446,2968
funk,-0.507,15,473,1,1,0.466,0.589,0.39,488
boom,-0.507,31,947,1,1,0.604,0.655,0.731,978
bone,-0.508,58,1747,1,1,0.337,0.37,0.413,1805
clinical,-0.508,10,325,1,1,0.337,0.412,0.64,335
pension,-0.509,8,266,1,1,0.625,0.409,0.406,274
puck,-0.509,2,88,1,1,0.398,0.49,0.349,90
predicting,-0.509,2,88,1,1,0.463,0.647,0.679,90
yam,-0.509,2,88,1,1,0.5,0.206,0.152,90
crap,-0.51,118,3532,1,1,0.083,0.644,0.167,3650
concerned,-0.511,77,2317,1,1,0.292,0.698,0.35,2394
chronic,-0.511,51,1545,1,1,0.255,0.615,0.464,1596
puke,-0.512,7,237,1,1,0.204,0.545,0.292,244
unsolved,-0.512,3,118,1,1,0.146,0.39,0.235,121
backbone,-0.512,7,237,1,1,0.538,0.464,0.62,244
parrot,-0.512,3,118,1,1,0.588,0.333,0.292,121
missy,-0.512,3,118,1,1,0.521,0.48,0.333,121
expensive,-0.512,72,2171,1,1,0.323,0.54,0.53,2243
system,-0.512,203,6071,1,1,0.615,0.346,0.764,6274
ear,-0.512,125,3750,1,1,0.469,0.216,0.231,3875
see,-0.512,4181,124497,1,1,0.635,0.269,0.312,128678
niece,-0.513,23,714,1,1,0.771,0.32,0.4,737
disease,-0.513,70,2115,1,1,0.041,0.539,0.333,2185
brighten,-0.514,10,327,1,1,0.76,0.547,0.649,337
weirdness,-0.514,10,327,1,1,0.316,0.491,0.364,337
wreck,-0.514,23,715,1,1,0.22,0.77,0.339,738
slick,-0.515,6,208,1,1,0.388,0.383,0.349,214
pancakes,-0.516,8,268,1,1,0.844,0.373,0.402,276
career,-0.517,116,3497,1,1,0.74,0.712,0.606,3613
harassing,-0.517,9,298,1,1,0.12,0.873,0.446,307
besties,-0.517,9,298,1,1,0.888,0.509,0.614,307
program,-0.517,50,1525,1,1,0.561,0.323,0.713,1575
episode,-0.518,229,6884,1,1,0.719,0.367,0.509,7113
asleep,-0.518,205,6169,1,1,0.604,0.1,0.27,6374
kids,-0.519,827,24822,1,1,0.837,0.5,0.417,25649
disappointed,-0.52,93,2818,1,1,0.071,0.472,0.241,2911
measles,-0.52,0,29,1,1,0.092,0.635,0.422,29
deacon,-0.52,0,29,1,1,0.531,0.43,0.736,29
outnumber,-0.52,1,59,1,1,0.347,0.615,0.577,60
subservient,-0.52,0,29,1,1,0.255,0.402,0.339,29
libel,-0.52,0,29,1,1,0.128,0.694,0.403,29
athlete,-0.52,5,179,1,1,0.781,0.718,0.686,184
software,-0.52,10,329,1,1,0.561,0.28,0.57,339
aggressor,-0.52,0,29,1,1,0.146,0.948,0.823,29
kebab,-0.52,0,29,1,1,0.531,0.431,0.377,29
rotate,-0.52,1,59,1,1,0.458,0.47,0.492,60
noob,-0.52,2,89,1,1,0.417,0.43,0.267,91
travesty,-0.52,5,179,1,1,0.354,0.644,0.407,184
holler,-0.52,4,149,1,1,0.276,0.825,0.406,153
sup,-0.52,3,119,1,1,0.551,0.358,0.385,122
mutilated,-0.52,0,29,1,1,0.041,0.841,0.356,29
tracer,-0.52,0,29,1,1,0.573,0.327,0.645,29
goodies,-0.52,2,89,1,1,0.95,0.622,0.424,91
stallion,-0.52,0,29,1,1,0.628,0.596,0.779,29
parmesan,-0.52,0,29,1,1,0.698,0.321,0.382,29
zit,-0.52,0,29,1,1,0.337,0.41,0.381,29
chimp,-0.52,0,29,1,1,0.394,0.588,0.345,29
playmate,-0.52,0,29,1,1,0.878,0.509,0.398,29
raffle,-0.52,0,29,1,1,0.64,0.51,0.454,29
nibble,-0.52,0,29,1,1,0.551,0.551,0.411,29
lymphoma,-0.52,0,29,1,1,0.208,0.645,0.33,29
handbag,-0.52,1,59,1,1,0.562,0.24,0.336,60
employer,-0.52,6,209,1,1,0.663,0.518,0.767,215
unrepentant,-0.52,0,29,1,1,0.24,0.445,0.413,29
administrator,-0.52,0,29,1,1,0.538,0.48,0.902,29
dummy,-0.52,9,299,1,1,0.44,0.144,0.25,308
homicide,-0.52,1,59,1,1,0.01,0.973,0.518,60
heterosexual,-0.52,4,149,1,1,0.561,0.612,0.557,153
cinder,-0.52,0,29,1,1,0.35,0.26,0.157,29
tell,-0.52,2108,63278,1,1,0.551,0.35,0.457,65386
thanks,-0.52,1091,32774,1,1,0.918,0.472,0.461,33865
irrational,-0.521,22,690,1,1,0.125,0.648,0.394,712
immigration,-0.522,15,480,1,1,0.39,0.667,0.454,495
needy,-0.523,49,1503,1,1,0.36,0.451,0.245,1552
treason,-0.523,11,360,1,1,0.094,0.806,0.552,371
shirt,-0.523,57,1744,1,1,0.698,0.186,0.231,1801
showing,-0.524,189,5722,1,1,0.622,0.54,0.491,5911
bitchy,-0.524,7,240,1,1,0.188,0.7,0.373,247
live,-0.524,5831,175719,1,1,0.88,0.673,0.676,181550
wake,-0.525,329,9945,1,1,0.7,0.47,0.512,10274
rubbish,-0.525,19,602,1,1,0.198,0.454,0.164,621
defeated,-0.525,32,994,1,1,0.104,0.582,0.145,1026
fox,-0.525,57,1748,1,1,0.323,0.555,0.491,1805
server,-0.526,22,693,1,1,0.656,0.356,0.536,715
demographic,-0.527,4,150,1,1,0.459,0.356,0.594,154
verify,-0.527,4,150,1,1,0.761,0.481,0.704,154
runaway,-0.527,13,422,1,1,0.271,0.77,0.402,435
handy,-0.527,8,271,1,1,0.741,0.378,0.639,279
wish,-0.528,1602,48458,1,1,0.771,0.583,0.647,50060
elementary,-0.528,12,392,1,1,0.594,0.286,0.686,404
factual,-0.528,3,120,1,1,0.656,0.44,0.545,123
kidnapped,-0.529,14,453,1,1,0.044,0.923,0.455,467
relationship,-0.529,1063,32220,1,1,0.867,0.566,0.589,33283
chase,-0.53,63,1938,1,1,0.396,0.878,0.623,2001
pretending,-0.531,80,2455,1,1,0.378,0.42,0.317,2535
lid,-0.531,5,181,1,1,0.49,0.189,0.255,186
boxer,-0.531,2,90,1,1,0.49,0.81,0.802,92
repulsive,-0.531,5,181,1,1,0.146,0.775,0.425,186
severity,-0.531,2,90,1,1,0.26,0.712,0.661,92
raptors,-0.531,2,90,1,1,0.28,0.565,0.591,92
persist,-0.531,8,272,1,1,0.765,0.644,0.727,280
embarrassment,-0.532,22,697,1,1,0.143,0.685,0.226,719
criminal,-0.532,51,1578,1,1,0.021,0.83,0.529,1629
senior,-0.533,53,1640,1,1,0.561,0.415,0.536,1693
scan,-0.533,4,151,1,1,0.479,0.423,0.47,155
cautious,-0.533,14,455,1,1,0.47,0.445,0.517,469
unwanted,-0.534,97,2979,1,1,0.177,0.546,0.205,3076
hold,-0.534,716,21814,1,1,0.448,0.29,0.364,22530
dealing,-0.534,287,8762,1,1,0.724,0.415,0.598,9049
helpful,-0.534,107,3286,1,1,0.816,0.337,0.705,3393
awkward,-0.535,153,4687,1,1,0.296,0.65,0.358,4840
issue,-0.535,273,8340,1,1,0.316,0.819,0.351,8613
ring,-0.535,102,3136,1,1,0.677,0.427,0.464,3238
propaganda,-0.535,23,730,1,1,0.521,0.651,0.618,753
unimportant,-0.535,12,395,1,1,0.281,0.24,0.175,407
bullet,-0.536,16,517,1,1,0.408,0.794,0.634,533
dog,-0.536,497,15184,1,1,0.704,0.5,0.407,15681
infect,-0.537,1,60,1,1,0.102,0.777,0.424,61
puff,-0.537,7,243,1,1,0.531,0.367,0.26,250
crappy,-0.537,21,670,1,1,0.039,0.582,0.208,691
dude,-0.537,429,13115,1,1,0.809,0.356,0.615,13544
caring,-0.537,143,4392,1,1,0.635,0.469,0.5,4535
stove,-0.538,8,274,1,1,0.466,0.391,0.405,282
singing,-0.539,194,5964,1,1,0.885,0.594,0.528,6158
clapping,-0.54,4,152,1,1,0.823,0.894,0.686,156
shaking,-0.54,50,1560,1,1,0.275,0.849,0.255,1610
horrific,-0.54,22,703,1,1,0.094,0.846,0.481,725
smart,-0.54,121,3734,1,1,0.906,0.607,0.923,3855
garbage,-0.54,62,1928,1,1,0.188,0.51,0.192,1990
annoying,-0.541,254,7809,1,1,0.082,0.853,0.348,8063
oversight,-0.542,2,91,1,1,0.385,0.618,0.723,93
channel,-0.542,67,2085,1,1,0.49,0.287,0.405,2152
gut,-0.543,29,920,1,1,0.408,0.367,0.364,949
fan,-0.543,260,8014,1,1,0.781,0.429,0.357,8274
fed,-0.544,74,2304,1,1,0.602,0.37,0.482,2378
sibling,-0.544,22,706,1,1,0.857,0.34,0.636,728
font,-0.545,3,122,1,1,0.615,0.336,0.576,125
stocks,-0.545,3,122,1,1,0.573,0.598,0.586,125
waiter,-0.545,7,245,1,1,0.459,0.3,0.295,252
demented,-0.545,3,122,1,1,0.088,0.787,0.309,125
jeopardy,-0.545,3,122,1,1,0.129,0.908,0.536,125
parenting,-0.545,20,645,1,1,0.812,0.52,0.676,665
socialism,-0.545,12,399,1,1,0.51,0.5,0.56,411
censorship,-0.546,4,153,1,1,0.219,0.698,0.421,157
japan,-0.548,62,1943,1,1,0.667,0.482,0.58,2005
grade,-0.548,56,1758,1,1,0.698,0.36,0.6,1814
cheered,-0.549,7,246,1,1,0.875,0.648,0.79,253
terrifying,-0.549,86,2686,1,1,0.031,0.836,0.602,2772
majority,-0.549,136,4231,1,1,0.684,0.56,0.93,4367
stand,-0.549,896,27708,1,1,0.6,0.324,0.509,28604
sec,-0.55,29,926,1,1,0.49,0.385,0.38,955
wear,-0.55,151,4698,1,1,0.312,0.37,0.255,4849
tactics,-0.55,11,370,1,1,0.583,0.676,0.774,381
adopt,-0.55,48,1514,1,1,0.694,0.612,0.701,1562
rick,-0.551,17,556,1,1,0.459,0.42,0.444,573
lip,-0.551,20,649,1,1,0.541,0.348,0.443,669
smile,-0.551,553,17148,1,1,0.906,0.598,0.618,17701
problem,-0.552,657,20372,1,1,0.062,0.644,0.415,21029
law,-0.552,128,3995,1,1,0.74,0.59,0.815,4123
weak,-0.552,219,6815,1,1,0.18,0.241,0.045,7034
happen,-0.552,509,15800,1,1,0.677,0.67,0.551,16309
croft,-0.553,0,30,1,1,0.531,0.429,0.421,30
spousal,-0.553,0,30,1,1,0.656,0.582,0.632,30
seesaw,-0.553,2,92,1,1,0.57,0.559,0.41,94
stockings,-0.553,0,30,1,1,0.458,0.365,0.382,30
fucker,-0.553,14,464,1,1,0.094,0.788,0.357,478
curable,-0.553,0,30,1,1,0.823,0.292,0.574,30
pneumonia,-0.553,1,61,1,1,0.208,0.608,0.324,62
commentator,-0.553,1,61,1,1,0.492,0.51,0.607,62
tumor,-0.553,3,123,1,1,0.102,0.664,0.324,126
wiz,-0.553,1,61,1,1,0.467,0.545,0.441,62
pong,-0.553,1,61,1,1,0.5,0.5,0.396,62
dehydrated,-0.553,1,61,1,1,0.31,0.685,0.212,62
spoiler,-0.553,14,464,1,1,0.347,0.527,0.38,478
evict,-0.553,0,30,1,1,0.042,0.632,0.377,30
unprotected,-0.553,3,123,1,1,0.15,0.582,0.197,126
snoopy,-0.553,0,30,1,1,0.573,0.534,0.291,30
valor,-0.553,0,30,1,1,0.833,0.442,0.763,30
crock,-0.553,1,61,1,1,0.385,0.412,0.421,62
bloated,-0.553,2,92,1,1,0.167,0.593,0.424,94
laundering,-0.553,1,61,1,1,0.439,0.327,0.444,62
fundraiser,-0.553,1,61,1,1,0.61,0.577,0.667,62
gigantic,-0.553,5,185,1,1,0.75,0.776,0.921,190
buzzer,-0.553,0,30,1,1,0.549,0.716,0.48,30
lower,-0.554,78,2450,1,1,0.327,0.296,0.258,2528
dear,-0.554,495,15399,1,1,0.88,0.434,0.629,15894
masturbate,-0.554,18,589,1,1,0.552,0.926,0.5,607
hit,-0.555,444,13830,1,1,0.235,0.931,0.679,14274
unstable,-0.556,22,714,1,1,0.167,0.587,0.15,736
bones,-0.557,64,2023,1,1,0.281,0.343,0.358,2087
lump,-0.557,6,217,1,1,0.438,0.337,0.463,223
donation,-0.557,6,217,1,1,0.792,0.398,0.602,223
coverage,-0.558,19,622,1,1,0.767,0.413,0.629,641
peep,-0.558,18,591,1,1,0.573,0.317,0.269,609
cheesy,-0.558,18,591,1,1,0.47,0.471,0.179,609
family,-0.558,2409,75092,1,1,0.968,0.383,0.643,77501
ostracized,-0.558,5,186,1,1,0.115,0.69,0.377,191
woman,-0.558,897,27993,1,1,0.865,0.5,0.578,28890
hungry,-0.559,91,2868,1,1,0.083,0.69,0.254,2959
kirk,-0.56,13,436,1,1,0.51,0.39,0.388,449
mall,-0.56,40,1279,1,1,0.724,0.663,0.492,1319
unattractive,-0.56,8,280,1,1,0.177,0.307,0.208,288
hash,-0.561,3,124,1,1,0.344,0.453,0.355,127
jug,-0.561,3,124,1,1,0.52,0.25,0.213,127
dispatch,-0.561,3,124,1,1,0.317,0.417,0.555,127
cousins,-0.561,39,1249,1,1,0.76,0.409,0.464,1288
tsunami,-0.561,3,124,1,1,0.042,0.944,0.684,127
topless,-0.561,3,124,1,1,0.625,0.765,0.414,127
predicament,-0.561,7,249,1,1,0.365,0.48,0.541,256
delivery,-0.561,29,937,1,1,0.704,0.461,0.786,966
weird,-0.561,756,23668,1,1,0.26,0.66,0.402,24424
flirt,-0.562,20,656,1,1,0.792,0.79,0.538,676
tattoo,-0.563,32,1032,1,1,0.49,0.602,0.525,1064
olive,-0.563,12,406,1,1,0.571,0.231,0.406,418
batter,-0.563,2,93,1,1,0.561,0.245,0.373,95
fricking,-0.563,2,93,1,1,0.333,0.642,0.357,95
hyperbole,-0.563,2,93,1,1,0.469,0.521,0.542,95
agh,-0.563,2,93,1,1,0.26,0.5,0.4,95
comply,-0.563,2,93,1,1,0.806,0.37,0.638,95
severe,-0.564,53,1692,1,1,0.164,0.735,0.635,1745
teenage,-0.564,30,971,1,1,0.667,0.673,0.558,1001
apparently,-0.565,203,6400,1,1,0.531,0.41,0.426,6603
bearable,-0.565,12,407,1,1,0.542,0.375,0.605,419
settle,-0.565,200,6309,1,1,0.833,0.52,0.772,6509
freezer,-0.566,9,313,1,1,0.396,0.406,0.407,322
yeahhh,-0.566,4,156,1,1,0.82,0.792,0.51,160
fascist,-0.566,9,313,1,1,0.2,0.755,0.527,322
fool,-0.566,117,3705,1,1,0.16,0.56,0.148,3822
estranged,-0.567,6,219,1,1,0.156,0.382,0.377,225
fooled,-0.567,15,502,1,1,0.051,0.692,0.241,517
stay,-0.567,1906,59977,1,1,0.604,0.275,0.516,61883
governor,-0.568,14,471,1,1,0.5,0.683,0.934,485
crazy,-0.568,756,23826,1,1,0.156,0.843,0.321,24582
banjo,-0.569,1,62,1,1,0.469,0.4,0.37,63
gutless,-0.569,1,62,1,1,0.25,0.381,0.384,63
gatorade,-0.569,1,62,1,1,0.719,0.529,0.519,63
passport,-0.569,7,251,1,1,0.653,0.457,0.682,258
diagram,-0.569,1,62,1,1,0.562,0.357,0.445,63
snowball,-0.569,1,62,1,1,0.717,0.444,0.321,63
post,-0.569,364,11501,1,1,0.52,0.426,0.548,11865
kid,-0.569,326,10306,1,1,0.76,0.453,0.298,10632
pepper,-0.57,20,661,1,1,0.4,0.539,0.328,681
pants,-0.57,67,2144,1,1,0.673,0.32,0.333,2211
bless,-0.57,271,8581,1,1,0.929,0.269,0.588,8852
damn,-0.571,760,24020,1,1,0.073,0.784,0.431,24780
losing,-0.571,274,8681,1,1,0.076,0.686,0.223,8955
employee,-0.572,14,473,1,1,0.582,0.361,0.481,487
kiss,-0.573,148,4712,1,1,0.967,0.813,0.63,4860
mayor,-0.573,10,347,1,1,0.469,0.481,0.818,357
publicly,-0.573,35,1138,1,1,0.74,0.481,0.632,1173
jerk,-0.573,24,790,1,1,0.194,0.63,0.238,814
cuddling,-0.574,25,822,1,1,0.917,0.562,0.433,847
slob,-0.574,2,94,1,1,0.275,0.365,0.3,96
trouble,-0.574,149,4749,1,1,0.135,0.811,0.452,4898
hyperventilating,-0.574,2,94,1,1,0.164,0.802,0.625,96
sentiment,-0.575,56,1805,1,1,0.765,0.451,0.639,1861
graduate,-0.575,34,1108,1,1,0.898,0.549,0.778,1142
soy,-0.576,6,221,1,1,0.438,0.25,0.286,227
blinded,-0.576,14,475,1,1,0.245,0.471,0.231,489
friend,-0.578,2082,66198,1,1,0.906,0.413,0.573,68280
downside,-0.578,22,730,1,1,0.19,0.4,0.246,752
laugh,-0.578,308,9824,1,1,0.98,0.639,0.587,10132
outrageous,-0.578,9,317,1,1,0.153,0.945,0.713,326
whack,-0.578,9,317,1,1,0.219,0.816,0.708,326
sack,-0.578,9,317,1,1,0.385,0.337,0.264,326
make,-0.58,4681,149137,1,1,0.684,0.42,0.48,153818
reply,-0.582,136,4371,1,1,0.762,0.29,0.596,4507
everyday,-0.582,536,17138,1,1,0.74,0.392,0.472,17674
slut,-0.582,11,382,1,1,0.071,0.808,0.309,393
wife,-0.582,435,13922,1,1,0.886,0.63,0.583,14357
confirmation,-0.583,15,510,1,1,0.812,0.48,0.692,525
lying,-0.583,144,4632,1,1,0.208,0.704,0.317,4776
packaging,-0.585,2,95,1,1,0.604,0.393,0.549,97
hippo,-0.585,0,31,1,1,0.49,0.404,0.477,31
lisp,-0.585,0,31,1,1,0.365,0.412,0.288,31
campaigner,-0.585,0,31,1,1,0.592,0.698,0.821,31
zipper,-0.585,2,95,1,1,0.39,0.315,0.233,97
imissyou,-0.585,0,31,1,1,0.48,0.608,0.344,31
viscous,-0.585,0,31,1,1,0.398,0.396,0.409,31
swimsuit,-0.585,0,31,1,1,0.74,0.373,0.269,31
confidentially,-0.585,0,31,1,1,0.633,0.469,0.558,31
modem,-0.585,0,31,1,1,0.573,0.355,0.5,31
cosmetic,-0.585,0,31,1,1,0.625,0.304,0.308,31
phony,-0.585,7,255,1,1,0.115,0.592,0.202,262
squish,-0.585,1,63,1,1,0.26,0.788,0.481,64
stylist,-0.585,1,63,1,1,0.76,0.445,0.5,64
waddle,-0.585,0,31,1,1,0.49,0.453,0.388,31
minefield,-0.585,0,31,1,1,0.188,0.839,0.684,31
mamma,-0.585,4,159,1,1,0.6,0.358,0.449,163
pretender,-0.585,0,31,1,1,0.5,0.683,0.574,31
wrenching,-0.585,6,223,1,1,0.204,0.833,0.483,229
grrr,-0.585,2,95,1,1,0.271,0.755,0.327,97
legalize,-0.585,0,31,1,1,0.51,0.46,0.818,31
citizen,-0.585,24,799,1,1,0.631,0.25,0.586,823
sinning,-0.585,2,95,1,1,0.17,0.7,0.422,97
nosebleed,-0.585,0,31,1,1,0.153,0.776,0.361,31
ambassador,-0.585,5,191,1,1,0.651,0.529,0.917,196
investigative,-0.585,1,63,1,1,0.562,0.6,0.704,64
awed,-0.585,0,31,1,1,0.364,0.774,0.361,31
hyperventilate,-0.585,0,31,1,1,0.347,0.729,0.556,31
growls,-0.585,1,63,1,1,0.125,0.675,0.442,64
swoop,-0.585,1,63,1,1,0.479,0.618,0.446,64
united,-0.587,86,2790,1,1,0.781,0.431,0.783,2876
insensitive,-0.587,10,352,1,1,0.219,0.471,0.302,362
watch,-0.588,1021,32814,1,1,0.531,0.346,0.423,33835
sugar,-0.589,37,1220,1,1,0.896,0.382,0.402,1257
advocacy,-0.589,6,224,1,1,0.5,0.646,0.731,230
childish,-0.589,26,867,1,1,0.573,0.442,0.23,893
website,-0.589,31,1028,1,1,0.615,0.442,0.526,1059
holder,-0.59,5,192,1,1,0.592,0.33,0.713,197
tomatoes,-0.59,5,192,1,1,0.615,0.24,0.272,197
exam,-0.591,34,1126,1,1,0.479,0.663,0.577,1160
laughing,-0.592,141,4577,1,1,0.906,0.596,0.534,4718
cough,-0.592,19,644,1,1,0.255,0.627,0.241,663
forget,-0.593,642,20745,1,1,0.312,0.382,0.209,21387
grammar,-0.594,9,322,1,1,0.56,0.287,0.607,331
intern,-0.595,5,193,1,1,0.459,0.46,0.392,198
hunk,-0.595,2,96,1,1,0.438,0.375,0.361,98
franchise,-0.595,8,290,1,1,0.663,0.4,0.56,298
register,-0.595,11,387,1,1,0.49,0.412,0.654,398
fag,-0.595,2,96,1,1,0.122,0.653,0.331,98
judicial,-0.595,2,96,1,1,0.378,0.667,0.833,98
kitchen,-0.596,105,3431,1,1,0.7,0.234,0.398,3536
stranger,-0.596,197,6411,1,1,0.33,0.449,0.302,6608
kiddo,-0.596,12,420,1,1,0.674,0.393,0.419,432
heartbeat,-0.597,37,1230,1,1,0.75,0.698,0.585,1267
barley,-0.597,4,161,1,1,0.614,0.212,0.296,165
side,-0.598,929,30148,1,1,0.439,0.288,0.395,31077
forgive,-0.598,123,4022,1,1,0.781,0.408,0.562,4145
admit,-0.599,180,5876,1,1,0.538,0.423,0.667,6056
telephone,-0.599,18,616,1,1,0.694,0.52,0.425,634
say,-0.6,3028,98417,1,1,0.571,0.31,0.482,101445
horseshit,-0.6,1,64,1,1,0.153,0.582,0.179,65
systematic,-0.6,1,64,1,1,0.617,0.444,0.594,65
receiver,-0.6,3,129,1,1,0.583,0.464,0.586,132
condolence,-0.6,1,64,1,1,0.26,0.443,0.404,65
patronising,-0.6,1,64,1,1,0.439,0.455,0.582,65
childbirth,-0.6,1,64,1,1,0.604,0.861,0.673,65
escalator,-0.6,1,64,1,1,0.5,0.53,0.518,65
smash,-0.6,29,974,1,1,0.195,0.692,0.53,1003
kaiser,-0.6,1,64,1,1,0.47,0.509,0.69,65
autocorrect,-0.6,3,129,1,1,0.551,0.439,0.616,132
school,-0.601,773,25174,1,1,0.765,0.423,0.633,25947
shit,-0.601,2398,78042,1,1,0,0.678,0.294,80440
chick,-0.602,25,846,1,1,0.771,0.602,0.387,871
willing,-0.603,224,7331,1,1,0.833,0.561,0.783,7555
ass,-0.603,766,25000,1,1,0.323,0.75,0.345,25766
trashy,-0.603,4,162,1,1,0.071,0.38,0.161,166
manipulative,-0.603,14,488,1,1,0.177,0.724,0.546,502
handsome,-0.604,30,1010,1,1,0.89,0.6,0.682,1040
heating,-0.604,7,260,1,1,0.647,0.491,0.537,267
document,-0.604,7,260,1,1,0.594,0.24,0.667,267
questionable,-0.604,7,260,1,1,0.268,0.551,0.365,267
fetish,-0.604,7,260,1,1,0.307,0.706,0.5,267
vulnerable,-0.604,111,3654,1,1,0.198,0.49,0.245,3765
unfortunately,-0.604,162,5320,1,1,0.104,0.494,0.281,5482
depressing,-0.605,128,4212,1,1,0.146,0.559,0.216,4340
grader,-0.605,2,97,1,1,0.583,0.317,0.42,99
gutter,-0.605,5,195,1,1,0.466,0.26,0.4,200
juggle,-0.605,2,97,1,1,0.594,0.76,0.426,99
minister,-0.605,23,783,1,1,0.547,0.441,0.892,806
pledged,-0.605,2,97,1,1,0.719,0.63,0.658,99
lea,-0.605,2,97,1,1,0.583,0.294,0.358,99
indictment,-0.605,2,97,1,1,0.245,0.745,0.577,99
prevail,-0.606,16,555,1,1,0.724,0.557,0.75,571
lineage,-0.607,6,228,1,1,0.633,0.465,0.721,234
frat,-0.608,3,130,1,1,0.714,0.371,0.726,133
lobby,-0.608,11,392,1,1,0.625,0.427,0.472,403
goodness,-0.608,81,2686,1,1,0.969,0.321,0.715,2767
saddens,-0.609,8,294,1,1,0.104,0.436,0.144,302
spider,-0.609,36,1212,1,1,0.229,0.569,0.43,1248
arsenal,-0.609,9,327,1,1,0.365,0.741,0.752,336
conclusion,-0.61,100,3315,1,1,0.615,0.377,0.659,3415
terrorist,-0.611,18,623,1,1,0.019,0.93,0.679,641
agent,-0.611,19,656,1,1,0.48,0.439,0.755,675
aunt,-0.612,52,1742,1,1,0.667,0.291,0.42,1794
kudos,-0.613,12,427,1,1,0.925,0.587,0.642,439
birthday,-0.614,431,14231,1,1,0.969,0.844,0.575,14662
duh,-0.614,19,658,1,1,0.357,0.461,0.364,677
credible,-0.615,8,296,1,1,0.917,0.441,0.75,304
wham,-0.615,0,32,1,1,0.469,0.49,0.423,32
presidential,-0.615,10,362,1,1,0.612,0.656,0.972,372
flabbergasted,-0.615,0,32,1,1,0.312,0.802,0.342,32
debit,-0.615,2,98,1,1,0.333,0.4,0.474,100
extortion,-0.615,0,32,1,1,0.112,0.868,0.63,32
soprano,-0.615,0,32,1,1,0.552,0.55,0.685,32
schadenfreude,-0.615,0,32,1,1,0.354,0.64,0.463,32
unintentionally,-0.615,17,593,1,1,0.46,0.49,0.286,610
shipment,-0.615,0,32,1,1,0.582,0.44,0.452,32
eek,-0.615,1,65,1,1,0.292,0.529,0.343,66
poltergeist,-0.615,0,32,1,1,0.271,0.784,0.544,32
soppy,-0.615,0,32,1,1,0.51,0.355,0.297,32
mystified,-0.615,0,32,1,1,0.344,0.6,0.509,32
criticise,-0.615,2,98,1,1,0.073,0.7,0.452,100
tiff,-0.615,1,65,1,1,0.531,0.415,0.343,66
packet,-0.615,2,98,1,1,0.582,0.385,0.407,100
terrier,-0.615,0,32,1,1,0.562,0.54,0.431,32
prosecution,-0.615,3,131,1,1,0.245,0.857,0.647,134
occupational,-0.615,0,32,1,1,0.583,0.469,0.596,32
oily,-0.615,0,32,1,1,0.276,0.533,0.385,32
painkiller,-0.615,0,32,1,1,0.487,0.312,0.481,32
neurologist,-0.615,0,32,1,1,0.608,0.5,0.736,32
bur,-0.615,1,65,1,1,0.385,0.353,0.314,66
keep,-0.616,2355,77782,1,1,0.714,0.296,0.547,80137
counts,-0.617,22,759,1,1,0.343,0.373,0.5,781
betrayed,-0.617,44,1486,1,1,0.122,0.769,0.308,1530
murderer,-0.617,13,462,1,1,0.01,0.96,0.65,475
flat,-0.618,82,2745,1,1,0.408,0.236,0.303,2827
boy,-0.618,418,13863,1,1,0.646,0.392,0.445,14281
attorney,-0.619,7,264,1,1,0.6,0.594,0.754,271
judge,-0.619,173,5765,1,1,0.51,0.604,0.857,5938
accusing,-0.62,6,231,1,1,0.156,0.745,0.324,237
granny,-0.621,9,331,1,1,0.796,0.24,0.452,340
roster,-0.621,4,165,1,1,0.531,0.306,0.381,169
psych,-0.624,10,365,1,1,0.48,0.5,0.526,375
sue,-0.624,13,465,1,1,0.219,0.731,0.679,478
comeback,-0.625,34,1165,1,1,0.58,0.409,0.555,1199
toothpaste,-0.625,2,99,1,1,0.51,0.29,0.371,101
brainless,-0.625,2,99,1,1,0.138,0.31,0.224,101
ridiculous,-0.625,71,2399,1,1,0.159,0.594,0.245,2470
furiously,-0.625,2,99,1,1,0.062,0.925,0.657,101
infection,-0.625,5,199,1,1,0.083,0.735,0.407,204
hobo,-0.625,5,199,1,1,0.323,0.443,0.282,204
flirty,-0.625,2,99,1,1,0.714,0.721,0.491,101
snore,-0.625,2,99,1,1,0.245,0.61,0.481,101
disrespectful,-0.626,21,733,1,1,0.031,0.694,0.273,754
rating,-0.627,7,266,1,1,0.663,0.679,0.637,273
happening,-0.627,216,7245,1,1,0.646,0.529,0.555,7461
male,-0.627,146,4909,1,1,0.612,0.532,0.695,5055
numb,-0.628,69,2338,1,1,0.108,0.42,0.352,2407
woo,-0.628,11,400,1,1,0.646,0.729,0.43,411
automatic,-0.628,6,233,1,1,0.562,0.433,0.664,239
bunch,-0.628,166,5583,1,1,0.552,0.358,0.473,5749
hoot,-0.63,1,66,1,1,0.449,0.56,0.43,67
testimony,-0.63,17,602,1,1,0.615,0.578,0.643,619
credentials,-0.63,1,66,1,1,0.708,0.373,0.675,67
dorky,-0.63,1,66,1,1,0.302,0.48,0.39,67
shutup,-0.63,1,66,1,1,0.333,0.56,0.491,67
remission,-0.63,1,66,1,1,0.418,0.33,0.518,67
bandwagon,-0.63,5,200,1,1,0.625,0.651,0.509,205
staff,-0.632,78,2649,1,1,0.745,0.274,0.627,2727
warren,-0.632,10,368,1,1,0.417,0.57,0.464,378
sketchy,-0.632,6,234,1,1,0.333,0.479,0.241,240
reaction,-0.633,63,2148,1,1,0.47,0.811,0.706,2211
consult,-0.633,4,167,1,1,0.755,0.37,0.441,171
joke,-0.633,187,6316,1,1,0.704,0.61,0.316,6503
darling,-0.634,65,2217,1,1,0.885,0.37,0.608,2282
shout,-0.634,79,2689,1,1,0.229,0.925,0.444,2768
friends,-0.635,4229,142302,1,1,0.929,0.51,0.625,146531
answering,-0.635,34,1177,1,1,0.684,0.5,0.607,1211
disadvantage,-0.635,5,201,1,1,0.15,0.377,0.282,206
educator,-0.635,2,100,1,1,0.827,0.317,0.845,102
scold,-0.635,2,100,1,1,0.194,0.755,0.626,102
poisoning,-0.635,5,201,1,1,0.094,0.837,0.526,206
freshman,-0.637,13,471,1,1,0.677,0.57,0.441,484
unfollow,-0.637,14,505,1,1,0.281,0.337,0.293,519
cereal,-0.637,18,640,1,1,0.612,0.206,0.316,658
mutual,-0.638,53,1821,1,1,0.729,0.321,0.464,1874
vest,-0.638,3,134,1,1,0.667,0.38,0.371,137
widow,-0.638,15,539,1,1,0.25,0.45,0.265,554
midterm,-0.638,3,134,1,1,0.427,0.337,0.425,137
obstruction,-0.638,3,134,1,1,0.125,0.742,0.491,137
cuddles,-0.639,31,1080,1,1,0.847,0.382,0.5,1111
peanut,-0.639,14,506,1,1,0.646,0.202,0.246,520
earthquake,-0.64,11,405,1,1,0.073,0.93,0.812,416
useless,-0.641,97,3318,1,1,0.052,0.342,0.184,3415
manager,-0.641,38,1320,1,1,0.625,0.549,0.897,1358
scares,-0.642,89,3048,1,1,0.122,0.847,0.386,3137
speechless,-0.643,14,508,1,1,0.459,0.32,0.315,522
cookie,-0.643,15,542,1,1,0.792,0.306,0.25,557
thought,-0.644,1866,63383,1,1,0.78,0.315,0.571,65249
psycho,-0.644,19,678,1,1,0.039,0.922,0.56,697
bumblebee,-0.645,0,33,1,1,0.469,0.493,0.321,33
wimp,-0.645,2,101,1,1,0.184,0.49,0.125,103
downer,-0.645,4,169,1,1,0.12,0.594,0.226,173
halftime,-0.645,1,67,1,1,0.458,0.352,0.429,68
abdominal,-0.645,0,33,1,1,0.49,0.456,0.445,33
dictatorship,-0.645,4,169,1,1,0.082,0.806,0.784,173
impairment,-0.645,0,33,1,1,0.17,0.571,0.22,33
cretins,-0.645,0,33,1,1,0.094,0.741,0.328,33
depot,-0.645,1,67,1,1,0.635,0.255,0.471,68
referral,-0.645,1,67,1,1,0.694,0.314,0.603,68
ethnic,-0.645,3,135,1,1,0.583,0.373,0.555,138
twats,-0.645,1,67,1,1,0.406,0.588,0.383,68
unethical,-0.645,2,101,1,1,0.104,0.433,0.269,103
turbo,-0.645,1,67,1,1,0.583,0.729,0.596,68
chandler,-0.645,5,203,1,1,0.51,0.452,0.454,208
grumble,-0.645,1,67,1,1,0.101,0.75,0.333,68
dizziness,-0.645,0,33,1,1,0.229,0.555,0.254,33
unappreciated,-0.645,12,441,1,1,0.143,0.431,0.209,453
unwell,-0.645,7,271,1,1,0.143,0.64,0.221,278
bravado,-0.645,0,33,1,1,0.479,0.51,0.527,33
transplant,-0.645,2,101,1,1,0.445,0.806,0.62,103
leukemia,-0.645,2,101,1,1,0.094,0.572,0.351,103
housing,-0.646,24,850,1,1,0.776,0.304,0.591,874
dawn,-0.647,192,6570,1,1,0.827,0.235,0.519,6762
endgame,-0.647,30,1055,1,1,0.449,0.538,0.526,1085
dun,-0.647,14,510,1,1,0.458,0.431,0.339,524
hostage,-0.648,10,374,1,1,0.163,0.923,0.325,384
gone,-0.648,810,27647,1,1,0.292,0.23,0.19,28457
feminism,-0.65,11,409,1,1,0.541,0.57,0.636,420
specialist,-0.65,5,204,1,1,0.76,0.562,0.877,209
hee,-0.65,5,204,1,1,0.43,0.433,0.312,209
buck,-0.651,9,341,1,1,0.677,0.577,0.72,350
hoe,-0.652,47,1643,1,1,0.302,0.48,0.418,1690
tribal,-0.652,3,136,1,1,0.417,0.404,0.482,139
potty,-0.652,3,136,1,1,0.367,0.373,0.317,139
afflicted,-0.652,3,136,1,1,0.271,0.5,0.167,139
chief,-0.653,33,1164,1,1,0.52,0.544,0.869,1197
detector,-0.655,2,102,1,1,0.459,0.63,0.724,104
mash,-0.655,2,102,1,1,0.44,0.363,0.283,104
contaminated,-0.655,2,102,1,1,0.04,0.5,0.368,104
phone,-0.655,768,26409,1,1,0.729,0.344,0.418,27177
understandable,-0.655,22,789,1,1,0.776,0.363,0.566,811
bravery,-0.656,27,961,1,1,0.898,0.745,0.868,988
bigoted,-0.657,4,171,1,1,0.153,0.76,0.462,175
bop,-0.657,14,515,1,1,0.429,0.49,0.426,529
candy,-0.657,26,928,1,1,0.93,0.425,0.384,954
trash,-0.658,137,4751,1,1,0.163,0.541,0.154,4888
similar,-0.658,263,9093,1,1,0.562,0.25,0.423,9356
buckle,-0.66,3,137,1,1,0.416,0.373,0.361,140
reunited,-0.66,5,206,1,1,0.708,0.439,0.658,211
shitless,-0.66,3,137,1,1,0.271,0.545,0.333,140
consultation,-0.66,3,137,1,1,0.66,0.463,0.625,140
rodeo,-0.66,1,68,1,1,0.49,0.676,0.588,69
stairs,-0.661,31,1104,1,1,0.51,0.439,0.342,1135
nebula,-0.662,6,241,1,1,0.51,0.418,0.438,247
epilepsy,-0.662,6,241,1,1,0.061,0.854,0.25,247
carton,-0.663,4,172,1,1,0.286,0.186,0.241,176
presidency,-0.663,12,449,1,1,0.776,0.686,0.918,461
adoption,-0.663,7,276,1,1,0.625,0.566,0.589,283
drunk,-0.664,171,5958,1,1,0.194,0.8,0.25,6129
cable,-0.665,14,519,1,1,0.583,0.245,0.434,533
equity,-0.665,2,103,1,1,0.792,0.304,0.614,105
hurtful,-0.666,16,589,1,1,0.104,0.68,0.463,605
doubting,-0.666,10,381,1,1,0.224,0.56,0.189,391
ghetto,-0.667,3,138,1,1,0.302,0.63,0.482,141
show,-0.667,998,34721,1,1,0.673,0.771,0.719,35719
apartment,-0.668,332,11578,1,1,0.719,0.393,0.58,11910
bad,-0.668,2019,70276,1,1,0.125,0.625,0.373,72295
giggling,-0.669,5,208,1,1,0.886,0.726,0.391,213
fuck,-0.67,1365,47593,1,1,0.198,0.93,0.446,48958
clique,-0.67,12,452,1,1,0.427,0.43,0.391,464
asshole,-0.67,71,2509,1,1,0.133,0.582,0.263,2580
uniform,-0.671,7,278,1,1,0.57,0.245,0.655,285
blame,-0.672,168,5902,1,1,0.115,0.64,0.309,6070
junior,-0.673,18,663,1,1,0.635,0.343,0.304,681
reiterate,-0.674,2,104,1,1,0.422,0.451,0.655,106
flak,-0.674,0,34,1,1,0.39,0.6,0.6,34
mutter,-0.674,1,69,1,1,0.406,0.427,0.228,70
rawr,-0.674,0,34,1,1,0.457,0.635,0.406,34
panties,-0.674,6,244,1,1,0.594,0.529,0.312,250
reinstall,-0.674,0,34,1,1,0.458,0.5,0.745,34
comrade,-0.674,9,349,1,1,0.781,0.412,0.804,358
gunman,-0.674,0,34,1,1,0.167,0.922,0.689,34
agreeing,-0.674,8,314,1,1,0.854,0.48,0.557,322
douche,-0.674,6,244,1,1,0.49,0.413,0.397,250
stfu,-0.674,24,874,1,1,0.292,0.5,0.39,898
ohno,-0.674,0,34,1,1,0.396,0.475,0.38,34
pandemic,-0.674,0,34,1,1,0.16,0.79,0.544,34
understaffed,-0.674,0,34,1,1,0.148,0.444,0.302,34
speakerphone,-0.674,0,34,1,1,0.531,0.569,0.56,34
babysitter,-0.674,4,174,1,1,0.656,0.415,0.408,178
checkout,-0.674,2,104,1,1,0.597,0.51,0.67,106
proportions,-0.674,1,69,1,1,0.625,0.43,0.5,70
lollipop,-0.674,0,34,1,1,0.628,0.483,0.357,34
marshmallow,-0.674,1,69,1,1,0.74,0.441,0.391,70
patronizing,-0.674,0,34,1,1,0.542,0.365,0.529,34
millionth,-0.674,1,69,1,1,0.635,0.528,0.611,70
immeasurably,-0.674,0,34,1,1,0.51,0.64,0.68,34
waterproof,-0.674,0,34,1,1,0.779,0.423,0.545,34
accounts,-0.675,44,1575,1,1,0.592,0.34,0.471,1619
scare,-0.676,73,2594,1,1,0.122,0.91,0.264,2667
bday,-0.677,47,1683,1,1,0.729,0.6,0.415,1730
slap,-0.678,19,702,1,1,0.1,0.804,0.518,721
password,-0.679,5,210,1,1,0.39,0.356,0.559,215
worldwide,-0.679,22,808,1,1,0.79,0.462,0.851,830
intrusive,-0.68,9,351,1,1,0.461,0.607,0.538,360
graduation,-0.681,16,598,1,1,0.88,0.67,0.837,614
diaper,-0.681,3,140,1,1,0.409,0.274,0.155,143
pickup,-0.681,3,140,1,1,0.561,0.529,0.42,143
whiny,-0.681,7,281,1,1,0.208,0.548,0.375,288
freaky,-0.681,7,281,1,1,0.19,0.615,0.384,288
whore,-0.682,22,810,1,1,0.135,0.88,0.333,832
send,-0.682,315,11142,1,1,0.663,0.48,0.537,11457
overthinking,-0.682,50,1798,1,1,0.408,0.761,0.525,1848
legal,-0.683,37,1341,1,1,0.653,0.387,0.887,1378
uncle,-0.683,57,2048,1,1,0.653,0.255,0.578,2105
tit,-0.684,2,105,1,1,0.402,0.539,0.388,107
smut,-0.684,2,105,1,1,0.357,0.36,0.349,107
growling,-0.684,2,105,1,1,0.119,0.887,0.475,107
aft,-0.684,2,105,1,1,0.48,0.417,0.518,107
stalker,-0.685,7,282,1,1,0.177,0.93,0.639,289
poor,-0.685,287,10193,1,1,0.156,0.358,0.087,10480
enraged,-0.686,4,176,1,1,0.083,0.962,0.636,180
refuse,-0.686,135,4814,1,1,0.18,0.52,0.331,4949
grandmother,-0.686,26,955,1,1,0.792,0.283,0.426,981
corruption,-0.686,35,1274,1,1,0.052,0.83,0.549,1309
puppy,-0.686,46,1664,1,1,0.908,0.461,0.324,1710
headline,-0.686,6,247,1,1,0.63,0.241,0.685,253
hope,-0.688,2161,76742,1,1,0.927,0.317,0.739,78903
bomber,-0.688,1,70,1,1,0.125,0.837,0.81,71
treaty,-0.688,1,70,1,1,0.646,0.382,0.667,71
unqualified,-0.688,1,70,1,1,0.17,0.433,0.173,71
censor,-0.688,1,70,1,1,0.344,0.276,0.538,71
boogie,-0.688,3,141,1,1,0.59,0.543,0.4,144
gymnastics,-0.688,1,70,1,1,0.745,0.677,0.508,71
chug,-0.688,1,70,1,1,0.401,0.413,0.358,71
guts,-0.689,22,816,1,1,0.592,0.649,0.582,838
destined,-0.692,147,5270,1,1,0.698,0.462,0.617,5417
assurance,-0.692,10,391,1,1,0.675,0.442,0.704,401
border,-0.693,44,1604,1,1,0.406,0.382,0.424,1648
irresponsible,-0.693,8,320,1,1,0.177,0.68,0.241,328
rhetoric,-0.694,12,463,1,1,0.417,0.429,0.504,475
nasty,-0.694,45,1641,1,1,0.115,0.62,0.264,1686
educate,-0.694,19,713,1,1,0.76,0.38,0.728,732
account,-0.695,160,5754,1,1,0.531,0.347,0.472,5914
scheme,-0.697,9,357,1,1,0.521,0.269,0.577,366
veteran,-0.697,20,751,1,1,0.56,0.431,0.759,771
broke,-0.697,249,8955,1,1,0.245,0.59,0.37,9204
heroin,-0.698,5,214,1,1,0.276,0.843,0.655,219
upset,-0.699,184,6640,1,1,0.071,0.68,0.33,6824
childless,-0.7,10,394,1,1,0.31,0.4,0.396,404
sickening,-0.7,13,502,1,1,0.074,0.618,0.259,515
rip,-0.701,92,3342,1,1,0.146,0.676,0.365,3434
bill,-0.702,71,2590,1,1,0.396,0.402,0.535,2661
situation,-0.702,393,14179,1,1,0.531,0.387,0.6,14572
guacamole,-0.702,0,35,1,1,0.684,0.317,0.282,35
alto,-0.702,0,35,1,1,0.656,0.404,0.73,35
grownup,-0.702,0,35,1,1,0.735,0.4,0.683,35
overprotective,-0.702,1,71,1,1,0.448,0.673,0.741,72
negligent,-0.702,0,35,1,1,0.167,0.583,0.259,35
unanimous,-0.702,0,35,1,1,0.656,0.38,0.682,35
moustache,-0.702,0,35,1,1,0.47,0.236,0.409,35
nappy,-0.702,0,35,1,1,0.529,0.333,0.207,35
deteriorated,-0.702,0,35,1,1,0.053,0.549,0.237,35
cleavage,-0.702,0,35,1,1,0.542,0.602,0.454,35
grad,-0.702,24,899,1,1,0.806,0.538,0.733,923
cog,-0.702,0,35,1,1,0.427,0.343,0.363,35
matchmaker,-0.702,0,35,1,1,0.615,0.509,0.519,35
deportation,-0.702,0,35,1,1,0.104,0.786,0.45,35
encouraging,-0.704,38,1405,1,1,0.823,0.583,0.755,1443
female,-0.704,164,5948,1,1,0.857,0.52,0.625,6112
cancer,-0.704,121,4400,1,1,0.052,0.694,0.529,4521
advocate,-0.705,23,865,1,1,0.551,0.53,0.818,888
sure,-0.705,1675,60489,1,1,0.724,0.27,0.793,62164
prick,-0.705,9,360,1,1,0.323,0.764,0.269,369
loved,-0.706,1181,42718,1,1,0.927,0.452,0.582,43899
humiliating,-0.708,4,180,1,1,0.062,0.716,0.279,184
monthly,-0.708,14,542,1,1,0.622,0.314,0.364,556
bet,-0.708,154,5613,1,1,0.385,0.698,0.432,5767
liberal,-0.708,49,1810,1,1,0.565,0.565,0.755,1859
elevator,-0.709,33,1231,1,1,0.562,0.604,0.676,1264
kindergarten,-0.71,6,253,1,1,0.833,0.462,0.308,259
volunteering,-0.71,6,253,1,1,0.844,0.614,0.603,259
incompetent,-0.711,9,362,1,1,0.133,0.566,0.239,371
moo,-0.712,2,108,1,1,0.438,0.355,0.3,110
hookup,-0.712,2,108,1,1,0.625,0.529,0.683,110
dice,-0.712,10,399,1,1,0.458,0.441,0.264,409
orientation,-0.713,9,363,1,1,0.667,0.454,0.686,372
sophomore,-0.713,4,181,1,1,0.653,0.415,0.427,185
responsible,-0.714,59,2184,1,1,0.837,0.527,0.833,2243
hardworking,-0.714,6,254,1,1,0.719,0.583,0.792,260
discouraged,-0.715,19,728,1,1,0.22,0.304,0.09,747
migraine,-0.715,10,400,1,1,0.135,0.783,0.318,410
lovee,-0.716,1,72,1,1,0.949,0.592,0.611,73
legit,-0.716,111,4087,1,1,0.747,0.427,0.849,4198
whelp,-0.716,1,72,1,1,0.344,0.458,0.31,73
sperm,-0.716,3,145,1,1,0.396,0.706,0.453,148
withdrawals,-0.716,1,72,1,1,0.427,0.404,0.464,73
donor,-0.716,3,145,1,1,0.714,0.49,0.653,148
jinx,-0.716,1,72,1,1,0.337,0.582,0.373,73
sneaky,-0.716,5,218,1,1,0.24,0.74,0.56,223
nuke,-0.716,1,72,1,1,0.125,0.905,0.873,73
minority,-0.716,33,1240,1,1,0.31,0.332,0.211,1273
exorcist,-0.716,1,72,1,1,0.219,0.906,0.716,73
matter,-0.717,1182,43238,1,1,0.487,0.353,0.562,44420
purse,-0.718,6,255,1,1,0.656,0.176,0.306,261
jackass,-0.719,4,182,1,1,0.188,0.692,0.279,186
angry,-0.719,193,7100,1,1,0.122,0.83,0.604,7293
hard,-0.719,1979,72474,1,1,0.302,0.708,0.616,74453
dodgy,-0.721,2,109,1,1,0.281,0.51,0.254,111
ay,-0.722,16,623,1,1,0.5,0.557,0.255,639
humiliated,-0.722,6,256,1,1,0.104,0.712,0.216,262
cunt,-0.723,22,844,1,1,0.135,0.673,0.377,866
incompetence,-0.724,4,183,1,1,0.077,0.551,0.208,187
rate,-0.724,56,2097,1,1,0.521,0.297,0.407,2153
member,-0.725,124,4600,1,1,0.698,0.333,0.555,4724
bigotry,-0.727,8,331,1,1,0.356,0.737,0.481,339
transparency,-0.727,8,331,1,1,0.847,0.26,0.587,339
pretend,-0.727,134,4981,1,1,0.49,0.528,0.542,5115
million,-0.729,155,5766,1,1,0.776,0.647,0.812,5921
husband,-0.729,263,9763,1,1,0.771,0.5,0.655,10026
slab,-0.73,0,36,1,1,0.398,0.265,0.264,36
erection,-0.73,0,36,1,1,0.64,0.856,0.695,36
muffin,-0.73,1,73,1,1,0.684,0.43,0.306,74
punt,-0.73,0,36,1,1,0.365,0.48,0.393,36
yak,-0.73,0,36,1,1,0.469,0.422,0.422,36
addresses,-0.73,2,110,1,1,0.51,0.354,0.45,112
parliamentary,-0.73,1,73,1,1,0.49,0.554,0.755,74
lecturer,-0.73,2,110,1,1,0.677,0.549,0.736,112
nepotism,-0.73,0,36,1,1,0.349,0.584,0.517,36
supervise,-0.73,0,36,1,1,0.698,0.555,0.889,36
teething,-0.73,0,36,1,1,0.396,0.471,0.474,36
hangry,-0.73,0,36,1,1,0.219,0.794,0.279,36
specialize,-0.73,0,36,1,1,0.776,0.54,0.861,36
tabby,-0.73,0,36,1,1,0.51,0.426,0.387,36
inhaler,-0.73,0,36,1,1,0.408,0.5,0.349,36
antibiotics,-0.73,1,73,1,1,0.448,0.406,0.557,74
want,-0.73,8515,315309,1,1,0.671,0.642,0.598,323824
battle,-0.731,269,10002,1,1,0.365,0.945,0.868,10271
believe,-0.731,1120,41531,1,1,0.781,0.37,0.682,42651
holidays,-0.731,190,7076,1,1,0.939,0.521,0.512,7266
gun,-0.731,64,2408,1,1,0.147,0.92,0.713,2472
afraid,-0.733,1147,42613,1,1,0.01,0.775,0.245,43760
horrid,-0.733,7,296,1,1,0.052,0.765,0.419,303
volunteer,-0.733,21,816,1,1,0.888,0.422,0.596,837
end,-0.735,2095,77951,1,1,0.198,0.349,0.298,80046
veronica,-0.735,4,185,1,1,0.594,0.399,0.402,189
euro,-0.736,3,148,1,1,0.68,0.441,0.521,151
specially,-0.737,31,1192,1,1,0.847,0.398,0.714,1223
report,-0.738,64,2425,1,1,0.583,0.444,0.575,2489
discredit,-0.739,2,111,1,1,0.075,0.529,0.355,113
visa,-0.739,5,223,1,1,0.735,0.367,0.66,228
medical,-0.74,51,1942,1,1,0.583,0.373,0.616,1993
thread,-0.74,194,7289,1,1,0.646,0.184,0.209,7483
blush,-0.74,4,186,1,1,0.698,0.61,0.445,190
cam,-0.74,19,747,1,1,0.448,0.363,0.355,766
paralysis,-0.741,6,261,1,1,0.156,0.5,0.305,267
ana,-0.742,12,486,1,1,0.541,0.3,0.314,498
industry,-0.743,45,1723,1,1,0.65,0.447,0.836,1768
condolences,-0.743,26,1011,1,1,0.198,0.48,0.288,1037
treatment,-0.743,57,2173,1,1,0.663,0.386,0.62,2230
playbook,-0.743,1,74,1,1,0.673,0.582,0.5,75
commie,-0.743,1,74,1,1,0.385,0.519,0.454,75
yaaaay,-0.743,1,74,1,1,0.625,0.677,0.326,75
recruitment,-0.743,1,74,1,1,0.479,0.645,0.591,75
injection,-0.743,1,74,1,1,0.281,0.741,0.518,75
anon,-0.744,10,412,1,1,0.479,0.354,0.298,422
complain,-0.745,100,3792,1,1,0.143,0.682,0.36,3892
thug,-0.745,8,337,1,1,0.24,0.882,0.667,345
stressing,-0.746,28,1090,1,1,0.163,0.866,0.462,1118
idiotic,-0.746,7,300,1,1,0.104,0.62,0.17,307
tic,-0.748,2,112,1,1,0.271,0.438,0.25,114
bout,-0.748,159,6027,1,1,0.208,0.808,0.679,6186
bracelet,-0.75,3,150,1,1,0.776,0.34,0.322,153
lotion,-0.75,3,150,1,1,0.724,0.261,0.188,153
embarrassing,-0.75,40,1547,1,1,0.226,0.809,0.225,1587
mike,-0.751,66,2532,1,1,0.542,0.365,0.423,2598
shoe,-0.752,10,415,1,1,0.517,0.225,0.288,425
miserable,-0.752,201,7641,1,1,0.062,0.461,0.188,7842
jerks,-0.752,5,226,1,1,0.214,0.788,0.395,231
yelling,-0.752,36,1399,1,1,0.323,0.939,0.565,1435
initiative,-0.755,13,530,1,1,0.833,0.615,0.768,543
scam,-0.755,17,682,1,1,0.042,0.745,0.418,699
dress,-0.756,77,2962,1,1,0.76,0.3,0.345,3039
obliterated,-0.756,0,37,1,1,0.24,0.469,0.344,37
consoled,-0.756,1,75,1,1,0.7,0.343,0.452,76
turd,-0.756,3,151,1,1,0.24,0.519,0.383,154
disband,-0.756,1,75,1,1,0.302,0.491,0.417,76
succeeding,-0.756,3,151,1,1,0.867,0.755,0.849,154
pelvic,-0.756,0,37,1,1,0.32,0.632,0.373,37
scissors,-0.756,3,151,1,1,0.458,0.462,0.302,154
dentist,-0.756,8,341,1,1,0.479,0.62,0.642,349
youngster,-0.756,0,37,1,1,0.796,0.557,0.661,37
pissed,-0.756,63,2431,1,1,0.102,0.888,0.543,2494
endemic,-0.756,0,37,1,1,0.406,0.48,0.483,37
diagnose,-0.756,2,113,1,1,0.378,0.52,0.714,115
pediatric,-0.756,0,37,1,1,0.56,0.462,0.49,37
metric,-0.756,1,75,1,1,0.519,0.248,0.573,76
sepsis,-0.756,0,37,1,1,0.229,0.452,0.327,37
guiding,-0.756,16,645,1,1,0.667,0.52,0.714,661
gender,-0.757,58,2242,1,1,0.688,0.346,0.611,2300
idiot,-0.758,82,3158,1,1,0.086,0.567,0.113,3240
stressed,-0.759,122,4683,1,1,0.167,0.74,0.502,4805
joking,-0.759,26,1028,1,1,0.776,0.839,0.407,1054
loaf,-0.762,4,190,1,1,0.755,0.25,0.277,194
constitutional,-0.762,4,190,1,1,0.633,0.418,0.827,194
suspicious,-0.762,12,496,1,1,0.153,0.745,0.431,508
military,-0.763,47,1835,1,1,0.396,0.71,0.875,1882
towel,-0.764,13,535,1,1,0.63,0.208,0.286,548
mental,-0.764,939,36007,1,1,0.49,0.49,0.585,36946
twitch,-0.765,18,727,1,1,0.51,0.74,0.548,745
unclear,-0.765,2,114,1,1,0.229,0.463,0.202,116
socialist,-0.766,13,536,1,1,0.448,0.4,0.543,549
holly,-0.766,7,306,1,1,0.51,0.25,0.443,313
math,-0.767,27,1074,1,1,0.417,0.375,0.6,1101
relate,-0.767,317,12211,1,1,0.653,0.5,0.623,12528
pledge,-0.768,6,268,1,1,0.719,0.49,0.764,274
hearing,-0.768,194,7496,1,1,0.669,0.49,0.595,7690
snitch,-0.769,1,76,1,1,0.3,0.598,0.333,77
expired,-0.769,3,153,1,1,0.198,0.394,0.2,156
yea,-0.771,120,4665,1,1,0.751,0.412,0.472,4785
apartments,-0.771,13,539,1,1,0.704,0.337,0.443,552
frustrating,-0.771,60,2352,1,1,0.042,0.696,0.264,2412
eve,-0.772,106,4128,1,1,0.612,0.378,0.44,4234
coworker,-0.772,32,1273,1,1,0.667,0.49,0.625,1305
awful,-0.772,158,6138,1,1,0.061,0.786,0.45,6296
attack,-0.773,149,5797,1,1,0.286,0.948,0.67,5946
scroll,-0.774,15,618,1,1,0.375,0.63,0.409,633
frustrated,-0.775,55,2166,1,1,0.08,0.651,0.255,2221
dam,-0.775,17,696,1,1,0.25,0.553,0.394,713
papa,-0.776,19,774,1,1,0.656,0.34,0.527,793
guess,-0.777,1040,40373,1,1,0.64,0.463,0.442,41413
grades,-0.779,14,582,1,1,0.521,0.349,0.566,596
survivor,-0.78,54,2139,1,1,0.677,0.75,0.815,2193
idol,-0.781,29,1167,1,1,0.684,0.805,0.853,1196
schmuck,-0.782,0,38,1,1,0.363,0.412,0.375,38
participant,-0.782,1,77,1,1,0.712,0.598,0.613,78
pivot,-0.782,0,38,1,1,0.458,0.382,0.44,38
census,-0.782,1,77,1,1,0.449,0.289,0.553,78
uncontrolled,-0.782,0,38,1,1,0.188,0.891,0.544,38
nasal,-0.782,0,38,1,1,0.479,0.34,0.33,38
woefully,-0.782,0,38,1,1,0.204,0.58,0.269,38
nutcase,-0.782,0,38,1,1,0.286,0.775,0.259,38
omniscient,-0.782,0,38,1,1,0.656,0.334,0.778,38
evacuate,-0.782,1,77,1,1,0.354,0.792,0.314,78
trust,-0.783,749,29266,1,1,0.888,0.547,0.741,30015
genesis,-0.786,33,1330,1,1,0.612,0.429,0.658,1363
screwed,-0.786,24,978,1,1,0.302,0.52,0.464,1002
bottling,-0.787,5,234,1,1,0.365,0.333,0.37,239
nervous,-0.787,116,4582,1,1,0.235,0.82,0.213,4698
tweet,-0.788,436,17136,1,1,0.659,0.49,0.537,17572
hateful,-0.789,24,980,1,1,0.071,0.819,0.43,1004
hire,-0.789,19,784,1,1,0.688,0.558,0.556,803
guy,-0.789,562,22103,1,1,0.583,0.367,0.546,22665
narcissist,-0.789,14,588,1,1,0.173,0.614,0.629,602
estimate,-0.791,2,117,1,1,0.719,0.469,0.517,119
unprepared,-0.791,2,117,1,1,0.204,0.45,0.152,119
empathize,-0.791,13,550,1,1,0.802,0.591,0.66,563
gal,-0.793,16,669,1,1,0.5,0.469,0.337,685
immature,-0.793,13,551,1,1,0.114,0.5,0.2,564
oppose,-0.793,6,275,1,1,0.431,0.8,0.473,281
sharing,-0.794,423,16724,1,1,0.827,0.462,0.545,17147
luckiest,-0.795,1,78,1,1,0.917,0.69,0.852,79
syndrome,-0.795,29,1184,1,1,0.229,0.51,0.246,1213
yayyyy,-0.795,1,78,1,1,0.677,0.613,0.363,79
married,-0.797,295,11715,1,1,0.674,0.57,0.602,12010
income,-0.798,29,1187,1,1,0.75,0.51,0.728,1216
spread,-0.798,91,3643,1,1,0.57,0.583,0.651,3734
anxious,-0.799,179,7134,1,1,0.281,0.875,0.434,7313
tummy,-0.799,5,237,1,1,0.427,0.365,0.23,242
proof,-0.8,60,2420,1,1,0.438,0.509,0.619,2480
decency,-0.8,9,396,1,1,0.75,0.235,0.634,405
internship,-0.801,6,277,1,1,0.59,0.51,0.482,283
roller,-0.801,14,595,1,1,0.521,0.394,0.345,609
hoax,-0.801,3,158,1,1,0.146,0.696,0.303,161
mate,-0.803,165,6609,1,1,0.847,0.417,0.669,6774
trough,-0.805,9,398,1,1,0.5,0.308,0.34,407
defend,-0.806,48,1956,1,1,0.698,0.722,0.67,2004
forsake,-0.806,16,678,1,1,0.102,0.567,0.223,694
encouragement,-0.807,33,1358,1,1,0.865,0.7,0.759,1391
barney,-0.808,1,79,1,1,0.451,0.378,0.44,80
hohoho,-0.808,0,39,1,1,0.677,0.433,0.33,39
enrollment,-0.808,0,39,1,1,0.667,0.391,0.698,39
cheque,-0.808,0,39,1,1,0.698,0.529,0.66,39
unacceptable,-0.808,11,479,1,1,0.133,0.479,0.33,490
tireless,-0.808,0,39,1,1,0.657,0.75,0.645,39
zing,-0.808,0,39,1,1,0.579,0.402,0.402,39
citizenship,-0.808,4,199,1,1,0.786,0.404,0.723,203
fob,-0.808,1,79,1,1,0.327,0.402,0.396,80
accessory,-0.808,0,39,1,1,0.562,0.292,0.445,39
codeine,-0.808,0,39,1,1,0.375,0.582,0.436,39
lifesaver,-0.808,1,79,1,1,0.908,0.745,0.703,80
deduction,-0.808,0,39,1,1,0.438,0.462,0.527,39
yuletide,-0.808,0,39,1,1,0.438,0.43,0.445,39
duct,-0.808,0,39,1,1,0.449,0.435,0.43,39
cervical,-0.808,0,39,1,1,0.375,0.413,0.445,39
crocodile,-0.808,1,79,1,1,0.344,0.708,0.61,80
disabled,-0.808,32,1319,1,1,0.308,0.443,0.235,1351
gross,-0.81,39,1602,1,1,0.115,0.575,0.181,1641
pathetic,-0.811,99,4014,1,1,0.088,0.464,0.139,4113
wan,-0.812,17,722,1,1,0.384,0.457,0.31,739
evidence,-0.815,49,2013,1,1,0.5,0.5,0.778,2062
fucking,-0.815,1119,45116,1,1,0.229,0.812,0.39,46235
sissy,-0.815,6,281,1,1,0.333,0.562,0.232,287
yesss,-0.816,18,765,1,1,0.719,0.657,0.451,783
reminder,-0.816,198,8024,1,1,0.552,0.423,0.589,8222
rag,-0.816,2,120,1,1,0.255,0.226,0.18,122
queue,-0.817,13,564,1,1,0.458,0.344,0.365,577
horrified,-0.817,7,322,1,1,0.04,0.885,0.368,329
genocide,-0.818,4,201,1,1,0.02,0.878,0.627,205
underwear,-0.819,19,808,1,1,0.61,0.546,0.375,827
appalling,-0.82,7,323,1,1,0.16,0.827,0.415,330
dildo,-0.82,3,161,1,1,0.536,0.587,0.491,164
ham,-0.822,6,283,1,1,0.673,0.245,0.404,289
doctor,-0.823,84,3451,1,1,0.7,0.531,0.861,3535
brokenhearted,-0.824,2,121,1,1,0.13,0.598,0.227,123
faze,-0.824,2,121,1,1,0.417,0.515,0.382,123
mess,-0.825,186,7612,1,1,0.143,0.843,0.273,7798
judged,-0.826,38,1588,1,1,0.281,0.686,0.722,1626
panicked,-0.826,7,325,1,1,0.1,0.949,0.26,332
breakdown,-0.827,59,2445,1,1,0.365,0.423,0.361,2504
domestic,-0.827,34,1427,1,1,0.729,0.327,0.5,1461
alleged,-0.827,4,203,1,1,0.365,0.522,0.52,207
gum,-0.827,4,203,1,1,0.573,0.227,0.213,207
ungrateful,-0.83,10,449,1,1,0.219,0.461,0.275,459
rocker,-0.832,0,40,1,1,0.615,0.704,0.625,40
victimized,-0.832,3,163,1,1,0.115,0.644,0.273,166
qualified,-0.832,8,368,1,1,0.76,0.52,0.815,376
broccoli,-0.832,1,81,1,1,0.469,0.2,0.283,82
toad,-0.832,1,81,1,1,0.302,0.452,0.196,82
mouthpiece,-0.832,0,40,1,1,0.573,0.346,0.393,40
silverware,-0.832,0,40,1,1,0.663,0.365,0.409,40
qualifications,-0.832,1,81,1,1,0.776,0.576,0.75,82
kanji,-0.832,0,40,1,1,0.51,0.413,0.425,40
export,-0.832,0,40,1,1,0.567,0.661,0.755,40
therapist,-0.834,61,2546,1,1,0.468,0.43,0.679,2607
government,-0.834,105,4354,1,1,0.427,0.53,0.85,4459
volunteers,-0.835,10,451,1,1,0.82,0.448,0.63,461
fake,-0.835,377,15537,1,1,0.073,0.554,0.268,15914
racism,-0.835,27,1150,1,1,0.122,0.673,0.487,1177
equality,-0.837,14,617,1,1,0.898,0.305,0.716,631
honey,-0.838,97,4039,1,1,0.92,0.431,0.51,4136
nightmares,-0.838,37,1566,1,1,0.082,0.942,0.448,1603
sister,-0.839,327,13534,1,1,0.916,0.324,0.562,13861
bankruptcy,-0.84,2,123,1,1,0.01,0.696,0.209,125
frustrates,-0.84,2,123,1,1,0.146,0.653,0.34,125
chin,-0.84,35,1487,1,1,0.571,0.31,0.269,1522
knowing,-0.841,664,27509,1,1,0.833,0.353,0.658,28173
less,-0.842,1283,53168,1,1,0.265,0.24,0.115,54451
moan,-0.844,12,538,1,1,0.357,0.735,0.352,550
pal,-0.844,36,1534,1,1,0.812,0.426,0.596,1570
firearm,-0.845,1,82,1,1,0.086,0.943,0.864,83
discharge,-0.845,1,82,1,1,0.427,0.538,0.578,83
ankle,-0.845,5,248,1,1,0.5,0.274,0.234,253
hang,-0.845,418,17389,1,1,0.323,0.529,0.446,17807
breakup,-0.846,21,913,1,1,0.25,0.72,0.357,934
clinic,-0.848,10,457,1,1,0.469,0.439,0.6,467
chairman,-0.849,2,124,1,1,0.656,0.567,0.933,126
testify,-0.849,5,249,1,1,0.521,0.65,0.741,254
parent,-0.849,81,3419,1,1,0.812,0.357,0.86,3500
notification,-0.851,8,375,1,1,0.604,0.461,0.671,383
streamer,-0.853,5,250,1,1,0.615,0.53,0.429,255
biased,-0.853,11,501,1,1,0.271,0.302,0.368,512
daughter,-0.853,183,7701,1,1,0.908,0.415,0.455,7884
abuse,-0.854,132,5570,1,1,0.071,0.873,0.469,5702
applaud,-0.854,10,460,1,1,0.865,0.824,0.464,470
hurt,-0.855,680,28569,1,1,0.062,0.773,0.291,29249
gay,-0.856,149,6294,1,1,0.388,0.587,0.429,6443
fess,-0.856,0,41,1,1,0.395,0.42,0.37,41
ibuprofen,-0.856,0,41,1,1,0.448,0.427,0.504,41
chrome,-0.856,3,167,1,1,0.582,0.373,0.421,170
deputy,-0.856,2,125,1,1,0.429,0.53,0.787,127
candidacy,-0.856,0,41,1,1,0.49,0.657,0.696,41
constituents,-0.856,5,251,1,1,0.573,0.414,0.833,256
runny,-0.856,0,41,1,1,0.54,0.439,0.325,41
hooker,-0.856,1,83,1,1,0.214,0.889,0.373,84
chopper,-0.856,0,41,1,1,0.594,0.56,0.509,41
outlast,-0.856,0,41,1,1,0.62,0.786,0.685,41
seatbelt,-0.856,0,41,1,1,0.656,0.314,0.726,41
discriminating,-0.856,0,41,1,1,0.16,0.783,0.462,41
bile,-0.856,1,83,1,1,0.157,0.461,0.324,84
hating,-0.858,62,2648,1,1,0.083,0.82,0.434,2710
turkey,-0.858,18,798,1,1,0.634,0.245,0.247,816
democracy,-0.858,36,1555,1,1,0.68,0.5,0.84,1591
depression,-0.86,727,30679,1,1,0.031,0.52,0.232,31406
landlord,-0.86,5,252,1,1,0.684,0.5,0.858,257
merry,-0.861,105,4469,1,1,0.979,0.731,0.764,4574
funds,-0.861,10,463,1,1,0.633,0.33,0.461,473
representation,-0.861,20,885,1,1,0.677,0.542,0.75,905
charger,-0.861,4,210,1,1,0.531,0.418,0.545,214
devastated,-0.863,18,802,1,1,0.12,0.544,0.264,820
resources,-0.863,57,2452,1,1,0.604,0.348,0.627,2509
xmas,-0.863,50,2156,1,1,0.906,0.717,0.615,2206
agoraphobia,-0.864,2,126,1,1,0.127,0.712,0.438,128
paycheck,-0.864,8,380,1,1,0.896,0.63,0.652,388
fat,-0.865,78,3345,1,1,0.198,0.353,0.237,3423
retarded,-0.865,7,338,1,1,0.302,0.462,0.161,345
coaster,-0.866,11,508,1,1,0.612,0.788,0.627,519
regime,-0.867,10,466,1,1,0.29,0.668,0.773,476
incase,-0.867,10,466,1,1,0.58,0.196,0.365,476
pipeline,-0.868,1,84,1,1,0.479,0.337,0.411,85
stinky,-0.868,3,169,1,1,0.092,0.558,0.176,172
insulin,-0.868,1,84,1,1,0.429,0.472,0.375,85
professionalism,-0.868,1,84,1,1,0.781,0.541,0.944,85
emergency,-0.871,28,1235,1,1,0.2,0.9,0.571,1263
disposable,-0.872,5,255,1,1,0.271,0.439,0.25,260
juggling,-0.872,2,127,1,1,0.562,0.874,0.346,129
cook,-0.873,112,4824,1,1,0.847,0.5,0.412,4936
loser,-0.873,57,2476,1,1,0.083,0.51,0.155,2533
illegal,-0.874,25,1110,1,1,0.061,0.787,0.337,1135
ted,-0.874,42,1837,1,1,0.712,0.453,0.336,1879
suffering,-0.874,459,19662,1,1,0.02,0.719,0.235,20121
care,-0.874,1679,71816,1,1,0.729,0.37,0.5,73495
venue,-0.876,11,513,1,1,0.727,0.316,0.395,524
journalism,-0.877,8,385,1,1,0.622,0.5,0.684,393
holding,-0.879,200,8630,1,1,0.6,0.385,0.67,8830
fundamentalist,-0.88,0,42,1,1,0.49,0.43,0.759,42
fiancee,-0.88,1,85,1,1,0.959,0.626,0.556,86
immorality,-0.88,0,42,1,1,0.188,0.689,0.315,42
reschedule,-0.88,0,42,1,1,0.438,0.422,0.537,42
inefficient,-0.88,0,42,1,1,0.19,0.46,0.173,42
palsy,-0.88,0,42,1,1,0.083,0.446,0.221,42
politician,-0.88,12,558,1,1,0.323,0.551,0.863,570
prevalence,-0.88,0,42,1,1,0.618,0.52,0.815,42
trainee,-0.88,2,128,1,1,0.627,0.408,0.352,130
culpable,-0.88,0,42,1,1,0.14,0.7,0.319,42
colon,-0.88,1,85,1,1,0.449,0.394,0.384,86
reputable,-0.88,0,42,1,1,0.781,0.462,0.919,42
canton,-0.88,0,42,1,1,0.542,0.472,0.536,42
genetics,-0.88,1,85,1,1,0.552,0.46,0.574,86
department,-0.881,26,1161,1,1,0.708,0.358,0.642,1187
telling,-0.884,331,14333,1,1,0.719,0.441,0.527,14664
hangout,-0.884,48,2115,1,1,0.573,0.5,0.462,2163
wallet,-0.885,9,431,1,1,0.68,0.432,0.5,440
vet,-0.886,19,864,1,1,0.531,0.4,0.644,883
ketchup,-0.888,5,259,1,1,0.653,0.338,0.282,264
literally,-0.888,861,37368,1,1,0.571,0.353,0.673,38229
ballot,-0.89,8,390,1,1,0.521,0.361,0.358,398
hopeless,-0.89,75,3301,1,1,0.094,0.298,0.112,3376
polling,-0.892,3,173,1,1,0.448,0.598,0.602,176
premature,-0.892,1,86,1,1,0.281,0.416,0.277,87
whipped,-0.892,5,260,1,1,0.198,0.804,0.361,265
professional,-0.892,66,2916,1,1,0.833,0.447,0.943,2982
defending,-0.893,19,870,1,1,0.604,0.871,0.812,889
cry,-0.893,818,35671,1,1,0.133,0.627,0.255,36489
perk,-0.893,8,391,1,1,0.903,0.519,0.682,399
meow,-0.893,6,304,1,1,0.51,0.51,0.412,310
rave,-0.893,6,304,1,1,0.49,0.637,0.42,310
despicable,-0.894,9,435,1,1,0.146,0.71,0.255,444
cheer,-0.894,103,4535,1,1,0.938,0.784,0.845,4638
zip,-0.894,7,348,1,1,0.487,0.368,0.422,355
rough,-0.895,140,6152,1,1,0.406,0.794,0.632,6292
allegation,-0.895,2,130,1,1,0.578,0.578,0.608,132
suck,-0.898,157,6918,1,1,0.344,0.706,0.377,7075
police,-0.899,72,3198,1,1,0.458,0.77,0.83,3270
bully,-0.899,23,1051,1,1,0.257,0.755,0.564,1074
disability,-0.9,19,876,1,1,0.073,0.482,0.173,895
troops,-0.9,8,394,1,1,0.385,0.718,0.804,402
dental,-0.903,3,175,1,1,0.573,0.404,0.463,178
aneurysm,-0.903,0,43,1,1,0.115,0.69,0.536,43
canned,-0.903,2,131,1,1,0.398,0.357,0.298,133
debacle,-0.903,2,131,1,1,0.156,0.606,0.266,133
amnesty,-0.903,0,43,1,1,0.551,0.451,0.814,43
humbug,-0.903,0,43,1,1,0.219,0.622,0.456,43
dak,-0.903,0,43,1,1,0.51,0.417,0.424,43
felon,-0.903,0,43,1,1,0.111,0.898,0.455,43
bacteria,-0.903,2,131,1,1,0.177,0.553,0.57,133
foxy,-0.903,0,43,1,1,0.552,0.642,0.679,43
electoral,-0.903,3,175,1,1,0.49,0.631,0.602,178
relieved,-0.904,44,1981,1,1,0.896,0.314,0.391,2025
homeless,-0.904,40,1805,1,1,0.042,0.45,0.188,1845
flirting,-0.908,13,618,1,1,0.59,0.773,0.491,631
racist,-0.908,53,2387,1,1,0.061,0.673,0.482,2440
dumb,-0.908,154,6856,1,1,0.188,0.33,0.151,7010
chubby,-0.909,3,176,1,1,0.531,0.427,0.304,179
beta,-0.91,9,442,1,1,0.71,0.37,0.439,451
brother,-0.912,376,16734,1,1,0.823,0.361,0.546,17110
reach,-0.912,567,25213,1,1,0.719,0.625,0.69,25780
text,-0.912,217,9678,1,1,0.604,0.157,0.402,9895
allergic,-0.913,10,488,1,1,0.135,0.549,0.273,498
election,-0.914,55,2490,1,1,0.625,0.519,0.651,2545
consultant,-0.914,1,88,1,1,0.77,0.344,0.808,89
tabloid,-0.914,1,88,1,1,0.438,0.365,0.444,89
flares,-0.914,7,355,1,1,0.58,0.642,0.556,362
hallelujah,-0.914,15,711,1,1,0.77,0.554,0.657,726
petition,-0.914,7,355,1,1,0.498,0.575,0.415,362
breast,-0.915,10,489,1,1,0.753,0.429,0.5,499
don,-0.916,5618,250454,1,1,0.646,0.454,0.702,256072
tough,-0.919,255,11449,1,1,0.344,0.588,0.742,11704
toy,-0.92,16,760,1,1,0.878,0.42,0.275,776
fraud,-0.92,16,760,1,1,0.111,0.688,0.407,776
tax,-0.92,39,1790,1,1,0.26,0.481,0.534,1829
customer,-0.922,27,1255,1,1,0.562,0.43,0.673,1282
salsa,-0.925,3,179,1,1,0.742,0.5,0.37,182
scumbag,-0.925,5,269,1,1,0.24,0.591,0.278,274
hysterectomy,-0.925,0,44,1,1,0.178,0.66,0.47,44
faucet,-0.925,0,44,1,1,0.427,0.278,0.356,44
titanic,-0.925,2,134,1,1,0.427,0.786,0.795,136
dashed,-0.925,0,44,1,1,0.276,0.393,0.338,44
revision,-0.925,1,89,1,1,0.417,0.459,0.71,90
televised,-0.925,0,44,1,1,0.625,0.519,0.518,44
fixable,-0.925,0,44,1,1,0.724,0.47,0.645,44
overweight,-0.925,3,179,1,1,0.052,0.5,0.389,182
earshot,-0.925,0,44,1,1,0.552,0.332,0.408,44
gaggle,-0.925,0,44,1,1,0.542,0.529,0.664,44
waist,-0.925,10,494,1,1,0.542,0.448,0.351,504
aggravate,-0.925,0,44,1,1,0.224,0.77,0.464,44
sceptical,-0.925,0,44,1,1,0.214,0.387,0.466,44
deductible,-0.925,0,44,1,1,0.375,0.286,0.455,44
fiat,-0.925,0,44,1,1,0.52,0.418,0.446,44
statistical,-0.925,0,44,1,1,0.714,0.353,0.627,44
supportive,-0.927,56,2567,1,1,0.875,0.42,0.635,2623
fridge,-0.928,31,1443,1,1,0.571,0.292,0.402,1474
living,-0.931,2613,118244,1,1,0.865,0.608,0.727,120857
poll,-0.933,17,815,1,1,0.552,0.5,0.554,832
savings,-0.933,8,407,1,1,0.776,0.431,0.608,415
hereditary,-0.933,2,135,1,1,0.531,0.6,0.737,137
fiasco,-0.933,2,135,1,1,0.167,0.6,0.2,137
facing,-0.934,108,4944,1,1,0.604,0.406,0.55,5052
worse,-0.934,403,18335,1,1,0.062,0.704,0.225,18738
sappy,-0.935,6,317,1,1,0.583,0.469,0.33,323
bitch,-0.936,446,20331,1,1,0.276,0.74,0.343,20777
anomaly,-0.937,1,90,1,1,0.188,0.538,0.404,91
accuser,-0.937,1,90,1,1,0.122,0.779,0.615,91
talented,-0.937,37,1728,1,1,0.939,0.635,0.938,1765
firearms,-0.937,1,90,1,1,0.22,0.943,0.821,91
smear,-0.939,4,227,1,1,0.23,0.433,0.4,231
kris,-0.939,4,227,1,1,0.427,0.417,0.407,231
disown,-0.94,2,136,1,1,0.153,0.637,0.368,138
targeting,-0.942,3,182,1,1,0.51,0.42,0.58,185
legislation,-0.942,3,182,1,1,0.531,0.418,0.808,185
vile,-0.943,18,869,1,1,0.083,0.537,0.553,887
groceries,-0.943,20,961,1,1,0.74,0.363,0.417,981
sexuality,-0.944,24,1145,1,1,0.67,0.898,0.657,1169
unemployed,-0.945,8,412,1,1,0.094,0.481,0.23,420
cute,-0.946,217,10012,1,1,0.92,0.528,0.579,10229
associate,-0.947,42,1976,1,1,0.812,0.409,0.625,2018
slimy,-0.947,1,91,1,1,0.177,0.5,0.309,92
woot,-0.947,1,91,1,1,0.602,0.49,0.481,92
strep,-0.947,0,45,1,1,0.365,0.594,0.353,45
steering,-0.947,1,91,1,1,0.58,0.431,0.66,92
palliative,-0.947,0,45,1,1,0.548,0.394,0.518,45
perjury,-0.947,0,45,1,1,0.229,0.686,0.409,45
dialysis,-0.947,0,45,1,1,0.194,0.567,0.407,45
hook,-0.948,25,1196,1,1,0.418,0.444,0.395,1221
backup,-0.949,10,506,1,1,0.52,0.51,0.553,516
wig,-0.951,6,322,1,1,0.722,0.279,0.18,328
dishwasher,-0.951,5,276,1,1,0.48,0.296,0.324,281
girl,-0.951,903,41739,1,1,0.74,0.572,0.443,42642
cuddled,-0.952,9,461,1,1,0.906,0.547,0.567,470
cashier,-0.952,4,230,1,1,0.615,0.413,0.484,234
clueless,-0.952,12,600,1,1,0.35,0.333,0.161,612
illegally,-0.953,3,184,1,1,0.133,0.788,0.402,187
gad,-0.955,2,138,1,1,0.51,0.47,0.408,140
yey,-0.96,6,325,1,1,0.677,0.53,0.29,331
lowest,-0.96,35,1676,1,1,0.312,0.304,0.129,1711
abusive,-0.961,47,2238,1,1,0.125,0.903,0.567,2285
bias,-0.962,25,1212,1,1,0.4,0.37,0.541,1237
nominee,-0.964,3,186,1,1,0.662,0.625,0.765,189
procedure,-0.964,3,186,1,1,0.625,0.548,0.654,189
pocket,-0.964,49,2337,1,1,0.458,0.275,0.34,2386
be,-0.964,33374,1561523,1,1,0.67,0.24,0.554,1594897
shocked,-0.966,33,1592,1,1,0.292,0.773,0.375,1625
overdose,-0.966,15,749,1,1,0.11,0.82,0.468,764
payday,-0.969,1,93,1,1,0.833,0.741,0.571,94
phobia,-0.969,14,704,1,1,0.173,0.904,0.291,718
wrecker,-0.969,1,93,1,1,0.229,0.716,0.474,94
mortgage,-0.969,5,281,1,1,0.255,0.408,0.537,286
tripe,-0.969,0,46,1,1,0.312,0.361,0.438,46
swipe,-0.969,4,234,1,1,0.573,0.45,0.266,238
kennel,-0.969,1,93,1,1,0.43,0.48,0.406,94
till,-0.97,380,17930,1,1,0.49,0.327,0.319,18310
dorm,-0.971,53,2541,1,1,0.719,0.194,0.327,2594
exact,-0.971,100,4756,1,1,0.719,0.354,0.685,4856
billion,-0.972,41,1979,1,1,0.719,0.564,0.782,2020
traumatic,-0.973,16,801,1,1,0.062,0.885,0.427,817
venting,-0.977,14,710,1,1,0.375,0.388,0.418,724
supervision,-0.977,4,236,1,1,0.459,0.578,0.825,240
hospice,-0.977,4,236,1,1,0.337,0.443,0.535,240
boo,-0.978,72,3461,1,1,0.153,0.676,0.309,3533
uterus,-0.98,1,94,1,1,0.551,0.42,0.51,95
lunatic,-0.98,5,284,1,1,0.125,0.792,0.442,289
medication,-0.98,25,1235,1,1,0.615,0.439,0.5,1260
shutdown,-0.981,15,760,1,1,0.173,0.367,0.418,775
remind,-0.982,246,11756,1,1,0.721,0.415,0.563,12002
schizophrenia,-0.982,4,237,1,1,0.092,0.88,0.435,241
mama,-0.983,72,3478,1,1,0.86,0.413,0.728,3550
detention,-0.985,3,190,1,1,0.265,0.698,0.562,193
together,-0.987,1154,55270,1,1,0.874,0.392,0.658,56424
horny,-0.988,39,1915,1,1,0.49,0.908,0.56,1954
china,-0.988,32,1580,1,1,0.561,0.443,0.556,1612
sadly,-0.989,113,5467,1,1,0.047,0.255,0.216,5580
deplorable,-0.99,3,191,1,1,0.135,0.657,0.23,194
lettuce,-0.99,1,95,1,1,0.594,0.163,0.291,96
database,-0.99,0,47,1,1,0.604,0.286,0.644,47
deodorant,-0.99,1,95,1,1,0.48,0.265,0.269,96
anorexic,-0.99,0,47,1,1,0.16,0.618,0.245,47
weenie,-0.99,0,47,1,1,0.406,0.451,0.284,47
rape,-0.994,56,2746,1,1,0.062,0.856,0.527,2802
donate,-0.995,15,771,1,1,0.774,0.462,0.577,786
counselor,-0.996,14,723,1,1,0.873,0.365,0.706,737
freak,-0.997,42,2077,1,1,0.052,0.839,0.464,2119
health,-1,589,28604,1,1,0.935,0.427,0.551,29193
bestfriends,-1,7,387,1,1,0.934,0.662,0.647,394
pimple,-1,1,96,1,1,0.245,0.37,0.274,97
raving,-1,1,96,1,1,0.312,0.764,0.358,97
turnout,-1,1,96,1,1,0.641,0.692,0.898,97
jingle,-1,1,96,1,1,0.635,0.5,0.424,97
loco,-1,1,96,1,1,0.306,0.774,0.226,97
dishonest,-1.002,4,242,1,1,0.191,0.491,0.163,246
stabbed,-1.002,9,485,1,1,0.031,0.875,0.431,494
stomach,-1.002,39,1943,1,1,0.367,0.402,0.438,1982
christmas,-1.004,516,25167,1,1,0.959,0.52,0.741,25683
skinny,-1.006,11,584,1,1,0.333,0.333,0.298,595
rant,-1.009,47,2348,1,1,0.219,0.774,0.482,2395
shoulder,-1.01,92,4551,1,1,0.562,0.286,0.406,4643
squeezing,-1.011,2,146,1,1,0.26,0.598,0.557,148
informative,-1.011,2,146,1,1,0.812,0.419,0.741,148
wheeze,-1.011,0,48,1,1,0.229,0.462,0.461,48
wacko,-1.011,0,48,1,1,0.271,0.574,0.33,48
congressional,-1.011,1,97,1,1,0.552,0.491,0.848,98
roommate,-1.012,120,5935,1,1,0.75,0.481,0.48,6055
reassurance,-1.014,22,1130,1,1,0.875,0.127,0.593,1152
whit,-1.015,4,245,1,1,0.562,0.393,0.595,249
paranoid,-1.015,39,1968,1,1,0.122,0.918,0.364,2007
prank,-1.016,3,196,1,1,0.571,0.69,0.389,199
worried,-1.016,148,7342,1,1,0.094,0.824,0.395,7490
refund,-1.017,5,295,1,1,0.541,0.528,0.43,300
supporters,-1.018,41,2073,1,1,0.763,0.539,0.558,2114
pun,-1.019,17,888,1,1,0.653,0.529,0.457,905
begging,-1.019,46,2321,1,1,0.292,0.461,0.202,2367
throw,-1.019,185,9189,1,1,0.344,0.77,0.623,9374
victim,-1.02,67,3363,1,1,0.115,0.676,0.202,3430
juju,-1.021,1,98,1,1,0.541,0.519,0.206,99
malignant,-1.021,1,98,1,1,0.143,0.824,0.37,99
deserve,-1.022,533,26463,1,1,0.802,0.436,0.613,26996
hetero,-1.024,2,148,1,1,0.589,0.405,0.435,150
homophobic,-1.025,10,546,1,1,0.13,0.736,0.464,556
speedy,-1.026,3,198,1,1,0.625,0.625,0.793,201
swear,-1.026,230,11496,1,1,0.601,0.577,0.658,11726
rally,-1.027,11,597,1,1,0.612,0.68,0.554,608
anxiety,-1.029,608,30395,1,1,0.146,0.865,0.342,31003
otto,-1.031,0,49,1,1,0.427,0.425,0.404,49
phi,-1.031,0,49,1,1,0.42,0.361,0.452,49
statistic,-1.031,2,149,1,1,0.508,0.42,0.609,151
firework,-1.031,0,49,1,1,0.786,0.904,0.593,49
heartburn,-1.031,0,49,1,1,0.143,0.613,0.398,49
detection,-1.031,0,49,1,1,0.708,0.567,0.538,49
horribly,-1.035,8,451,1,1,0.05,0.631,0.454,459
horrible,-1.036,145,7335,1,1,0.071,0.857,0.398,7480
crush,-1.036,81,4120,1,1,0.271,0.676,0.582,4201
granddaughter,-1.037,2,150,1,1,0.823,0.445,0.389,152
spiders,-1.038,26,1359,1,1,0.26,0.696,0.368,1385
president,-1.038,178,9016,1,1,0.677,0.622,0.973,9194
cousin,-1.039,50,2569,1,1,0.675,0.394,0.427,2619
dryer,-1.039,4,251,1,1,0.479,0.343,0.277,255
hastily,-1.04,8,453,1,1,0.271,0.609,0.609,461
cuddle,-1.04,57,2925,1,1,0.885,0.559,0.475,2982
unprofessional,-1.041,1,100,1,1,0.042,0.37,0.17,101
spooky,-1.042,15,808,1,1,0.104,0.858,0.38,823
proud,-1.044,288,14640,1,1,0.906,0.7,0.873,14928
breaker,-1.044,2,151,1,1,0.323,0.527,0.52,153
outage,-1.044,2,151,1,1,0.306,0.684,0.438,153
chat,-1.05,131,6726,1,1,0.729,0.4,0.346,6857
brave,-1.05,159,8156,1,1,0.837,0.75,0.917,8315
taxpayer,-1.051,1,101,1,1,0.592,0.528,0.647,102
jihad,-1.051,0,50,1,1,0.323,0.66,0.444,50
sleepover,-1.051,8,458,1,1,0.815,0.519,0.34,466
mace,-1.051,1,101,1,1,0.45,0.412,0.415,102
unzip,-1.051,0,50,1,1,0.378,0.52,0.538,50
coupon,-1.051,0,50,1,1,0.704,0.3,0.421,50
washer,-1.051,2,152,1,1,0.594,0.39,0.365,154
impeach,-1.051,3,203,1,1,0.208,0.776,0.664,206
cried,-1.054,138,7109,1,1,0.167,0.612,0.254,7247
queer,-1.054,27,1432,1,1,0.286,0.61,0.304,1459
evangelical,-1.056,3,204,1,1,0.602,0.389,0.602,207
message,-1.056,284,14619,1,1,0.65,0.391,0.415,14903
eligible,-1.057,2,153,1,1,0.75,0.4,0.518,155
judging,-1.058,36,1900,1,1,0.24,0.625,0.693,1936
verified,-1.06,1,102,1,1,0.781,0.367,0.677,103
carat,-1.06,1,102,1,1,0.823,0.604,0.676,103
xoxo,-1.061,18,978,1,1,0.729,0.52,0.4,996
ex,-1.062,103,5363,1,1,0.25,0.52,0.306,5466
filing,-1.064,2,154,1,1,0.62,0.42,0.7,156
convinced,-1.064,105,5478,1,1,0.75,0.5,0.63,5583
wage,-1.064,12,671,1,1,0.635,0.48,0.565,683
lease,-1.065,7,413,1,1,0.52,0.463,0.545,420
shitty,-1.068,128,6694,1,1,0.02,0.679,0.163,6822
cologne,-1.068,10,570,1,1,0.677,0.413,0.552,580
insecure,-1.069,49,2595,1,1,0.114,0.538,0.132,2644
unhappy,-1.07,77,4053,1,1,0.112,0.5,0.155,4130
nab,-1.07,0,51,1,1,0.469,0.544,0.407,51
fig,-1.07,0,51,1,1,0.573,0.39,0.339,51
reduction,-1.07,1,103,1,1,0.365,0.382,0.24,104
flattering,-1.07,0,51,1,1,0.755,0.686,0.5,51
valve,-1.07,0,51,1,1,0.323,0.363,0.471,51
notwithstanding,-1.07,0,51,1,1,0.367,0.316,0.433,51
esteem,-1.076,23,1255,1,1,0.745,0.38,0.679,1278
paste,-1.076,2,156,1,1,0.5,0.556,0.5,158
trafficking,-1.076,5,313,1,1,0.25,0.71,0.399,318
crisis,-1.077,71,3768,1,1,0.208,0.811,0.431,3839
senator,-1.078,13,733,1,1,0.391,0.422,0.821,746
mop,-1.08,1,104,1,1,0.396,0.442,0.296,105
uninformed,-1.08,1,104,1,1,0.156,0.37,0.182,105
talk,-1.081,2002,105274,1,1,0.833,0.346,0.594,107276
sexual,-1.082,111,5891,1,1,0.584,0.959,0.64,6002
buddy,-1.084,95,5059,1,1,0.884,0.585,0.655,5154
con,-1.084,37,2002,1,1,0.255,0.736,0.427,2039
belittle,-1.084,3,210,1,1,0.122,0.417,0.25,213
rep,-1.086,11,633,1,1,0.52,0.51,0.64,644
candidate,-1.086,18,1003,1,1,0.596,0.49,0.804,1021
gaga,-1.087,8,475,1,1,0.479,0.396,0.26,483
irked,-1.089,0,52,1,1,0.164,0.791,0.353,52
ringer,-1.089,0,52,1,1,0.573,0.604,0.347,52
crook,-1.089,2,158,1,1,0.171,0.765,0.55,160
tun,-1.089,0,52,1,1,0.386,0.413,0.364,52
unsteady,-1.089,2,158,1,1,0.122,0.5,0.19,160
paramedic,-1.089,0,52,1,1,0.673,0.464,0.636,52
sinner,-1.089,12,688,1,1,0.237,0.667,0.356,700
contention,-1.089,0,52,1,1,0.375,0.51,0.738,52
wen,-1.095,19,1065,1,1,0.438,0.431,0.38,1084
yell,-1.095,24,1332,1,1,0.24,0.798,0.558,1356
investigation,-1.1,14,803,1,1,0.531,0.592,0.82,817
struggle,-1.101,356,19141,1,1,0.365,0.82,0.741,19497
armpit,-1.108,0,53,1,1,0.283,0.439,0.25,53
faggot,-1.108,1,107,1,1,0.219,0.643,0.292,108
mozzarella,-1.108,0,53,1,1,0.653,0.265,0.34,53
douchebags,-1.108,0,53,1,1,0.327,0.587,0.366,53
toughen,-1.108,0,53,1,1,0.458,0.683,0.711,53
suspect,-1.109,54,2972,1,1,0.133,0.75,0.509,3026
unfair,-1.109,25,1405,1,1,0.173,0.472,0.19,1430
chop,-1.11,16,919,1,1,0.25,0.655,0.467,935
fault,-1.114,133,7281,1,1,0.188,0.558,0.184,7414
deathbed,-1.117,1,108,1,1,0.051,0.652,0.311,109
panic,-1.118,97,5344,1,1,0.062,0.938,0.4,5441
openly,-1.122,31,1751,1,1,0.603,0.388,0.553,1782
ion,-1.122,81,4492,1,1,0.429,0.33,0.408,4573
remember,-1.123,1334,73178,1,1,0.776,0.422,0.454,74512
panicking,-1.124,10,603,1,1,0.094,0.882,0.333,613
shanghai,-1.126,0,54,1,1,0.551,0.45,0.509,54
concert,-1.127,96,5337,1,1,0.938,0.867,0.718,5433
voting,-1.127,49,2752,1,1,0.615,0.602,0.768,2801
classmate,-1.129,5,330,1,1,0.781,0.4,0.593,335
policy,-1.13,26,1489,1,1,0.324,0.735,0.833,1515
strong,-1.131,819,45316,1,1,0.912,0.745,0.895,46135
feeling,-1.132,3139,173662,1,1,0.806,0.329,0.531,176801
abused,-1.132,35,1991,1,1,0.021,0.874,0.235,2026
microwave,-1.134,6,387,1,1,0.542,0.497,0.443,393
targeted,-1.135,9,554,1,1,0.573,0.537,0.573,563
discrimination,-1.135,7,443,1,1,0.051,0.724,0.379,450
fight,-1.137,476,26531,1,1,0.531,0.868,0.809,27007
mommy,-1.138,22,1279,1,1,0.854,0.353,0.422,1301
banking,-1.138,2,166,1,1,0.51,0.327,0.5,168
stupid,-1.142,236,13246,1,1,0.133,0.51,0.2,13482
yelp,-1.144,0,55,1,1,0.417,0.709,0.431,55
slime,-1.144,2,167,1,1,0.3,0.37,0.183,169
xenophobia,-1.144,0,55,1,1,0.156,0.771,0.5,55
hateeee,-1.144,0,55,1,1,0.219,0.606,0.368,55
ultrasound,-1.144,0,55,1,1,0.573,0.594,0.6,55
reproductive,-1.144,1,111,1,1,0.77,0.604,0.856,112
bankrupt,-1.144,3,223,1,1,0.163,0.673,0.337,226
prom,-1.146,10,616,1,1,0.527,0.44,0.404,626
completely,-1.148,792,44564,1,1,0.73,0.37,0.69,45356
campaign,-1.148,35,2023,1,1,0.602,0.73,0.823,2058
nursing,-1.15,15,900,1,1,0.552,0.549,0.653,915
thank,-1.15,1666,93872,1,1,0.958,0.353,0.526,95538
sneezing,-1.15,2,168,1,1,0.434,0.57,0.345,170
ugly,-1.152,152,8634,1,1,0.167,0.63,0.254,8786
hate,-1.153,1772,100129,1,1,0.031,0.802,0.43,101901
braces,-1.153,1,112,1,1,0.5,0.337,0.568,113
lipstick,-1.153,3,225,1,1,0.653,0.429,0.306,228
stoned,-1.154,10,621,1,1,0.177,0.796,0.375,631
relapse,-1.155,4,282,1,1,0.173,0.46,0.303,286
reassured,-1.155,7,452,1,1,0.854,0.186,0.519,459
tired,-1.156,818,46401,1,1,0.125,0.317,0.191,47219
embarrassed,-1.156,35,2039,1,1,0.184,0.56,0.246,2074
ptsd,-1.157,43,2496,1,1,0.373,0.52,0.346,2539
discriminate,-1.157,3,226,1,1,0.125,0.761,0.366,229
conservative,-1.161,29,1708,1,1,0.615,0.316,0.788,1737
kook,-1.162,2,170,1,1,0.417,0.471,0.398,172
firefighter,-1.162,0,56,1,1,0.637,0.77,0.773,56
derogatory,-1.162,0,56,1,1,0.122,0.58,0.404,56
spokesperson,-1.162,0,56,1,1,0.573,0.453,0.615,56
buffoon,-1.162,1,113,1,1,0.344,0.651,0.29,114
kool-aid,-1.162,0,56,1,1,0.531,0.318,0.393,56
assured,-1.165,18,1085,1,1,0.878,0.327,0.754,1103
valid,-1.165,72,4172,1,1,0.693,0.353,0.565,4244
bra,-1.165,11,685,1,1,0.672,0.529,0.509,696
flop,-1.165,4,285,1,1,0.081,0.642,0.196,289
girlie,-1.168,2,171,1,1,0.604,0.54,0.409,173
consensus,-1.168,2,171,1,1,0.627,0.358,0.625,173
appalled,-1.171,3,229,1,1,0.194,0.792,0.562,232
bigot,-1.171,3,229,1,1,0.479,0.745,0.517,232
disliking,-1.171,3,229,1,1,0.163,0.637,0.366,232
cause,-1.172,1187,68432,1,1,0.469,0.373,0.486,69619
cheat,-1.173,24,1440,1,1,0.125,0.776,0.4,1464
accusation,-1.173,5,345,1,1,0.073,0.718,0.564,350
assessment,-1.175,11,692,1,1,0.75,0.623,0.658,703
alleyway,-1.179,0,57,1,1,0.357,0.471,0.382,57
chump,-1.179,0,57,1,1,0.375,0.451,0.304,57
gullible,-1.179,2,173,1,1,0.44,0.442,0.318,175
paramedics,-1.179,0,57,1,1,0.479,0.594,0.712,57
vomiting,-1.179,1,115,1,1,0.156,0.78,0.157,116
molest,-1.179,0,57,1,1,0.133,0.816,0.319,57
liar,-1.182,28,1685,1,1,0.042,0.606,0.339,1713
felt,-1.182,1442,83960,1,1,0.643,0.417,0.566,85402
provider,-1.183,4,290,1,1,0.751,0.494,0.75,294
tucker,-1.184,3,232,1,1,0.475,0.558,0.429,235
disgusting,-1.188,60,3567,1,1,0.031,0.796,0.245,3627
forefront,-1.188,1,116,1,1,0.573,0.559,0.811,117
scary,-1.189,282,16567,1,1,0.062,0.952,0.528,16849
dementia,-1.19,10,644,1,1,0.092,0.779,0.337,654
sick,-1.191,373,21944,1,1,0.104,0.431,0.136,22317
girly,-1.191,6,410,1,1,0.595,0.462,0.371,416
heartbroken,-1.192,26,1585,1,1,0.082,0.551,0.235,1611
sexist,-1.193,8,528,1,1,0.255,0.798,0.411,536
know,-1.194,7804,459402,1,1,0.765,0.361,0.704,467206
godbless,-1.196,1,117,1,1,0.823,0.395,0.588,118
raisin,-1.196,0,58,1,1,0.594,0.235,0.246,58
brad,-1.196,3,235,1,1,0.49,0.385,0.402,238
wingman,-1.196,0,58,1,1,0.573,0.578,0.582,58
flustered,-1.196,1,117,1,1,0.316,0.903,0.283,118
medley,-1.205,1,118,1,1,0.487,0.352,0.4,119
dad,-1.206,286,17099,1,1,0.857,0.412,0.786,17385
daddy,-1.206,48,2919,1,1,0.795,0.4,0.736,2967
hospital,-1.208,68,4116,1,1,0.323,0.537,0.598,4184
slogan,-1.208,2,178,1,1,0.55,0.216,0.564,180
grandma,-1.208,42,2565,1,1,0.796,0.208,0.491,2607
insurance,-1.209,17,1074,1,1,0.714,0.308,0.825,1091
help,-1.211,1833,109806,1,1,0.673,0.471,0.46,111639
trifling,-1.213,0,59,1,1,0.375,0.418,0.183,59
bracket,-1.213,1,119,1,1,0.49,0.35,0.682,120
pollen,-1.213,0,59,1,1,0.622,0.212,0.292,59
impostor,-1.213,1,119,1,1,0.135,0.704,0.442,120
infuriating,-1.213,4,299,1,1,0.139,0.87,0.509,303
harassment,-1.217,16,1023,1,1,0.083,0.896,0.42,1039
paranormal,-1.217,3,240,1,1,0.167,0.814,0.56,243
accuse,-1.219,7,482,1,1,0.133,0.752,0.5,489
bogus,-1.221,1,120,1,1,0.219,0.353,0.144,121
elderly,-1.223,30,1877,1,1,0.615,0.212,0.283,1907
trump,-1.223,281,17083,1,1,0.64,0.716,0.898,17364
illness,-1.225,137,8374,1,1,0.098,0.717,0.211,8511
outraged,-1.226,4,303,1,1,0.156,0.696,0.538,307
sorry,-1.228,832,50743,1,1,0.406,0.362,0.212,51575
drummer,-1.23,0,60,1,1,0.646,0.7,0.564,60
abort,-1.23,2,182,1,1,0.153,0.686,0.429,184
unarmed,-1.23,1,121,1,1,0.427,0.42,0.241,122
wracking,-1.23,0,60,1,1,0.244,0.607,0.454,60
kidney,-1.234,3,244,1,1,0.448,0.363,0.38,247
attacker,-1.238,1,122,1,1,0.185,0.962,0.629,123
cooker,-1.238,1,122,1,1,0.592,0.373,0.407,123
fudge,-1.238,1,122,1,1,0.853,0.418,0.407,123
bud,-1.238,26,1660,1,1,0.46,0.402,0.333,1686
ill,-1.24,215,13307,1,1,0.073,0.41,0.2,13522
senate,-1.243,12,803,1,1,0.49,0.349,0.836,815
falsely,-1.244,6,432,1,1,0.083,0.48,0.265,438
fussy,-1.246,0,61,1,1,0.417,0.643,0.519,61
hamburger,-1.246,0,61,1,1,0.809,0.551,0.387,61
administration,-1.246,14,929,1,1,0.625,0.404,0.786,943
palpitations,-1.246,0,61,1,1,0.417,0.702,0.528,61
desperado,-1.246,1,123,1,1,0.26,0.745,0.361,124
healthcare,-1.248,13,869,1,1,0.78,0.392,0.63,882
mum,-1.248,80,5033,1,1,0.802,0.317,0.698,5113
sender,-1.249,5,372,1,1,0.542,0.449,0.509,377
sweetheart,-1.25,26,1679,1,1,0.959,0.423,0.509,1705
bisexual,-1.25,8,559,1,1,0.438,0.765,0.459,567
depressed,-1.25,284,17734,1,1,0.024,0.445,0.136,18018
terrified,-1.251,82,5170,1,1,0.09,0.902,0.387,5252
scarier,-1.254,9,624,1,1,0.156,0.846,0.472,633
outrage,-1.257,8,563,1,1,0.06,0.689,0.542,571
wages,-1.258,3,250,1,1,0.776,0.44,0.62,253
yaay,-1.262,0,62,1,1,0.604,0.575,0.327,62
vaccine,-1.262,0,62,1,1,0.5,0.52,0.555,62
certificate,-1.262,1,125,1,1,0.786,0.377,0.746,126
dial,-1.262,4,314,1,1,0.62,0.427,0.596,318
receptionist,-1.262,0,62,1,1,0.677,0.43,0.385,62
foreigner,-1.262,1,125,1,1,0.5,0.519,0.48,126
striker,-1.262,0,62,1,1,0.5,0.589,0.696,62
burp,-1.262,1,125,1,1,0.219,0.594,0.432,126
prosecute,-1.262,0,62,1,1,0.479,0.587,0.769,62
girlfriend,-1.263,90,5740,1,1,0.712,0.763,0.604,5830
disgusted,-1.265,15,1010,1,1,0.051,0.773,0.274,1025
nauseous,-1.266,3,252,1,1,0.135,0.78,0.284,255
crying,-1.267,364,23106,1,1,0.153,0.704,0.208,23470
karaoke,-1.268,4,316,1,1,0.763,0.649,0.342,320
mom,-1.272,458,29206,1,1,0.927,0.336,0.639,29664
freaked,-1.273,10,700,1,1,0.135,0.917,0.34,710
inappropriate,-1.274,7,509,1,1,0.135,0.542,0.353,516
hurting,-1.274,97,6251,1,1,0.153,0.778,0.221,6348
moron,-1.276,11,766,1,1,0.133,0.587,0.183,777
analyst,-1.278,0,63,1,1,0.604,0.415,0.755,63
rigged,-1.278,1,127,1,1,0.188,0.51,0.412,128
outpouring,-1.278,1,127,1,1,0.562,0.685,0.552,128
clone,-1.278,16,1087,1,1,0.406,0.471,0.524,1103
counsellor,-1.278,2,191,1,1,0.823,0.327,0.74,193
bombed,-1.278,0,63,1,1,0.051,0.851,0.627,63
trimester,-1.278,0,63,1,1,0.783,0.336,0.538,63
legitimacy,-1.278,0,63,1,1,0.823,0.42,0.855,63
id,-1.282,106,6875,1,1,0.449,0.344,0.391,6981
supporter,-1.283,14,964,1,1,0.721,0.51,0.698,978
hug,-1.292,187,12206,1,1,0.908,0.427,0.548,12393
twit,-1.293,2,194,1,1,0.194,0.653,0.198,196
sunscreen,-1.293,1,129,1,1,0.656,0.387,0.462,130
semicolon,-1.293,0,64,1,1,0.378,0.255,0.318,64
businessman,-1.293,0,64,1,1,0.653,0.51,0.802,64
prostate,-1.293,0,64,1,1,0.323,0.51,0.438,64
salary,-1.298,6,456,1,1,0.786,0.48,0.652,462
sitter,-1.301,1,130,1,1,0.656,0.429,0.404,131
colleague,-1.301,11,785,1,1,0.74,0.413,0.6,796
mistreated,-1.306,5,394,1,1,0.01,0.792,0.2,399
assure,-1.307,24,1647,1,1,0.91,0.46,0.839,1671
yay,-1.308,66,4419,1,1,0.694,0.575,0.345,4485
documentation,-1.308,0,65,1,1,0.719,0.29,0.667,65
postal,-1.308,0,65,1,1,0.765,0.245,0.411,65
spam,-1.308,6,461,1,1,0.188,0.354,0.304,467
yayy,-1.308,1,131,1,1,0.64,0.587,0.355,132
anytime,-1.31,94,6281,1,1,0.625,0.461,0.436,6375
creepy,-1.31,52,3504,1,1,0.125,0.861,0.373,3556
hinge,-1.316,1,132,1,1,0.458,0.292,0.417,133
caller,-1.316,1,132,1,1,0.646,0.615,0.472,133
bro,-1.32,261,17483,1,1,0.794,0.349,0.684,17744
cheater,-1.324,4,334,1,1,0.104,0.92,0.333,338
suicide,-1.329,177,11990,1,1,0.03,0.873,0.429,12167
atheist,-1.335,4,338,1,1,0.225,0.447,0.377,342
supporting,-1.336,68,4679,1,1,0.634,0.49,0.764,4747
sad,-1.338,1386,94331,1,1,0.225,0.333,0.149,95717
intimidate,-1.353,1,137,1,1,0.21,0.804,0.632,138
reported,-1.355,12,898,1,1,0.418,0.442,0.567,910
fighting,-1.355,232,16113,1,1,0.292,0.885,0.783,16345
marry,-1.365,92,6496,1,1,0.896,0.765,0.673,6588
pregnancy,-1.366,22,1607,1,1,0.74,0.769,0.569,1629
constituency,-1.367,1,139,1,1,0.5,0.48,0.696,140
thermostat,-1.367,1,139,1,1,0.439,0.48,0.321,140
cabal,-1.374,1,140,1,1,0.5,0.406,0.573,141
yayyy,-1.374,1,140,1,1,0.602,0.7,0.381,141
terrorists,-1.376,4,352,1,1,0.062,0.967,0.688,356
crybaby,-1.377,2,211,1,1,0.375,0.702,0.311,213
quarter,-1.38,28,2055,1,1,0.568,0.296,0.509,2083
supervisor,-1.381,2,212,1,1,0.615,0.479,0.933,214
thigh,-1.381,1,141,1,1,0.469,0.433,0.588,142
toot,-1.381,0,70,1,1,0.5,0.481,0.373,70
tuition,-1.381,1,141,1,1,0.531,0.372,0.436,142
casket,-1.384,4,355,1,1,0.125,0.49,0.346,359
funding,-1.385,7,569,1,1,0.729,0.48,0.827,576
rapist,-1.388,8,642,1,1,0.062,0.906,0.571,650
supported,-1.392,33,2438,1,1,0.853,0.408,0.613,2471
probability,-1.395,2,215,1,1,0.673,0.365,0.651,217
buttercup,-1.395,0,71,1,1,0.562,0.482,0.422,71
grandpa,-1.395,11,863,1,1,0.806,0.296,0.466,874
loan,-1.397,8,648,1,1,0.552,0.48,0.352,656
surgery,-1.401,20,1520,1,1,0.286,0.769,0.6,1540
fee,-1.402,5,434,1,1,0.354,0.386,0.556,439
accused,-1.406,18,1381,1,1,0.13,0.67,0.42,1399
ashamed,-1.406,66,4876,1,1,0.156,0.588,0.228,4942
thankgod,-1.409,0,72,1,1,0.823,0.451,0.466,72
patriotic,-1.409,2,218,1,1,0.875,0.509,0.933,220
hesitate,-1.411,32,2411,1,1,0.459,0.548,0.232,2443
payment,-1.412,4,365,1,1,0.629,0.452,0.643,369
fascism,-1.414,2,219,1,1,0.104,0.74,0.695,221
guidelines,-1.416,1,146,1,1,0.459,0.5,0.664,147
misconduct,-1.416,1,146,1,1,0.061,0.667,0.304,147
worry,-1.418,409,30198,1,1,0.245,0.776,0.267,30607
squeaky,-1.423,0,73,1,1,0.229,0.771,0.367,73
tot,-1.423,2,221,1,1,0.602,0.431,0.311,223
impeachment,-1.423,4,369,1,1,0.163,0.735,0.694,373
ilk,-1.423,1,147,1,1,0.438,0.451,0.455,148
counseling,-1.424,9,740,1,1,0.667,0.48,0.704,749
shittest,-1.436,0,74,1,1,0.076,0.673,0.232,74
dodger,-1.436,0,74,1,1,0.427,0.454,0.49,74
insulting,-1.439,4,375,1,1,0.094,0.84,0.412,379
momma,-1.44,19,1505,1,1,0.833,0.412,0.527,1524
uneducated,-1.441,2,225,1,1,0.177,0.35,0.246,227
congress,-1.443,23,1811,1,1,0.449,0.444,0.857,1834
stuffing,-1.443,1,150,1,1,0.417,0.324,0.304,151
ford,-1.445,23,1815,1,1,0.521,0.34,0.382,1838
petrified,-1.448,13,1061,1,1,0.221,0.625,0.232,1074
mortified,-1.45,0,75,1,1,0.073,0.731,0.27,75
ocd,-1.456,11,917,1,1,0.333,0.472,0.37,928
support,-1.457,632,48449,1,1,0.811,0.472,0.737,49081
feel,-1.461,7980,613828,1,1,0.802,0.602,0.596,621808
disorder,-1.463,34,2694,1,1,0.115,0.816,0.218,2728
wont,-1.463,142,11011,1,1,0.24,0.343,0.291,11153
vote,-1.465,129,10032,1,1,0.582,0.5,0.649,10161
enlist,-1.469,1,154,1,1,0.51,0.37,0.483,155
punctuation,-1.476,0,77,1,1,0.561,0.385,0.592,77
reputation,-1.478,29,2345,1,1,0.74,0.542,0.721,2374
sufferer,-1.48,2,234,1,1,0.156,0.69,0.278,236
giggles,-1.48,2,234,1,1,0.865,0.684,0.346,236
worthless,-1.48,45,3603,1,1,0.083,0.42,0.153,3648
invalidate,-1.482,1,156,1,1,0.315,0.48,0.397,157
credibility,-1.485,3,314,1,1,0.875,0.427,0.809,317
pharmacy,-1.495,1,158,1,1,0.531,0.337,0.542,159
army,-1.497,87,7010,1,1,0.417,0.759,0.902,7097
promise,-1.499,255,20449,1,1,0.823,0.5,0.704,20704
helpless,-1.5,30,2478,1,1,0.104,0.42,0.214,2508
valentine,-1.502,83,6727,1,1,0.888,0.615,0.51,6810
reporter,-1.504,7,641,1,1,0.531,0.55,0.604,648
gunfire,-1.505,2,240,1,1,0.156,0.93,0.673,242
bipolar,-1.506,14,1205,1,1,0.208,0.685,0.426,1219
vent,-1.508,62,5075,1,1,0.479,0.519,0.529,5137
stigma,-1.508,39,3223,1,1,0.327,0.5,0.47,3262
chemo,-1.509,2,241,1,1,0.214,0.686,0.444,243
mummy,-1.51,3,322,1,1,0.4,0.588,0.415,325
superstar,-1.513,1,161,1,1,0.885,0.86,0.88,162
democratic,-1.519,12,1058,1,1,0.802,0.519,0.798,1070
tissue,-1.526,2,245,1,1,0.558,0.236,0.345,247
doggy,-1.532,1,164,1,1,0.646,0.491,0.404,165
puss,-1.561,0,84,1,1,0.306,0.582,0.236,84
acne,-1.561,3,339,1,1,0.167,0.474,0.308,342
dough,-1.567,1,170,1,1,0.588,0.229,0.391,171
arthritis,-1.567,1,170,1,1,0.11,0.518,0.345,171
reassuring,-1.571,18,1630,1,1,0.847,0.308,0.691,1648
auntie,-1.573,3,343,1,1,0.643,0.275,0.447,346
caving,-1.573,1,171,1,1,0.378,0.491,0.551,172
criticized,-1.581,2,259,1,1,0.24,0.6,0.311,261
boyfriend,-1.584,125,10950,1,1,0.781,0.604,0.547,11075
terrifies,-1.585,4,434,1,1,0.083,0.923,0.5,438
uneven,-1.589,2,261,1,1,0.125,0.457,0.24,263
depress,-1.593,3,350,1,1,0.219,0.635,0.528,353
escalate,-1.596,0,87,1,1,0.653,0.714,0.728,87
boa,-1.619,1,179,1,1,0.255,0.569,0.542,180
toby,-1.63,1,181,1,1,0.427,0.375,0.33,182
suicidal,-1.638,48,4494,1,1,0.021,0.867,0.382,4542
fundraising,-1.641,0,91,1,1,0.76,0.62,0.544,91
seizure,-1.646,1,184,1,1,0.177,0.775,0.462,185
unsupported,-1.662,1,187,1,1,0.26,0.45,0.221,188
asthma,-1.667,1,188,1,1,0.198,0.549,0.227,189
spelling,-1.669,2,283,1,1,0.594,0.357,0.398,285
baby,-1.681,403,38707,1,1,0.837,0.365,0.455,39110
congressman,-1.683,0,95,1,1,0.438,0.471,0.877,95
unsafe,-1.694,7,775,1,1,0.115,0.562,0.147,782
abortion,-1.7,11,1171,1,1,0.082,0.77,0.283,1182
vindicated,-1.714,0,98,1,1,0.615,0.48,0.609,98
drumming,-1.724,1,199,1,1,0.594,0.75,0.426,200
suffer,-1.729,454,45748,1,1,0.082,0.91,0.259,46202
mansions,-1.734,0,100,1,1,0.735,0.529,0.777,100
reeling,-1.756,6,722,1,1,0.327,0.542,0.267,728
phew,-1.758,9,1034,1,1,0.531,0.429,0.302,1043
babe,-1.763,56,5923,1,1,0.86,0.536,0.424,5979
scariest,-1.77,9,1046,1,1,0.167,0.863,0.538,1055
reassure,-1.773,7,839,1,1,0.837,0.306,0.63,846
hugs,-1.775,93,9895,1,1,0.98,0.422,0.6,9988
voicemail,-1.782,0,105,1,1,0.458,0.453,0.406,105
diagnosis,-1.787,7,851,1,1,0.571,0.5,0.819,858
adverts,-1.792,0,106,1,1,0.551,0.5,0.595,106
unsuccessful,-1.795,4,536,1,1,0.14,0.318,0.106,540
sucks,-1.799,268,28988,1,1,0.115,0.683,0.302,29256
bing,-1.801,0,107,1,1,0.573,0.453,0.415,107
dusk,-1.813,58,6446,1,1,0.532,0.276,0.519,6504
pregnant,-1.816,23,2630,1,1,0.765,0.773,0.537,2653
lefty,-1.828,0,110,1,1,0.49,0.406,0.379,110
sux,-1.837,2,335,1,1,0.406,0.531,0.331,337
confidential,-1.837,4,559,1,1,0.643,0.471,0.761,563
patriot,-1.838,8,1008,1,1,0.771,0.635,0.886,1016
democrat,-1.841,11,1348,1,1,0.582,0.4,0.755,1359
lifeline,-1.851,9,1135,1,1,0.735,0.552,0.496,1144
dying,-1.858,283,32488,1,1,0.04,0.664,0.422,32771
cockroach,-1.859,1,228,1,1,0.188,0.667,0.196,229
tuna,-1.898,0,118,1,1,0.531,0.386,0.304,118
cyst,-1.906,0,119,1,1,0.173,0.578,0.312,119
pentagon,-1.923,0,121,1,1,0.49,0.636,0.774,121
yaaay,-1.947,0,124,1,1,0.65,0.61,0.33,124
sorority,-1.955,0,125,1,1,0.635,0.637,0.627,125
sweetie,-1.974,18,2439,1,1,0.99,0.549,0.56,2457
scared,-2.035,370,50657,1,1,0.146,0.828,0.185,51027
pedophile,-2.075,1,283,1,1,0.051,0.724,0.43,284
electorate,-2.082,0,142,1,1,0.56,0.38,0.696,142
parliament,-2.128,3,598,1,1,0.573,0.54,0.858,601
assault,-2.131,21,3303,1,1,0.167,0.848,0.55,3324
underage,-2.133,1,300,1,1,0.469,0.461,0.3,301
voter,-2.149,4,764,1,1,0.612,0.538,0.754,768
nationwide,-2.162,0,154,1,1,0.684,0.217,0.672,154
sneeze,-2.164,2,465,1,1,0.271,0.442,0.336,467
glad,-2.179,556,87784,1,1,0.938,0.76,0.74,88340
unsupervised,-2.194,0,159,1,1,0.478,0.481,0.442,159
republican,-2.203,11,1937,1,1,0.398,0.551,0.664,1948
coalition,-2.213,0,162,1,1,0.49,0.73,0.673,162
die,-2.259,1075,183681,1,1,0.031,0.765,0.259,184756
helper,-2.268,7,1377,1,1,0.704,0.438,0.567,1384
referendum,-2.345,2,557,1,1,0.51,0.469,0.643,559
kidnap,-2.366,0,189,1,1,0.032,0.923,0.535,189
jeans,-2.407,8,1781,1,1,0.622,0.324,0.371,1789
prevention,-2.44,11,2455,1,1,0.76,0.463,0.6,2466
poise,-2.475,6,1482,1,1,0.677,0.202,0.708,1488
penniless,-2.53,0,223,1,1,0.062,0.316,0.083,223
miscarriage,-2.743,2,830,1,1,0.042,0.781,0.312,832
enforcement,-2.75,0,278,1,1,0.594,0.571,0.736,278
sandman,-2.757,2,842,1,1,0.479,0.469,0.388,844
infertility,-2.764,0,282,1,1,0.17,0.664,0.328,282
aftertaste,-2.948,1,679,1,1,0.354,0.362,0.455,680
deejay,-2.954,1,683,1,1,0.551,0.63,0.473,684
trench,-3.06,14,5704,1,1,0.429,0.76,0.429,5718
hotline,-3.282,4,2374,1,1,0.592,0.565,0.663,2378
promiscuous,-3.443,0,557,1,1,0.214,0.8,0.436,557
