Term,pmi,freq_pos,freq_neg,VAD original,VAD extended,valence,arousal,dominance,frequency
fortress,6.388,5249,126,1,1,0.816,0.5,0.933,5375
cholera,5.61,151,7,1,1,0.02,0.867,0.507,158
porous,5.374,59,3,1,1,0.385,0.37,0.264,62
uniformity,5.108,45,3,1,1,0.745,0.353,0.538,48
peopled,4.631,106,14,1,1,0.594,0.45,0.679,120
refreshment,4.494,55,8,1,1,0.667,0.41,0.352,63
incline,4.206,83,17,1,1,0.49,0.423,0.345,100
monastic,4.192,45,9,1,1,0.438,0.314,0.676,54
superman,3.991,913,242,1,1,0.945,0.794,0.929,1155
hundred,3.915,3844,1102,1,1,0.604,0.37,0.406,4946
contemplation,3.871,306,91,1,1,0.552,0.324,0.627,397
confederacy,3.855,22,6,1,1,0.59,0.541,0.736,28
purification,3.838,41,12,1,1,0.847,0.452,0.774,53
uninterrupted,3.818,132,41,1,1,0.5,0.434,0.527,173
recharge,3.755,888,298,1,1,0.584,0.702,0.664,1186
slowness,3.727,25,8,1,1,0.302,0.212,0.191,33
revue,3.663,83,30,1,1,0.594,0.35,0.42,113
vega,3.614,110,42,1,1,0.51,0.333,0.434,152
simplify,3.575,66,26,1,1,0.565,0.347,0.602,92
industrious,3.56,21,8,1,1,0.72,0.537,0.791,29
intrusion,3.556,55,22,1,1,0.293,0.641,0.67,77
realism,3.543,201,83,1,1,0.74,0.545,0.67,284
tranquility,3.506,423,182,1,1,0.84,0.135,0.442,605
bliss,3.47,1935,865,1,1,0.816,0.5,0.782,2800
trample,3.435,40,18,1,1,0.235,0.764,0.562,58
exaltation,3.4,24,11,1,1,0.594,0.892,0.673,35
lifeblood,3.359,19,9,1,1,0.673,0.69,0.708,28
colonel,3.332,110,56,1,1,0.459,0.592,0.89,166
serenity,3.319,585,304,1,1,0.9,0.122,0.557,889
undisturbed,3.316,45,23,1,1,0.725,0.287,0.434,68
savagery,3.312,41,21,1,1,0.219,0.907,0.711,62
regroup,3.27,74,40,1,1,0.633,0.602,0.797,114
rejuvenate,3.225,41,23,1,1,0.776,0.588,0.767,64
meditation,3.219,865,497,1,1,0.786,0.12,0.478,1362
dissatisfaction,3.215,186,107,1,1,0.115,0.663,0.202,293
monastery,3.2,57,33,1,1,0.694,0.183,0.726,90
furnace,3.194,38,22,1,1,0.429,0.529,0.5,60
monotony,3.19,178,105,1,1,0.398,0.135,0.353,283
blend,3.177,396,237,1,1,0.469,0.452,0.463,633
sphinx,3.177,19,11,1,1,0.604,0.324,0.49,30
blissful,3.147,368,227,1,1,0.885,0.639,0.676,595
seclusion,3.139,283,176,1,1,0.23,0.558,0.505,459
oft,3.131,155,97,1,1,0.5,0.308,0.474,252
apostle,3.127,45,28,1,1,0.646,0.347,0.732,73
retreat,3.118,604,384,1,1,0.5,0.519,0.312,988
pensive,3.114,165,105,1,1,0.54,0.22,0.529,270
immemorial,3.101,16,10,1,1,0.327,0.469,0.454,26
restorative,3.097,39,25,1,1,0.633,0.51,0.703,64
sweetness,3.096,311,202,1,1,0.906,0.474,0.528,513
replenish,3.093,22,14,1,1,0.615,0.336,0.689,36
mirth,3.089,28,18,1,1,0.888,0.64,0.608,46
shire,3.081,149,98,1,1,0.479,0.257,0.609,247
interruption,3.071,38,25,1,1,0.184,0.632,0.425,63
penance,3.06,45,30,1,1,0.219,0.667,0.463,75
decompress,3.05,46,31,1,1,0.438,0.43,0.509,77
lofty,3.047,103,70,1,1,0.755,0.306,0.569,173
indivisible,3.045,18,12,1,1,0.646,0.398,0.58,30
bustle,3.035,106,73,1,1,0.347,0.814,0.445,179
refining,3.011,23,16,1,1,0.694,0.466,0.664,39
simplicity,2.966,180,133,1,1,0.667,0.25,0.337,313
skiing,2.966,53,39,1,1,0.823,0.824,0.62,92
latitude,2.953,15,11,1,1,0.562,0.306,0.49,26
altitude,2.953,39,29,1,1,0.708,0.482,0.736,68
introspection,2.951,265,199,1,1,0.603,0.337,0.575,464
durable,2.938,20,15,1,1,0.74,0.294,0.688,35
savor,2.931,89,68,1,1,0.827,0.552,0.526,157
meditating,2.93,98,75,1,1,0.718,0.185,0.399,173
repose,2.924,43,33,1,1,0.469,0.1,0.33,76
cultivation,2.917,17,13,1,1,0.625,0.324,0.462,30
sanctity,2.889,24,19,1,1,0.771,0.33,0.628,43
purify,2.877,20,16,1,1,0.823,0.304,0.746,36
contemplative,2.853,81,67,1,1,0.729,0.308,0.739,148
aluminum,2.848,17,14,1,1,0.449,0.28,0.434,31
gentleness,2.838,56,47,1,1,0.927,0.278,0.447,103
relaxation,2.837,158,133,1,1,0.873,0.161,0.381,291
stillness,2.809,583,505,1,1,0.729,0.125,0.339,1088
multitude,2.802,140,122,1,1,0.562,0.765,0.847,262
scenic,2.797,56,49,1,1,0.684,0.548,0.756,105
tranquil,2.792,117,103,1,1,0.917,0.094,0.355,220
chagrin,2.791,16,14,1,1,0.104,0.704,0.472,30
intrude,2.775,57,51,1,1,0.058,0.735,0.48,108
richness,2.761,251,228,1,1,0.896,0.833,0.922,479
meditate,2.761,284,258,1,1,0.812,0.146,0.564,542
mediation,2.761,32,29,1,1,0.661,0.35,0.657,61
perilous,2.75,36,33,1,1,0.143,0.862,0.575,69
recollect,2.749,24,22,1,1,0.688,0.491,0.602,46
frightful,2.748,37,34,1,1,0.125,0.755,0.455,71
fortitude,2.748,88,81,1,1,0.823,0.608,0.897,169
merriment,2.743,26,24,1,1,0.948,0.721,0.632,50
silky,2.736,43,40,1,1,0.802,0.397,0.271,83
laureate,2.735,14,13,1,1,0.724,0.402,0.702,27
heady,2.725,34,32,1,1,0.448,0.806,0.565,66
regenerate,2.72,18,17,1,1,0.782,0.607,0.767,35
finality,2.705,25,24,1,1,0.615,0.368,0.627,49
meditative,2.686,48,47,1,1,0.614,0.12,0.454,95
clarity,2.676,399,395,1,1,0.796,0.31,0.631,794
regeneration,2.666,15,15,1,1,0.76,0.64,0.845,30
deluge,2.666,16,16,1,1,0.245,0.714,0.612,32
ascetic,2.666,17,17,1,1,0.438,0.375,0.472,34
commandment,2.666,13,13,1,1,0.656,0.49,0.876,26
innermost,2.666,42,42,1,1,0.583,0.5,0.51,84
magnificence,2.666,14,14,1,1,0.802,0.81,0.92,28
servitude,2.634,30,31,1,1,0.25,0.49,0.25,61
labyrinth,2.633,88,91,1,1,0.479,0.811,0.491,179
mull,2.627,24,25,1,1,0.663,0.34,0.594,49
equilibrium,2.619,20,21,1,1,0.676,0.235,0.62,41
restful,2.617,39,41,1,1,0.781,0.116,0.413,80
privacy,2.613,608,641,1,1,0.52,0.42,0.598,1249
chronicle,2.61,34,36,1,1,0.427,0.571,0.586,70
pleasures,2.607,197,209,1,1,0.896,0.654,0.705,406
hike,2.596,207,222,1,1,0.615,0.442,0.538,429
renewal,2.592,38,41,1,1,0.77,0.71,0.672,79
invention,2.589,87,94,1,1,0.714,0.577,0.811,181
withdraw,2.586,155,168,1,1,0.26,0.425,0.336,323
mockingbird,2.584,46,50,1,1,0.513,0.337,0.423,96
fasting,2.58,133,145,1,1,0.388,0.37,0.394,278
serene,2.578,184,201,1,1,0.802,0.132,0.37,385
sacred,2.573,402,441,1,1,0.833,0.375,0.862,843
meridian,2.56,17,19,1,1,0.51,0.324,0.558,36
gregarious,2.56,35,39,1,1,0.551,0.471,0.529,74
remoteness,2.56,17,19,1,1,0.323,0.51,0.339,36
perverse,2.56,35,39,1,1,0.146,0.808,0.464,74
disappoint,2.555,392,438,1,1,0.15,0.633,0.288,830
lightness,2.555,33,37,1,1,0.794,0.36,0.526,70
clutter,2.542,37,42,1,1,0.135,0.598,0.4,79
solace,2.528,873,1002,1,1,0.776,0.294,0.453,1875
canyon,2.525,118,136,1,1,0.468,0.731,0.634,254
hiking,2.523,181,209,1,1,0.82,0.843,0.67,390
commune,2.517,55,64,1,1,0.5,0.488,0.655,119
hammering,2.512,23,27,1,1,0.347,0.779,0.557,50
illicit,2.507,28,33,1,1,0.188,0.794,0.39,61
component,2.504,73,86,1,1,0.531,0.382,0.525,159
transcendence,2.503,16,19,1,1,0.656,0.608,0.754,35
soak,2.5,177,209,1,1,0.48,0.37,0.24,386
slaughterhouse,2.494,15,18,1,1,0.146,0.794,0.472,33
refine,2.494,15,18,1,1,0.653,0.46,0.64,33
jour,2.491,20,24,1,1,0.479,0.394,0.415,44
karmic,2.491,20,24,1,1,0.357,0.459,0.464,44
crystalline,2.483,14,17,1,1,0.765,0.235,0.534,31
muddle,2.483,14,17,1,1,0.184,0.71,0.336,31
openness,2.481,83,100,1,1,0.837,0.561,0.667,183
pas,2.48,185,223,1,1,0.49,0.344,0.262,408
hammock,2.473,32,39,1,1,0.673,0.255,0.287,71
bask,2.472,158,192,1,1,0.76,0.33,0.381,350
advisable,2.458,12,15,1,1,0.867,0.48,0.51,27
ski,2.443,99,124,1,1,0.684,0.67,0.471,223
metropolis,2.443,31,39,1,1,0.656,0.625,0.779,70
communion,2.443,95,119,1,1,0.765,0.357,0.607,214
benign,2.437,34,43,1,1,0.694,0.44,0.509,77
campsite,2.432,18,23,1,1,0.68,0.49,0.547,41
sanction,2.429,14,18,1,1,0.201,0.75,0.517,32
relish,2.429,100,127,1,1,0.854,0.61,0.632,227
revel,2.428,92,117,1,1,0.74,0.705,0.684,209
grounding,2.425,32,41,1,1,0.521,0.452,0.591,73
compose,2.407,60,78,1,1,0.639,0.432,0.694,138
indispensable,2.403,19,25,1,1,0.71,0.449,0.802,44
divinity,2.399,48,63,1,1,0.896,0.559,0.774,111
overlord,2.398,25,33,1,1,0.75,0.755,0.932,58
hideaway,2.391,18,24,1,1,0.448,0.481,0.36,42
morrow,2.387,27,36,1,1,0.708,0.314,0.49,63
overshadow,2.384,42,56,1,1,0.333,0.549,0.654,98
insurmountable,2.384,45,60,1,1,0.62,0.627,0.737,105
disengage,2.378,17,23,1,1,0.406,0.529,0.304,40
picturesque,2.378,32,43,1,1,0.802,0.491,0.483,75
acquire,2.37,95,128,1,1,0.833,0.468,0.7,223
silence,2.37,5972,8026,1,1,0.438,0.2,0.223,13998
visualize,2.369,25,34,1,1,0.635,0.431,0.537,59
peace,2.365,8908,12038,1,1,0.939,0.156,0.613,20946
grid,2.361,86,117,1,1,0.562,0.426,0.443,203
trespass,2.36,13,18,1,1,0.229,0.67,0.613,31
calmness,2.357,126,172,1,1,0.934,0.105,0.394,298
leisure,2.348,98,135,1,1,0.631,0.429,0.421,233
unplug,2.337,35,49,1,1,0.239,0.441,0.404,84
mountains,2.327,712,999,1,1,0.766,0.433,0.569,1711
attain,2.327,76,107,1,1,0.806,0.51,0.719,183
immerse,2.324,53,75,1,1,0.51,0.577,0.509,128
spiritual,2.322,936,1320,1,1,0.938,0.327,0.564,2256
rejuvenated,2.317,11,16,1,1,0.809,0.673,0.7,27
blacksmith,2.317,11,16,1,1,0.48,0.531,0.702,27
addictive,2.314,450,640,1,1,0.302,0.683,0.472,1090
luxurious,2.314,63,90,1,1,0.947,0.644,0.754,153
tout,2.311,46,66,1,1,0.48,0.538,0.375,112
creativity,2.31,471,673,1,1,0.938,0.684,0.815,1144
brainy,2.309,13,19,1,1,0.708,0.52,0.648,32
favorable,2.305,22,32,1,1,0.952,0.38,0.788,54
sabbatical,2.298,17,25,1,1,0.771,0.24,0.427,42
fruitful,2.295,77,112,1,1,0.73,0.618,0.637,189
undertake,2.291,21,31,1,1,0.796,0.702,0.754,52
refuel,2.291,10,15,1,1,0.592,0.445,0.5,25
convent,2.291,10,15,1,1,0.48,0.217,0.594,25
vacant,2.287,164,240,1,1,0.578,0.22,0.464,404
tame,2.286,142,208,1,1,0.56,0.604,0.642,350
periodic,2.283,14,21,1,1,0.677,0.324,0.508,35
squander,2.283,14,21,1,1,0.24,0.755,0.529,35
monk,2.281,146,215,1,1,0.472,0.208,0.439,361
spontaneity,2.28,16,24,1,1,0.817,0.698,0.655,40
descent,2.277,98,145,1,1,0.3,0.402,0.158,243
opt,2.276,62,92,1,1,0.51,0.471,0.345,154
preserve,2.276,83,123,1,1,0.837,0.431,0.755,206
immersion,2.275,22,33,1,1,0.51,0.556,0.564,55
abstinence,2.271,30,45,1,1,0.26,0.392,0.429,75
kryptonite,2.27,34,51,1,1,0.306,0.69,0.588,85
secrecy,2.27,34,51,1,1,0.294,0.549,0.475,85
stout,2.26,23,35,1,1,0.656,0.657,0.817,58
agreeable,2.26,13,20,1,1,0.906,0.5,0.696,33
mutation,2.26,11,17,1,1,0.365,0.625,0.611,28
ingenious,2.26,13,20,1,1,0.76,0.69,0.891,33
oils,2.26,29,44,1,1,0.459,0.229,0.391,73
firing,2.26,87,131,1,1,0.188,0.931,0.803,218
laboratory,2.26,15,23,1,1,0.571,0.49,0.537,38
nourishment,2.249,28,43,1,1,0.786,0.29,0.631,71
bourgeois,2.246,22,34,1,1,0.439,0.593,0.682,56
maturity,2.241,190,291,1,1,0.827,0.4,0.806,481
reflective,2.236,79,122,1,1,0.656,0.292,0.735,201
eloquence,2.235,12,19,1,1,0.729,0.49,0.804,31
mindfulness,2.233,71,110,1,1,0.729,0.635,0.745,181
outdoors,2.23,131,203,1,1,0.781,0.444,0.453,334
ascendant,2.23,10,16,1,1,0.656,0.673,0.821,26
originality,2.229,30,47,1,1,0.898,0.5,0.824,77
worldly,2.223,78,122,1,1,0.438,0.612,0.295,200
sanctuary,2.222,318,496,1,1,0.863,0.226,0.575,814
quiver,2.221,24,38,1,1,0.32,0.452,0.335,62
cabin,2.219,299,468,1,1,0.643,0.292,0.43,767
require,2.219,405,634,1,1,0.398,0.439,0.56,1039
effectiveness,2.218,22,35,1,1,0.64,0.654,0.812,57
metamorphosis,2.214,20,32,1,1,0.541,0.571,0.613,52
conduit,2.214,13,21,1,1,0.47,0.302,0.413,34
awaken,2.212,107,169,1,1,0.729,0.412,0.611,276
interrupted,2.209,113,179,1,1,0.281,0.559,0.333,292
enjoying,2.208,2769,4378,1,1,0.908,0.759,0.759,7147
considerable,2.203,33,53,1,1,0.653,0.314,0.683,86
cleansing,2.201,48,77,1,1,0.729,0.298,0.472,125
involuntary,2.198,51,82,1,1,0.354,0.49,0.231,133
destitute,2.197,91,146,1,1,0.13,0.451,0.222,237
buddhist,2.196,29,47,1,1,0.57,0.182,0.481,76
imperial,2.196,44,71,1,1,0.669,0.646,0.922,115
interior,2.19,86,139,1,1,0.618,0.157,0.462,225
magnitude,2.186,51,83,1,1,0.608,0.613,0.774,134
wildlife,2.184,112,182,1,1,0.656,0.53,0.561,294
transcendent,2.18,15,25,1,1,0.667,0.6,0.824,40
buddhism,2.176,18,30,1,1,0.51,0.115,0.673,48
shuddering,2.173,10,17,1,1,0.302,0.802,0.638,27
diversion,2.173,32,53,1,1,0.74,0.821,0.714,85
citadel,2.169,13,22,1,1,0.585,0.464,0.602,35
independence,2.169,705,1159,1,1,0.896,0.663,0.911,1864
namaste,2.165,19,32,1,1,0.719,0.255,0.464,51
conducive,2.165,19,32,1,1,0.775,0.479,0.679,51
cascade,2.165,19,32,1,1,0.735,0.509,0.395,51
glacier,2.165,19,32,1,1,0.573,0.396,0.554,51
intuition,2.16,81,135,1,1,0.857,0.508,0.602,216
confinement,2.157,174,290,1,1,0.333,0.656,0.52,464
patriarch,2.155,14,24,1,1,0.592,0.448,0.898,38
mastery,2.15,36,61,1,1,0.755,0.648,0.873,97
splendid,2.149,67,113,1,1,0.896,0.74,0.81,180
pristine,2.149,30,51,1,1,0.65,0.363,0.625,81
conditional,2.146,21,36,1,1,0.521,0.343,0.556,57
hermit,2.145,451,760,1,1,0.271,0.337,0.351,1211
focal,2.14,12,21,1,1,0.367,0.365,0.482,33
confine,2.14,25,43,1,1,0.327,0.551,0.538,68
rout,2.135,9,16,1,1,0.163,0.625,0.233,25
sameness,2.135,9,16,1,1,0.531,0.33,0.484,25
ponder,2.128,124,213,1,1,0.74,0.38,0.689,337
adaptation,2.127,97,167,1,1,0.663,0.365,0.609,264
opus,2.127,13,23,1,1,0.458,0.368,0.391,36
midst,2.127,612,1050,1,1,0.324,0.275,0.296,1662
intuitive,2.124,31,54,1,1,0.771,0.573,0.69,85
simile,2.122,17,30,1,1,0.615,0.363,0.464,47
disrupt,2.122,64,111,1,1,0.265,0.64,0.349,175
seminal,2.119,10,18,1,1,0.459,0.413,0.566,28
coastline,2.119,10,18,1,1,0.745,0.282,0.441,28
radiant,2.118,58,101,1,1,0.888,0.717,0.791,159
untamed,2.116,14,25,1,1,0.429,0.778,0.709,39
measured,2.113,83,145,1,1,0.542,0.265,0.578,228
brood,2.111,26,46,1,1,0.633,0.519,0.434,72
discipline,2.11,201,351,1,1,0.615,0.471,0.806,552
spinach,2.106,23,41,1,1,0.583,0.2,0.368,64
finite,2.106,23,41,1,1,0.384,0.347,0.293,64
snowfall,2.106,15,27,1,1,0.675,0.28,0.455,42
inwards,2.099,20,36,1,1,0.49,0.385,0.438,56
shoreline,2.098,16,29,1,1,0.677,0.296,0.529,45
renounce,2.095,12,22,1,1,0.156,0.49,0.552,34
strenuous,2.095,12,22,1,1,0.104,0.66,0.481,34
delightful,2.093,131,233,1,1,0.918,0.735,0.644,364
archaic,2.093,21,38,1,1,0.271,0.327,0.332,59
woodland,2.092,30,54,1,1,0.776,0.306,0.48,84
obedience,2.09,35,63,1,1,0.765,0.287,0.536,98
bustling,2.089,49,88,1,1,0.49,0.85,0.528,137
delighted,2.086,255,456,1,1,0.938,0.664,0.685,711
baptism,2.086,13,24,1,1,0.844,0.384,0.566,37
moderation,2.085,32,58,1,1,0.531,0.24,0.453,90
ambience,2.084,37,67,1,1,0.735,0.356,0.426,104
motionless,2.082,28,51,1,1,0.323,0.21,0.246,79
cultivate,2.08,107,193,1,1,0.708,0.41,0.598,300
refreshed,2.08,53,96,1,1,0.91,0.377,0.48,149
provincial,2.078,14,26,1,1,0.645,0.341,0.481,40
silvery,2.078,9,17,1,1,0.543,0.46,0.517,26
nobility,2.078,9,17,1,1,0.844,0.347,0.736,26
rye,2.073,46,84,1,1,0.49,0.298,0.411,130
reflect,2.066,676,1232,1,1,0.698,0.342,0.472,1908
acres,2.066,55,101,1,1,0.51,0.363,0.5,156
reservoir,2.065,16,30,1,1,0.531,0.276,0.462,46
analytical,2.065,16,30,1,1,0.625,0.324,0.8,46
endurance,2.062,40,74,1,1,0.592,0.745,0.76,114
canoe,2.056,24,45,1,1,0.542,0.3,0.418,69
priestess,2.055,18,34,1,1,0.531,0.39,0.691,52
disrupting,2.055,18,34,1,1,0.186,0.557,0.339,52
duration,2.054,50,93,1,1,0.656,0.37,0.536,143
timber,2.053,12,23,1,1,0.332,0.202,0.386,35
quaint,2.05,26,49,1,1,0.625,0.463,0.474,75
decisive,2.047,13,25,1,1,0.74,0.509,0.935,38
circular,2.047,27,51,1,1,0.562,0.342,0.417,78
needful,2.047,13,25,1,1,0.582,0.46,0.614,38
civilization,2.037,128,241,1,1,0.823,0.452,0.839,369
necessity,2.035,172,324,1,1,0.567,0.471,0.588,496
enigmatic,2.03,17,33,1,1,0.469,0.589,0.679,50
devotional,2.03,17,33,1,1,0.74,0.394,0.655,50
intentional,2.029,99,188,1,1,0.65,0.615,0.75,287
alchemy,2.024,19,37,1,1,0.541,0.583,0.693,56
respite,2.02,74,142,1,1,0.6,0.373,0.42,216
nakedness,2.019,10,20,1,1,0.48,0.76,0.35,30
abstraction,2.019,10,20,1,1,0.469,0.439,0.525,30
commemorate,2.019,10,20,1,1,0.812,0.602,0.636,30
interrupt,2.019,99,190,1,1,0.21,0.635,0.509,289
recollection,2.015,23,45,1,1,0.722,0.337,0.566,68
cathedral,2.014,48,93,1,1,0.598,0.33,0.643,141
balance,2.01,665,1282,1,1,0.684,0.265,0.735,1947
contemplate,2.01,150,290,1,1,0.74,0.347,0.642,440
unwind,2.01,68,132,1,1,0.837,0.181,0.394,200
faculties,2.009,13,26,1,1,0.643,0.431,0.76,39
illumination,2.004,15,30,1,1,0.76,0.588,0.537,45
cacophony,2.004,15,30,1,1,0.408,0.562,0.44,45
fertile,2.004,31,61,1,1,0.888,0.408,0.704,92
tonic,2.002,34,67,1,1,0.541,0.36,0.5,101
instructed,2.001,17,34,1,1,0.74,0.388,0.722,51
oneness,2.001,53,104,1,1,0.745,0.272,0.72,157
sapiens,2.001,17,34,1,1,0.48,0.453,0.584,51
practiced,2,55,108,1,1,0.612,0.605,0.58,163
meandering,1.999,18,36,1,1,0.427,0.644,0.539,54
toil,1.993,24,48,1,1,0.558,0.51,0.583,72
affinity,1.99,28,56,1,1,0.8,0.5,0.537,84
enjoy,1.99,9727,19121,1,1,0.959,0.725,0.75,28848
thrive,1.989,337,664,1,1,0.948,0.529,0.772,1001
entangled,1.986,36,72,1,1,0.319,0.578,0.357,108
cleanse,1.981,58,116,1,1,0.625,0.31,0.66,174
getaway,1.98,64,128,1,1,0.5,0.76,0.368,192
nature,1.979,2056,4087,1,1,0.857,0.184,0.643,6143
indulge,1.976,141,282,1,1,0.833,0.716,0.669,423
amazement,1.973,10,21,1,1,0.75,0.8,0.639,31
stanza,1.973,11,23,1,1,0.612,0.343,0.297,34
flee,1.973,92,185,1,1,0.292,0.796,0.232,277
verdant,1.973,8,17,1,1,0.6,0.26,0.389,25
medicinal,1.973,8,17,1,1,0.667,0.417,0.614,25
sanctum,1.973,21,43,1,1,0.521,0.438,0.657,64
twelfth,1.973,10,21,1,1,0.521,0.292,0.527,31
reserves,1.973,13,27,1,1,0.653,0.363,0.52,40
diligence,1.973,13,27,1,1,0.688,0.423,0.7,40
satin,1.973,27,55,1,1,0.519,0.396,0.481,82
woodlands,1.973,9,19,1,1,0.656,0.34,0.473,28
piety,1.973,9,19,1,1,0.76,0.34,0.482,28
scenery,1.97,166,334,1,1,0.745,0.253,0.592,500
reflection,1.958,825,1676,1,1,0.71,0.5,0.528,2501
dune,1.955,27,56,1,1,0.459,0.173,0.414,83
enlightenment,1.955,83,170,1,1,0.837,0.549,0.619,253
penetrate,1.955,27,56,1,1,0.287,0.877,0.732,83
seductive,1.954,51,105,1,1,0.771,0.821,0.667,156
fruits,1.953,100,205,1,1,0.865,0.357,0.259,305
aversion,1.953,24,50,1,1,0.074,0.663,0.525,74
trout,1.951,22,46,1,1,0.516,0.387,0.298,68
temperament,1.949,20,42,1,1,0.42,0.625,0.703,62
reverence,1.947,18,38,1,1,0.643,0.347,0.516,56
tumult,1.945,17,36,1,1,0.271,0.64,0.636,53
preserving,1.945,17,36,1,1,0.765,0.462,0.63,53
essential,1.943,327,675,1,1,0.812,0.405,0.759,1002
deliberate,1.942,47,98,1,1,0.551,0.654,0.682,145
fullness,1.94,44,92,1,1,0.868,0.402,0.811,136
spirituality,1.939,101,210,1,1,0.865,0.281,0.667,311
recesses,1.938,13,28,1,1,0.367,0.47,0.379,41
zen,1.937,81,169,1,1,0.492,0.21,0.432,250
ephemeral,1.936,26,55,1,1,0.5,0.312,0.377,81
delicious,1.936,281,584,1,1,0.927,0.65,0.589,865
interrupting,1.936,39,82,1,1,0.146,0.593,0.509,121
rhythmic,1.935,12,26,1,1,0.714,0.642,0.664,38
massacre,1.934,37,78,1,1,0.031,0.887,0.64,115
creative,1.933,848,1766,1,1,0.917,0.518,0.788,2614
relinquish,1.932,11,24,1,1,0.265,0.606,0.286,35
elevation,1.93,45,95,1,1,0.76,0.759,0.711,140
rustle,1.928,10,22,1,1,0.333,0.538,0.394,32
pope,1.925,71,150,1,1,0.6,0.375,0.636,221
incense,1.924,19,41,1,1,0.698,0.275,0.328,60
elixir,1.924,9,20,1,1,0.708,0.587,0.604,29
soaking,1.923,68,144,1,1,0.438,0.324,0.375,212
submerge,1.919,8,18,1,1,0.517,0.643,0.456,26
inconceivable,1.919,8,18,1,1,0.198,0.552,0.561,26
paddle,1.915,16,35,1,1,0.561,0.375,0.393,51
terrain,1.914,32,69,1,1,0.54,0.3,0.472,101
glove,1.913,105,224,1,1,0.5,0.23,0.382,329
revelations,1.912,23,50,1,1,0.729,0.655,0.6,73
gratitude,1.912,286,609,1,1,0.885,0.441,0.61,895
utmost,1.909,45,97,1,1,0.719,0.74,0.858,142
enchanted,1.909,67,144,1,1,0.917,0.633,0.687,211
emblem,1.908,29,63,1,1,0.64,0.33,0.754,92
prayer,1.907,879,1879,1,1,0.745,0.217,0.604,2758
chaos,1.904,444,952,1,1,0.016,0.923,0.373,1396
alignment,1.902,33,72,1,1,0.643,0.412,0.683,105
imperative,1.9,39,85,1,1,0.625,0.647,0.708,124
alpine,1.899,12,27,1,1,0.594,0.337,0.474,39
delude,1.897,56,122,1,1,0.143,0.627,0.353,178
breathtaking,1.894,72,157,1,1,0.936,0.792,0.921,229
individuality,1.894,78,170,1,1,0.612,0.469,0.527,248
noise,1.893,929,2013,1,1,0.26,0.883,0.388,2942
concentration,1.893,77,168,1,1,0.735,0.5,0.722,245
zeal,1.893,11,25,1,1,0.367,0.741,0.616,36
esoteric,1.893,11,25,1,1,0.5,0.676,0.545,36
ruckus,1.893,11,25,1,1,0.271,0.706,0.411,36
scarcely,1.886,10,23,1,1,0.082,0.412,0.16,33
penetrating,1.882,20,45,1,1,0.469,0.792,0.782,65
inner,1.881,1140,2500,1,1,0.551,0.216,0.443,3640
countryside,1.878,80,177,1,1,0.732,0.288,0.327,257
ineffable,1.877,9,21,1,1,0.551,0.577,0.585,30
dormant,1.877,24,54,1,1,0.385,0.245,0.245,78
bestow,1.877,14,32,1,1,0.656,0.56,0.642,46
elegance,1.877,19,43,1,1,0.918,0.396,0.824,62
chatter,1.876,63,140,1,1,0.56,0.45,0.347,203
noun,1.875,38,85,1,1,0.531,0.23,0.477,123
oneself,1.875,374,826,1,1,0.66,0.337,0.483,1200
lair,1.874,28,63,1,1,0.469,0.438,0.392,91
loch,1.873,18,41,1,1,0.449,0.235,0.425,59
prologue,1.871,13,30,1,1,0.571,0.392,0.546,43
conception,1.869,22,50,1,1,0.694,0.49,0.614,72
restoration,1.869,22,50,1,1,0.755,0.426,0.734,72
leisurely,1.867,17,39,1,1,0.806,0.25,0.367,56
vigor,1.867,8,19,1,1,0.86,0.755,0.811,27
heroism,1.867,17,39,1,1,0.844,0.802,0.898,56
initiation,1.863,12,28,1,1,0.698,0.529,0.527,40
distaste,1.863,12,28,1,1,0.184,0.625,0.37,40
culinary,1.863,12,28,1,1,0.654,0.443,0.519,40
oracle,1.861,16,37,1,1,0.552,0.531,0.67,53
continual,1.861,16,37,1,1,0.5,0.423,0.685,53
turmoil,1.861,92,207,1,1,0.198,0.888,0.417,299
emerge,1.859,53,120,1,1,0.602,0.594,0.731,173
unaffected,1.855,11,26,1,1,0.542,0.265,0.571,37
bastion,1.855,19,44,1,1,0.531,0.5,0.596,63
quiet,1.849,4360,9865,1,1,0.792,0.105,0.431,14225
hibernation,1.847,29,67,1,1,0.469,0.245,0.384,96
swami,1.847,14,33,1,1,0.51,0.547,0.491,47
sensory,1.847,44,101,1,1,0.583,0.48,0.442,145
sensuality,1.845,10,24,1,1,0.844,0.84,0.632,34
mandatory,1.844,50,115,1,1,0.271,0.667,0.777,165
catcher,1.837,37,86,1,1,0.653,0.413,0.54,123
detachment,1.836,81,187,1,1,0.243,0.7,0.443,268
prerequisite,1.835,16,38,1,1,0.448,0.424,0.482,54
priceless,1.833,126,291,1,1,0.745,0.696,0.779,417
courtyard,1.833,19,45,1,1,0.503,0.365,0.355,64
paucity,1.833,9,22,1,1,0.153,0.453,0.175,31
bazaar,1.833,9,22,1,1,0.604,0.34,0.5,31
marvellous,1.828,28,66,1,1,0.878,0.809,0.849,94
wondrous,1.828,28,66,1,1,0.854,0.679,0.818,94
engrossed,1.827,15,36,1,1,0.541,0.471,0.304,51
drain,1.827,193,448,1,1,0.277,0.47,0.222,641
cocoon,1.824,49,115,1,1,0.47,0.28,0.29,164
absorb,1.821,57,134,1,1,0.469,0.558,0.67,191
formed,1.821,173,404,1,1,0.656,0.272,0.696,577
idyllic,1.818,11,27,1,1,0.571,0.394,0.593,38
execute,1.818,26,62,1,1,0.327,0.708,0.769,88
urinal,1.818,8,20,1,1,0.214,0.51,0.306,28
steamboat,1.818,8,20,1,1,0.708,0.5,0.633,28
harmonious,1.818,14,34,1,1,0.938,0.391,0.719,48
coy,1.818,8,20,1,1,0.347,0.33,0.213,28
ardent,1.818,8,20,1,1,0.694,0.873,0.722,28
aerial,1.818,8,20,1,1,0.615,0.461,0.463,28
wilderness,1.817,387,906,1,1,0.281,0.333,0.29,1293
refined,1.812,22,53,1,1,0.85,0.43,0.653,75
literary,1.811,93,220,1,1,0.719,0.324,0.667,313
luxury,1.809,204,482,1,1,0.932,0.673,0.75,686
unafraid,1.808,13,32,1,1,0.5,0.52,0.655,45
sufficiency,1.808,13,32,1,1,0.594,0.438,0.576,45
withstand,1.807,71,169,1,1,0.37,0.548,0.571,240
camping,1.806,120,285,1,1,0.653,0.529,0.48,405
submerged,1.806,21,51,1,1,0.337,0.528,0.357,72
commotion,1.806,10,25,1,1,0.49,0.7,0.646,35
refill,1.805,40,96,1,1,0.67,0.4,0.464,136
productivity,1.804,97,231,1,1,0.958,0.691,0.857,328
buddha,1.803,53,127,1,1,0.69,0.198,0.604,180
perimeter,1.801,7,18,1,1,0.47,0.443,0.555,25
undue,1.801,7,18,1,1,0.156,0.573,0.318,25
interrupts,1.801,15,37,1,1,0.204,0.545,0.389,52
fertility,1.801,23,56,1,1,0.885,0.529,0.726,79
paradoxical,1.798,20,49,1,1,0.406,0.547,0.433,69
ritual,1.797,77,185,1,1,0.375,0.52,0.508,262
manuscript,1.797,25,61,1,1,0.51,0.208,0.54,86
sonnet,1.797,12,30,1,1,0.718,0.294,0.404,42
murmur,1.797,12,30,1,1,0.458,0.52,0.2,42
sublime,1.796,56,135,1,1,0.784,0.333,0.585,191
biography,1.795,35,85,1,1,0.698,0.229,0.718,120
catalyst,1.794,40,97,1,1,0.604,0.509,0.585,137
presence,1.794,1809,4327,1,1,0.874,0.431,0.607,6136
contentment,1.793,149,358,1,1,0.875,0.61,0.782,507
insulated,1.79,9,23,1,1,0.208,0.265,0.304,32
smoothly,1.79,24,59,1,1,0.821,0.134,0.488,83
unmatched,1.79,49,119,1,1,0.776,0.536,0.771,168
rippling,1.79,9,23,1,1,0.5,0.48,0.327,32
soil,1.786,111,269,1,1,0.35,0.18,0.356,380
pretense,1.785,16,40,1,1,0.323,0.6,0.54,56
cherishing,1.785,16,40,1,1,0.836,0.38,0.625,56
glory,1.784,536,1296,1,1,0.948,0.735,0.817,1832
pilgrimage,1.782,30,74,1,1,0.708,0.522,0.625,104
defect,1.778,13,33,1,1,0.135,0.561,0.185,46
cadence,1.778,13,33,1,1,0.427,0.473,0.355,46
abhor,1.778,13,33,1,1,0.125,0.602,0.349,46
tribulation,1.778,13,33,1,1,0.448,0.612,0.484,46
delight,1.777,191,466,1,1,0.949,0.666,0.647,657
nectar,1.775,15,38,1,1,0.746,0.331,0.398,53
elusive,1.772,35,87,1,1,0.229,0.615,0.466,122
excursion,1.772,8,21,1,1,0.625,0.714,0.627,29
figurative,1.772,8,21,1,1,0.479,0.45,0.634,29
botanical,1.772,8,21,1,1,0.66,0.259,0.491,29
beaches,1.77,88,217,1,1,0.865,0.5,0.538,305
henceforth,1.768,10,26,1,1,0.527,0.404,0.466,36
devotion,1.765,90,223,1,1,0.802,0.561,0.673,313
herbal,1.765,12,31,1,1,0.592,0.255,0.39,43
samurai,1.764,55,137,1,1,0.562,0.736,0.838,192
crucial,1.764,126,312,1,1,0.541,0.657,0.777,438
homestead,1.763,14,36,1,1,0.865,0.221,0.536,50
doomsday,1.761,16,41,1,1,0.125,0.861,0.67,57
taunt,1.76,18,46,1,1,0.083,0.696,0.355,64
complete,1.758,1854,4597,1,1,0.75,0.414,0.809,6451
contrary,1.753,150,375,1,1,0.327,0.449,0.338,525
landmark,1.749,17,44,1,1,0.694,0.355,0.681,61
doings,1.749,23,59,1,1,0.604,0.491,0.705,82
indignation,1.749,9,24,1,1,0.173,0.778,0.431,33
bard,1.749,37,94,1,1,0.47,0.41,0.439,131
courteous,1.749,7,19,1,1,0.937,0.396,0.529,26
unbridled,1.749,11,29,1,1,0.396,0.759,0.448,40
aroma,1.749,21,54,1,1,0.823,0.235,0.442,75
trappings,1.749,9,24,1,1,0.458,0.462,0.37,33
interference,1.749,21,54,1,1,0.396,0.736,0.357,75
recoil,1.749,7,19,1,1,0.089,0.429,0.259,26
reclaim,1.744,36,92,1,1,0.469,0.724,0.648,128
punishment,1.743,233,588,1,1,0.083,0.825,0.536,821
plunge,1.743,28,72,1,1,0.307,0.69,0.55,100
conquest,1.739,18,47,1,1,0.71,0.702,0.833,65
prying,1.738,16,42,1,1,0.385,0.647,0.547,58
restraint,1.736,29,75,1,1,0.167,0.618,0.52,104
allegory,1.734,12,32,1,1,0.615,0.58,0.509,44
preserved,1.734,12,32,1,1,0.677,0.337,0.667,44
elation,1.731,10,27,1,1,0.74,0.853,0.623,37
intoxicating,1.73,30,78,1,1,0.224,0.76,0.464,108
spectacle,1.726,24,63,1,1,0.812,0.745,0.762,87
monte,1.725,15,40,1,1,0.589,0.33,0.391,55
crisp,1.724,45,117,1,1,0.776,0.692,0.508,162
acrylic,1.723,29,76,1,1,0.582,0.279,0.42,105
amuse,1.721,41,107,1,1,0.812,0.684,0.664,148
impenetrable,1.721,20,53,1,1,0.531,0.577,0.839,73
stimulus,1.721,13,35,1,1,0.771,0.779,0.75,48
desiring,1.72,32,84,1,1,0.814,0.821,0.632,116
recreational,1.718,18,48,1,1,0.896,0.686,0.479,66
brisk,1.717,11,30,1,1,0.719,0.745,0.742,41
decadent,1.717,11,30,1,1,0.29,0.559,0.324,41
weakened,1.716,28,74,1,1,0.373,0.304,0.092,102
transformation,1.714,72,188,1,1,0.796,0.618,0.77,260
planting,1.714,38,100,1,1,0.635,0.343,0.595,138
fixture,1.71,9,25,1,1,0.663,0.216,0.409,34
glorious,1.71,184,480,1,1,0.959,0.673,0.827,664
safeguard,1.71,9,25,1,1,0.786,0.624,0.7,34
nightingale,1.707,45,119,1,1,0.74,0.34,0.496,164
necessities,1.707,22,59,1,1,0.52,0.63,0.463,81
execution,1.704,25,67,1,1,0.16,0.811,0.713,92
headquarters,1.704,12,33,1,1,0.615,0.271,0.525,45
ox,1.704,12,33,1,1,0.417,0.396,0.412,45
completeness,1.704,12,33,1,1,0.823,0.433,0.769,45
discernment,1.703,20,54,1,1,0.408,0.471,0.694,74
seer,1.701,7,20,1,1,0.604,0.481,0.74,27
superstitious,1.701,7,20,1,1,0.281,0.545,0.514,27
stitching,1.701,7,20,1,1,0.51,0.382,0.345,27
coolness,1.701,15,41,1,1,0.49,0.307,0.548,56
rehearse,1.701,7,20,1,1,0.588,0.622,0.5,27
forgetfulness,1.696,10,28,1,1,0.271,0.385,0.302,38
erode,1.696,10,28,1,1,0.208,0.643,0.58,38
presumption,1.696,10,28,1,1,0.375,0.596,0.518,38
confines,1.696,32,86,1,1,0.396,0.386,0.542,118
igloo,1.696,10,28,1,1,0.569,0.302,0.345,38
prose,1.695,38,102,1,1,0.542,0.274,0.436,140
wintry,1.694,13,36,1,1,0.448,0.434,0.445,49
wisdom,1.692,468,1241,1,1,0.93,0.302,0.871,1709
external,1.692,110,293,1,1,0.479,0.341,0.509,403
solitaire,1.691,85,227,1,1,0.365,0.227,0.279,312
peaceful,1.685,1776,4737,1,1,0.867,0.108,0.569,6513
seashore,1.685,8,23,1,1,0.796,0.31,0.375,31
disembodied,1.685,8,23,1,1,0.167,0.62,0.412,31
freshness,1.685,8,23,1,1,0.917,0.333,0.585,31
situated,1.685,17,47,1,1,0.542,0.231,0.543,64
permanence,1.685,8,23,1,1,0.771,0.37,0.708,31
disarray,1.685,8,23,1,1,0.198,0.657,0.223,31
yoga,1.68,195,524,1,1,0.75,0.115,0.422,719
divine,1.68,274,736,1,1,0.918,0.571,0.885,1010
complacency,1.678,18,50,1,1,0.604,0.503,0.519,68
yogi,1.678,18,50,1,1,0.653,0.347,0.349,68
unparalleled,1.678,18,50,1,1,0.708,0.306,0.538,68
prefer,1.678,2078,5580,1,1,0.76,0.385,0.536,7658
acre,1.677,15,42,1,1,0.583,0.387,0.423,57
indefinite,1.677,15,42,1,1,0.448,0.292,0.296,57
necessary,1.677,768,2066,1,1,0.75,0.433,0.679,2834
sanity,1.676,270,728,1,1,0.667,0.333,0.655,998
recreation,1.675,25,69,1,1,0.909,0.632,0.66,94
evade,1.674,22,61,1,1,0.304,0.49,0.342,83
trail,1.674,200,541,1,1,0.6,0.322,0.455,741
unadulterated,1.673,9,26,1,1,0.57,0.42,0.528,35
covet,1.673,9,26,1,1,0.302,0.779,0.524,35
malt,1.673,9,26,1,1,0.75,0.373,0.324,35
menacing,1.673,9,26,1,1,0.042,0.88,0.643,35
stronghold,1.673,9,26,1,1,0.708,0.636,0.954,35
opium,1.673,9,26,1,1,0.276,0.49,0.333,35
herbs,1.67,16,45,1,1,0.62,0.299,0.308,61
expanse,1.67,40,110,1,1,0.594,0.529,0.689,150
overload,1.669,37,102,1,1,0.381,0.69,0.652,139
practise,1.667,20,56,1,1,0.713,0.49,0.616,76
inclination,1.667,13,37,1,1,0.378,0.49,0.538,50
literature,1.665,196,535,1,1,0.708,0.25,0.598,731
unravel,1.664,35,97,1,1,0.378,0.598,0.455,132
attainable,1.662,10,29,1,1,0.76,0.5,0.759,39
creaking,1.662,10,29,1,1,0.302,0.743,0.415,39
indulgence,1.662,21,59,1,1,0.479,0.49,0.517,80
forest,1.661,583,1594,1,1,0.729,0.27,0.435,2177
pastime,1.66,29,81,1,1,0.677,0.353,0.443,110
mosque,1.66,29,81,1,1,0.542,0.352,0.528,110
subdued,1.66,14,40,1,1,0.236,0.463,0.223,54
permitted,1.659,18,51,1,1,0.865,0.41,0.613,69
retire,1.656,113,312,1,1,0.398,0.392,0.186,425
crowds,1.655,315,867,1,1,0.469,0.723,0.806,1182
moat,1.654,7,21,1,1,0.398,0.38,0.314,28
dojo,1.654,7,21,1,1,0.5,0.435,0.455,28
unwritten,1.654,11,32,1,1,0.367,0.384,0.272,43
deprive,1.654,23,65,1,1,0.271,0.591,0.34,88
futility,1.654,39,109,1,1,0.125,0.32,0.176,148
sequestered,1.654,7,21,1,1,0.16,0.863,0.427,28
celibacy,1.654,75,208,1,1,0.302,0.276,0.509,283
wreath,1.654,7,21,1,1,0.745,0.44,0.66,28
ecstasy,1.652,44,123,1,1,0.796,0.922,0.655,167
hushed,1.649,16,46,1,1,0.292,0.194,0.272,62
oncoming,1.647,12,35,1,1,0.594,0.625,0.773,47
boldness,1.644,8,24,1,1,0.806,0.684,0.814,32
archery,1.644,8,24,1,1,0.594,0.604,0.589,32
skepticism,1.644,8,24,1,1,0.229,0.48,0.582,32
transcendental,1.644,8,24,1,1,0.635,0.652,0.842,32
fencing,1.644,8,24,1,1,0.542,0.654,0.539,32
introspective,1.644,62,174,1,1,0.552,0.36,0.471,236
incorporate,1.644,17,49,1,1,0.745,0.612,0.571,66
noisy,1.637,163,458,1,1,0.271,0.812,0.561,621
discretion,1.636,9,27,1,1,0.552,0.32,0.685,36
assembled,1.636,9,27,1,1,0.663,0.45,0.644,36
waterfront,1.636,9,27,1,1,0.716,0.274,0.556,36
dissolve,1.634,30,86,1,1,0.271,0.49,0.41,116
majestic,1.633,51,145,1,1,0.948,0.731,0.906,196
humility,1.632,73,207,1,1,0.74,0.118,0.444,280
likeness,1.632,15,44,1,1,0.688,0.41,0.561,59
creek,1.631,53,151,1,1,0.552,0.392,0.33,204
exquisite,1.631,53,151,1,1,0.892,0.644,0.604,204
theological,1.63,10,30,1,1,0.48,0.363,0.683,40
humidity,1.63,10,30,1,1,0.464,0.373,0.367,40
required,1.626,203,576,1,1,0.583,0.509,0.7,779
drunkenness,1.624,11,33,1,1,0.214,0.774,0.336,44
accustomed,1.623,134,382,1,1,0.542,0.365,0.441,516
mountaintop,1.621,18,53,1,1,0.653,0.541,0.713,71
stimulation,1.621,69,198,1,1,0.708,0.821,0.702,267
vie,1.62,57,164,1,1,0.484,0.491,0.5,221
sensibility,1.62,12,36,1,1,0.583,0.423,0.448,48
crave,1.619,846,2411,1,1,0.625,0.51,0.731,3257
conundrum,1.618,26,76,1,1,0.354,0.524,0.408,102
gown,1.618,26,76,1,1,0.625,0.283,0.421,102
confined,1.617,88,253,1,1,0.286,0.472,0.444,341
eleventh,1.616,6,19,1,1,0.594,0.329,0.357,25
comparatively,1.616,6,19,1,1,0.604,0.391,0.538,25
compartment,1.616,6,19,1,1,0.5,0.389,0.607,25
upkeep,1.616,6,19,1,1,0.59,0.442,0.685,25
whimsy,1.616,6,19,1,1,0.729,0.639,0.455,25
teapot,1.616,6,19,1,1,0.479,0.11,0.309,25
juxtaposition,1.614,21,62,1,1,0.427,0.5,0.46,83
abode,1.613,29,85,1,1,0.62,0.302,0.5,114
trusty,1.613,14,42,1,1,0.863,0.398,0.696,56
overcast,1.613,14,42,1,1,0.417,0.25,0.475,56
contemporary,1.613,59,171,1,1,0.72,0.365,0.569,230
ample,1.612,22,65,1,1,0.744,0.349,0.719,87
yearn,1.611,122,352,1,1,0.592,0.491,0.491,474
node,1.61,23,68,1,1,0.396,0.343,0.361,91
arid,1.61,7,22,1,1,0.323,0.333,0.379,29
prevailing,1.61,7,22,1,1,0.798,0.708,0.864,29
afresh,1.61,7,22,1,1,0.643,0.521,0.48,29
irreversible,1.61,7,22,1,1,0.17,0.541,0.667,29
scholarly,1.61,7,22,1,1,0.75,0.466,0.709,29
unbound,1.61,7,22,1,1,0.354,0.402,0.283,29
preference,1.609,104,301,1,1,0.792,0.5,0.72,405
vow,1.608,41,120,1,1,0.56,0.51,0.664,161
brewing,1.606,25,74,1,1,0.74,0.593,0.609,99
amid,1.606,60,175,1,1,0.51,0.34,0.256,235
assertion,1.605,17,51,1,1,0.74,0.442,0.75,68
glade,1.605,8,25,1,1,0.6,0.385,0.434,33
fondness,1.603,18,54,1,1,0.885,0.391,0.503,72
bacon,1.601,118,344,1,1,0.698,0.406,0.295,462
whirl,1.601,9,28,1,1,0.461,0.788,0.661,37
foliage,1.601,9,28,1,1,0.62,0.373,0.237,37
unfamiliar,1.6,102,298,1,1,0.219,0.558,0.273,400
input,1.599,62,182,1,1,0.643,0.337,0.527,244
cultivated,1.599,20,60,1,1,0.837,0.343,0.564,80
tumultuous,1.598,10,31,1,1,0.208,0.622,0.59,41
embrace,1.597,1360,3962,1,1,0.949,0.49,0.452,5322
prolonged,1.597,68,200,1,1,0.406,0.453,0.56,268
voluntary,1.596,58,171,1,1,0.771,0.46,0.643,229
cowardice,1.595,23,69,1,1,0.133,0.621,0.167,92
idleness,1.594,24,72,1,1,0.308,0.33,0.228,96
sullen,1.593,25,75,1,1,0.25,0.407,0.263,100
crest,1.593,12,37,1,1,0.458,0.333,0.333,49
therapeutic,1.593,143,420,1,1,0.625,0.275,0.68,563
intoxication,1.591,13,40,1,1,0.323,0.71,0.4,53
bronze,1.59,14,43,1,1,0.622,0.333,0.526,57
pivotal,1.59,14,43,1,1,0.582,0.471,0.536,57
invasion,1.59,44,131,1,1,0.271,0.843,0.808,175
philosopher,1.589,46,137,1,1,0.684,0.316,0.72,183
ambient,1.588,32,96,1,1,0.625,0.36,0.582,128
balm,1.588,32,96,1,1,0.625,0.275,0.414,128
tarot,1.587,50,149,1,1,0.479,0.422,0.43,199
growth,1.583,676,1999,1,1,0.917,0.588,0.776,2675
rugged,1.581,23,70,1,1,0.561,0.569,0.793,93
ridge,1.581,24,73,1,1,0.484,0.402,0.349,97
deliverance,1.581,24,73,1,1,0.75,0.52,0.658,97
lengthy,1.58,26,79,1,1,0.57,0.342,0.528,105
remembrance,1.58,53,159,1,1,0.812,0.25,0.519,212
spectacular,1.578,60,180,1,1,0.947,0.74,0.887,240
exterior,1.577,33,100,1,1,0.542,0.4,0.627,133
avoidance,1.576,36,109,1,1,0.47,0.481,0.466,145
amidst,1.575,164,490,1,1,0.48,0.33,0.316,654
nest,1.575,133,398,1,1,0.687,0.221,0.333,531
possession,1.575,44,133,1,1,0.677,0.676,0.848,177
sleepless,1.569,531,1592,1,1,0.213,0.41,0.207,2123
fuzz,1.567,7,23,1,1,0.521,0.482,0.363,30
underpants,1.567,6,20,1,1,0.448,0.473,0.276,26
thud,1.567,6,20,1,1,0.255,0.686,0.62,26
breadth,1.567,10,32,1,1,0.667,0.49,0.644,42
sailboat,1.567,9,29,1,1,0.719,0.392,0.381,38
mosaic,1.567,10,32,1,1,0.635,0.25,0.302,42
strengthening,1.567,20,62,1,1,0.913,0.627,0.945,82
adversity,1.567,40,122,1,1,0.276,0.76,0.538,162
gleaming,1.567,13,41,1,1,0.827,0.635,0.627,54
languish,1.567,11,35,1,1,0.235,0.408,0.382,46
bonne,1.567,9,29,1,1,0.448,0.395,0.362,38
perennial,1.567,10,32,1,1,0.527,0.358,0.5,42
cello,1.567,13,41,1,1,0.635,0.324,0.528,54
fornication,1.567,7,23,1,1,0.365,0.951,0.457,30
expansive,1.567,18,56,1,1,0.708,0.65,0.778,74
apprehension,1.567,10,32,1,1,0.385,0.72,0.454,42
synergy,1.567,8,26,1,1,0.667,0.51,0.72,34
certainty,1.567,51,155,1,1,0.781,0.4,0.769,206
emergence,1.567,7,23,1,1,0.276,0.857,0.676,30
precision,1.567,13,41,1,1,0.677,0.431,0.875,54
glare,1.567,27,83,1,1,0.698,0.735,0.733,110
absorbing,1.567,19,59,1,1,0.49,0.49,0.578,78
rendering,1.567,16,50,1,1,0.531,0.434,0.667,66
earthy,1.567,6,20,1,1,0.375,0.413,0.404,26
repentance,1.567,19,59,1,1,0.417,0.604,0.324,78
beast,1.566,400,1203,1,1,0.214,0.78,0.732,1603
observe,1.564,105,318,1,1,0.771,0.39,0.36,423
recluse,1.562,68,207,1,1,0.24,0.49,0.446,275
cottage,1.562,64,195,1,1,0.6,0.279,0.361,259
obtain,1.559,41,126,1,1,0.76,0.438,0.731,167
outward,1.558,36,111,1,1,0.449,0.439,0.365,147
boundary,1.553,22,69,1,1,0.561,0.427,0.518,91
solitary,1.552,559,1705,1,1,0.224,0.202,0.268,2264
perseverance,1.551,40,124,1,1,0.888,0.63,0.796,164
urgency,1.551,19,60,1,1,0.429,0.908,0.543,79
nook,1.55,18,57,1,1,0.48,0.321,0.296,75
sands,1.55,37,115,1,1,0.646,0.304,0.377,152
seek,1.549,1410,4310,1,1,0.622,0.429,0.482,5720
utilize,1.549,17,54,1,1,0.694,0.445,0.545,71
essence,1.546,122,376,1,1,0.663,0.369,0.575,498
grail,1.545,14,45,1,1,0.573,0.384,0.566,59
resonance,1.545,14,45,1,1,0.541,0.426,0.629,59
recover,1.545,179,551,1,1,0.918,0.51,0.647,730
waning,1.544,13,42,1,1,0.375,0.333,0.3,55
haste,1.544,13,42,1,1,0.378,0.745,0.5,55
nonfiction,1.544,13,42,1,1,0.426,0.315,0.431,55
autonomy,1.541,37,116,1,1,0.781,0.349,0.891,153
sustenance,1.54,11,36,1,1,0.82,0.519,0.679,47
discern,1.54,23,73,1,1,0.459,0.566,0.518,96
territorial,1.54,11,36,1,1,0.405,0.6,0.766,47
dominion,1.537,10,33,1,1,0.542,0.704,0.89,43
granite,1.537,10,33,1,1,0.572,0.343,0.483,43
manor,1.537,53,166,1,1,0.646,0.358,0.738,219
tangle,1.534,9,30,1,1,0.354,0.545,0.254,39
scribble,1.534,9,30,1,1,0.429,0.453,0.358,39
uninhabited,1.534,9,30,1,1,0.301,0.23,0.221,39
highest,1.534,267,830,1,1,0.771,0.64,0.71,1097
landscape,1.532,147,459,1,1,0.719,0.176,0.423,606
hallowed,1.531,8,27,1,1,0.74,0.5,0.728,35
itinerary,1.531,8,27,1,1,0.551,0.55,0.454,35
hiker,1.531,8,27,1,1,0.694,0.802,0.644,35
altered,1.531,26,83,1,1,0.255,0.765,0.5,109
hibernate,1.529,16,52,1,1,0.5,0.317,0.431,68
reserve,1.529,50,158,1,1,0.585,0.289,0.589,208
importance,1.527,291,911,1,1,0.75,0.58,0.864,1202
birthing,1.526,7,24,1,1,0.796,0.877,0.519,31
sovereignty,1.526,15,49,1,1,0.719,0.529,0.886,64
revolt,1.526,7,24,1,1,0.343,0.878,0.658,31
fellowship,1.526,119,374,1,1,0.9,0.429,0.778,493
crackle,1.526,7,24,1,1,0.327,0.643,0.481,31
continental,1.526,7,24,1,1,0.486,0.35,0.755,31
indestructible,1.526,7,24,1,1,0.772,0.731,0.853,31
grouping,1.526,7,24,1,1,0.745,0.58,0.698,31
momentary,1.526,54,171,1,1,0.562,0.271,0.33,225
feast,1.525,76,240,1,1,0.979,0.724,0.68,316
pact,1.524,29,93,1,1,0.442,0.444,0.593,122
healing,1.522,862,2707,1,1,0.75,0.452,0.585,3569
mystical,1.522,28,90,1,1,0.594,0.443,0.689,118
stoic,1.522,35,112,1,1,0.427,0.473,0.602,147
regain,1.521,63,200,1,1,0.729,0.52,0.759,263
receptive,1.521,13,43,1,1,0.729,0.519,0.639,56
deafness,1.521,6,21,1,1,0.125,0.413,0.219,27
disruption,1.521,13,43,1,1,0.235,0.735,0.436,56
dispute,1.521,20,65,1,1,0.219,0.75,0.585,85
hooded,1.521,6,21,1,1,0.306,0.745,0.439,27
sauna,1.521,20,65,1,1,0.781,0.35,0.455,85
clamor,1.521,6,21,1,1,0.438,0.643,0.36,27
innocently,1.521,20,65,1,1,0.776,0.25,0.302,85
glaze,1.521,6,21,1,1,0.65,0.34,0.356,27
primitive,1.521,13,43,1,1,0.323,0.388,0.361,56
preferable,1.518,52,166,1,1,0.806,0.433,0.687,218
systematically,1.517,12,40,1,1,0.69,0.39,0.651,52
strife,1.517,38,122,1,1,0.344,0.898,0.63,160
antithesis,1.517,12,40,1,1,0.396,0.412,0.536,52
merge,1.515,24,78,1,1,0.76,0.48,0.733,102
guru,1.513,41,132,1,1,0.573,0.36,0.653,173
ingredient,1.513,23,75,1,1,0.792,0.373,0.451,98
attire,1.513,17,56,1,1,0.742,0.388,0.483,73
omnipotent,1.513,11,37,1,1,0.719,0.679,0.919,48
abundance,1.509,94,301,1,1,0.812,0.69,0.852,395
invade,1.509,49,158,1,1,0.408,0.892,0.714,207
value,1.508,997,3174,1,1,0.875,0.582,0.802,4171
watchtower,1.508,10,34,1,1,0.5,0.415,0.647,44
blasphemy,1.508,10,34,1,1,0.146,0.794,0.406,44
transcend,1.508,21,69,1,1,0.604,0.771,0.726,90
withdrawal,1.507,69,222,1,1,0.275,0.541,0.226,291
fishing,1.505,145,465,1,1,0.677,0.283,0.405,610
downtime,1.505,25,82,1,1,0.24,0.226,0.324,107
delicacy,1.503,9,31,1,1,0.812,0.279,0.336,40
fireplace,1.503,39,127,1,1,0.667,0.38,0.417,166
salted,1.503,9,31,1,1,0.333,0.4,0.304,40
armor,1.503,59,191,1,1,0.469,0.625,0.784,250
ascending,1.503,9,31,1,1,0.826,0.644,0.777,40
pleasurable,1.503,14,47,1,1,0.948,0.529,0.669,61
vocation,1.503,19,63,1,1,0.833,0.426,0.686,82
legion,1.501,33,108,1,1,0.469,0.57,0.852,141
incest,1.499,32,105,1,1,0.073,0.853,0.491,137
discover,1.498,424,1365,1,1,0.771,0.793,0.673,1789
indoor,1.498,41,134,1,1,0.615,0.245,0.347,175
intrinsic,1.498,13,44,1,1,0.406,0.471,0.526,57
pious,1.498,13,44,1,1,0.698,0.306,0.426,57
density,1.498,13,44,1,1,0.602,0.471,0.561,57
disturbance,1.497,22,73,1,1,0.146,0.907,0.404,95
unleash,1.497,22,73,1,1,0.479,0.775,0.559,95
beneficial,1.497,100,324,1,1,0.82,0.579,0.703,424
capacity,1.497,155,501,1,1,0.719,0.411,0.806,656
overdo,1.496,8,28,1,1,0.156,0.864,0.602,36
adieu,1.496,8,28,1,1,0.25,0.471,0.342,36
nightlife,1.496,8,28,1,1,0.542,0.783,0.51,36
exalted,1.496,8,28,1,1,0.676,0.845,0.696,36
racket,1.496,8,28,1,1,0.52,0.356,0.352,36
assimilate,1.496,8,28,1,1,0.559,0.391,0.683,36
evoke,1.495,30,99,1,1,0.438,0.341,0.5,129
etiquette,1.493,12,41,1,1,0.604,0.35,0.421,53
candles,1.492,102,332,1,1,0.615,0.206,0.268,434
reflecting,1.492,157,510,1,1,0.59,0.408,0.471,667
paramount,1.492,16,54,1,1,0.771,0.615,0.902,70
cove,1.492,16,54,1,1,0.5,0.304,0.37,70
traverse,1.487,11,38,1,1,0.571,0.59,0.629,49
threshold,1.487,23,77,1,1,0.531,0.519,0.575,100
solicit,1.487,7,25,1,1,0.62,0.49,0.604,32
photography,1.487,123,402,1,1,0.63,0.431,0.36,525
syllable,1.487,7,25,1,1,0.448,0.25,0.417,32
canto,1.487,11,38,1,1,0.776,0.461,0.554,49
cosmopolitan,1.487,7,25,1,1,0.823,0.51,0.76,32
dogma,1.487,15,51,1,1,0.53,0.46,0.719,66
boundless,1.487,19,64,1,1,0.684,0.642,0.652,83
steadfast,1.487,15,51,1,1,0.771,0.433,0.8,66
flimsy,1.487,7,25,1,1,0.302,0.396,0.189,32
arsenic,1.487,7,25,1,1,0.281,0.472,0.447,32
denounce,1.487,11,38,1,1,0.083,0.78,0.426,49
appropriation,1.487,11,38,1,1,0.51,0.632,0.717,49
inland,1.487,7,25,1,1,0.51,0.417,0.423,32
conqueror,1.487,7,25,1,1,0.604,0.809,0.93,32
alimony,1.487,7,25,1,1,0.612,0.477,0.464,32
relaxing,1.486,276,900,1,1,0.854,0.157,0.475,1176
remainder,1.485,34,113,1,1,0.398,0.357,0.324,147
abide,1.485,30,100,1,1,0.635,0.354,0.705,130
kinship,1.484,26,87,1,1,0.771,0.3,0.652,113
solemn,1.483,56,185,1,1,0.708,0.37,0.709,241
turbulent,1.482,14,48,1,1,0.302,0.792,0.612,62
sunrise,1.481,155,509,1,1,0.823,0.347,0.64,664
rebirth,1.481,36,120,1,1,0.781,0.712,0.78,156
hurried,1.48,10,35,1,1,0.314,0.806,0.393,45
highlands,1.479,28,94,1,1,0.735,0.431,0.596,122
relative,1.479,162,533,1,1,0.5,0.378,0.386,695
philosophical,1.479,46,153,1,1,0.719,0.275,0.713,199
graffiti,1.479,17,58,1,1,0.582,0.633,0.353,75
enlightening,1.478,24,81,1,1,0.825,0.729,0.727,105
spa,1.477,45,150,1,1,0.622,0.151,0.386,195
splendor,1.476,20,68,1,1,0.927,0.612,0.85,88
radically,1.476,13,45,1,1,0.552,0.731,0.715,58
grasshopper,1.476,6,22,1,1,0.5,0.462,0.287,28
penitentiary,1.476,6,22,1,1,0.229,0.726,0.491,28
communicative,1.476,6,22,1,1,0.847,0.56,0.637,28
accelerated,1.476,6,22,1,1,0.61,0.812,0.682,28
recede,1.476,6,22,1,1,0.231,0.449,0.245,28
mortal,1.475,102,338,1,1,0.196,0.786,0.51,440
reliance,1.474,23,78,1,1,0.844,0.431,0.853,101
gardens,1.474,64,213,1,1,0.775,0.202,0.296,277
brewery,1.474,16,55,1,1,0.71,0.622,0.51,71
monarch,1.472,9,32,1,1,0.583,0.559,0.87,41
neighboring,1.472,9,32,1,1,0.656,0.306,0.481,41
feign,1.472,9,32,1,1,0.34,0.394,0.356,41
habitually,1.472,9,32,1,1,0.6,0.324,0.583,41
mournful,1.47,25,85,1,1,0.18,0.441,0.188,110
untouched,1.469,41,138,1,1,0.531,0.276,0.6,179
authentic,1.469,125,416,1,1,0.885,0.51,0.782,541
blindness,1.466,21,72,1,1,0.245,0.48,0.196,93
observing,1.466,65,218,1,1,0.583,0.4,0.685,283
patience,1.465,363,1208,1,1,0.771,0.125,0.387,1571
earthly,1.465,30,102,1,1,0.625,0.318,0.518,132
procession,1.462,8,29,1,1,0.656,0.539,0.643,37
waterfall,1.462,29,99,1,1,0.652,0.46,0.528,128
chattering,1.462,8,29,1,1,0.46,0.663,0.304,37
cement,1.462,26,89,1,1,0.544,0.265,0.527,115
embassy,1.462,17,59,1,1,0.622,0.333,0.758,76
pendant,1.462,8,29,1,1,0.676,0.321,0.385,37
heed,1.459,31,106,1,1,0.75,0.49,0.569,137
joys,1.458,86,290,1,1,0.981,0.643,0.651,376
balanced,1.457,68,230,1,1,0.806,0.255,0.745,298
treasures,1.457,42,143,1,1,0.867,0.771,0.842,185
awakening,1.456,98,331,1,1,0.745,0.5,0.618,429
reconciliation,1.455,13,46,1,1,0.896,0.57,0.604,59
immaculate,1.455,13,46,1,1,0.698,0.33,0.688,59
complement,1.455,27,93,1,1,0.76,0.277,0.6,120
crescent,1.455,13,46,1,1,0.698,0.382,0.407,59
sayonara,1.453,10,36,1,1,0.56,0.398,0.402,46
fruition,1.453,10,36,1,1,0.776,0.567,0.664,46
completion,1.453,21,73,1,1,0.656,0.47,0.525,94
camouflage,1.453,10,36,1,1,0.438,0.585,0.45,46
nominate,1.451,37,127,1,1,0.615,0.471,0.669,164
mischief,1.451,26,90,1,1,0.385,0.834,0.292,116
chaplain,1.449,7,26,1,1,0.582,0.37,0.577,33
mindful,1.449,63,215,1,1,0.765,0.45,0.725,278
cyclical,1.449,7,26,1,1,0.38,0.45,0.554,33
linguistic,1.449,7,26,1,1,0.646,0.351,0.618,33
rowing,1.449,7,26,1,1,0.458,0.443,0.467,33
flourish,1.449,60,205,1,1,0.939,0.573,0.601,265
processing,1.449,52,178,1,1,0.726,0.774,0.711,230
astral,1.448,28,97,1,1,0.604,0.417,0.567,125
illuminate,1.448,28,97,1,1,0.905,0.646,0.782,125
delve,1.448,20,70,1,1,0.469,0.529,0.684,90
monochrome,1.447,12,43,1,1,0.312,0.292,0.339,55
prized,1.447,12,43,1,1,0.906,0.53,0.714,55
embers,1.447,12,43,1,1,0.49,0.481,0.508,55
penchant,1.447,12,43,1,1,0.688,0.48,0.609,55
effortless,1.447,12,43,1,1,0.626,0.09,0.352,55
uneasiness,1.447,12,43,1,1,0.19,0.798,0.241,55
wither,1.446,43,148,1,1,0.15,0.42,0.259,191
atone,1.445,17,60,1,1,0.418,0.673,0.411,77
mythology,1.442,19,67,1,1,0.684,0.439,0.688,86
anonymity,1.442,39,135,1,1,0.469,0.255,0.43,174
atomic,1.442,9,33,1,1,0.327,0.817,0.713,42
novelist,1.442,24,84,1,1,0.34,0.343,0.529,108
cherish,1.44,366,1249,1,1,0.896,0.491,0.652,1615
heath,1.44,58,200,1,1,0.802,0.387,0.546,258
medieval,1.44,26,91,1,1,0.56,0.408,0.455,117
audible,1.44,26,91,1,1,0.673,0.37,0.462,117
surroundings,1.44,129,442,1,1,0.6,0.346,0.492,571
comfortable,1.439,2014,6870,1,1,0.927,0.163,0.473,8884
gravel,1.439,16,57,1,1,0.39,0.37,0.332,73
hideout,1.437,11,40,1,1,0.337,0.443,0.302,51
ancestor,1.437,11,40,1,1,0.592,0.388,0.594,51
murky,1.437,11,40,1,1,0.143,0.618,0.37,51
calamity,1.437,11,40,1,1,0.122,0.795,0.343,51
poet,1.434,214,736,1,1,0.827,0.35,0.556,950
arched,1.434,6,23,1,1,0.582,0.403,0.398,29
breach,1.434,13,47,1,1,0.177,0.745,0.423,60
prudence,1.434,6,23,1,1,0.781,0.284,0.679,29
exposition,1.434,6,23,1,1,0.521,0.627,0.655,29
wintertime,1.434,6,23,1,1,0.76,0.516,0.404,29
hoarse,1.434,6,23,1,1,0.281,0.402,0.315,29
retrospective,1.434,6,23,1,1,0.594,0.481,0.528,29
duel,1.434,13,47,1,1,0.271,0.696,0.589,60
steward,1.434,6,23,1,1,0.633,0.238,0.55,29
inertia,1.434,6,23,1,1,0.344,0.288,0.322,29
discovery,1.433,120,414,1,1,0.823,0.627,0.814,534
teamwork,1.432,22,78,1,1,0.918,0.49,0.773,100
prelude,1.431,15,54,1,1,0.544,0.392,0.556,69
composure,1.429,17,61,1,1,0.802,0.354,0.717,78
beckon,1.429,8,30,1,1,0.663,0.455,0.452,38
gorge,1.426,10,37,1,1,0.365,0.644,0.42,47
machinery,1.426,10,37,1,1,0.458,0.615,0.629,47
carve,1.426,43,151,1,1,0.469,0.443,0.598,194
margin,1.426,10,37,1,1,0.5,0.219,0.331,47
solidify,1.426,10,37,1,1,0.583,0.318,0.754,47
calming,1.425,132,459,1,1,0.885,0.105,0.36,591
colonial,1.424,12,44,1,1,0.553,0.327,0.613,56
lounging,1.421,16,58,1,1,0.735,0.167,0.449,74
surrendering,1.419,22,79,1,1,0.198,0.411,0.245,101
enable,1.419,51,180,1,1,0.76,0.491,0.782,231
carefree,1.418,55,194,1,1,0.755,0.22,0.5,249
incessant,1.417,32,114,1,1,0.438,0.76,0.544,146
emancipation,1.413,5,20,1,1,0.704,0.684,0.763,25
seaweed,1.413,5,20,1,1,0.446,0.286,0.382,25
grassy,1.413,7,27,1,1,0.647,0.323,0.371,34
carcass,1.413,9,34,1,1,0.115,0.529,0.309,43
lawless,1.413,7,27,1,1,0.219,0.69,0.42,34
amour,1.413,25,90,1,1,0.865,0.48,0.652,115
ornament,1.413,9,34,1,1,0.561,0.373,0.441,43
horizontal,1.413,7,27,1,1,0.573,0.304,0.387,34
evacuation,1.413,5,20,1,1,0.16,0.755,0.582,25
fowl,1.413,5,20,1,1,0.51,0.388,0.364,25
overture,1.413,5,20,1,1,0.49,0.402,0.491,25
dabble,1.413,5,20,1,1,0.55,0.53,0.491,25
observatory,1.413,9,34,1,1,0.643,0.324,0.731,43
assassinate,1.413,5,20,1,1,0.051,0.969,0.722,25
yield,1.413,25,90,1,1,0.719,0.578,0.618,115
anathema,1.413,7,27,1,1,0.286,0.49,0.519,34
innocuous,1.413,5,20,1,1,0.51,0.321,0.172,25
prim,1.413,5,20,1,1,0.54,0.37,0.473,25
journal,1.411,163,574,1,1,0.688,0.24,0.352,737
sea,1.411,1833,6431,1,1,0.833,0.353,0.589,8264
order,1.411,1469,5156,1,1,0.78,0.295,0.814,6625
reset,1.409,77,273,1,1,0.49,0.45,0.574,350
margarita,1.409,38,136,1,1,0.75,0.438,0.42,174
aligned,1.408,28,101,1,1,0.583,0.275,0.553,129
temple,1.408,134,474,1,1,0.612,0.269,0.66,608
residency,1.406,20,73,1,1,0.694,0.357,0.679,93
philosophy,1.406,102,362,1,1,0.684,0.255,0.64,464
chambers,1.404,46,165,1,1,0.542,0.442,0.388,211
scotch,1.403,27,98,1,1,0.578,0.52,0.615,125
vitality,1.402,12,45,1,1,0.923,0.565,0.869,57
hiss,1.402,12,45,1,1,0.388,0.48,0.37,57
nudity,1.402,12,45,1,1,0.438,0.853,0.415,57
surf,1.401,34,123,1,1,0.847,0.65,0.5,157
lunacy,1.4,10,38,1,1,0.132,0.847,0.33,48
filmmaker,1.4,10,38,1,1,0.704,0.51,0.635,48
practice,1.4,500,1776,1,1,0.684,0.582,0.639,2276
canvas,1.399,72,258,1,1,0.719,0.09,0.364,330
ascend,1.399,19,70,1,1,0.83,0.62,0.812,89
heather,1.399,59,212,1,1,0.5,0.352,0.407,271
linen,1.397,8,31,1,1,0.656,0.323,0.286,39
stifled,1.397,8,31,1,1,0.229,0.731,0.193,39
timeout,1.397,8,31,1,1,0.344,0.433,0.322,39
cautiously,1.397,8,31,1,1,0.51,0.388,0.525,39
toughness,1.397,8,31,1,1,0.552,0.618,0.837,39
absolution,1.397,8,31,1,1,0.715,0.5,0.664,39
naught,1.397,17,63,1,1,0.344,0.176,0.161,80
disconnect,1.397,105,376,1,1,0.438,0.292,0.191,481
yearning,1.396,262,935,1,1,0.709,0.51,0.537,1197
flash,1.396,201,718,1,1,0.571,0.59,0.657,919
wholly,1.396,40,145,1,1,0.69,0.353,0.696,185
lighthouse,1.395,79,284,1,1,0.622,0.24,0.51,363
refresh,1.394,52,188,1,1,0.719,0.64,0.689,240
virtue,1.394,105,377,1,1,0.896,0.443,0.827,482
constructive,1.394,50,181,1,1,0.86,0.57,0.812,231
stormy,1.393,134,481,1,1,0.146,0.87,0.562,615
chariot,1.393,6,24,1,1,0.684,0.55,0.491,30
moonlit,1.393,20,74,1,1,0.873,0.269,0.508,94
formulate,1.393,6,24,1,1,0.851,0.456,0.673,30
banish,1.393,27,99,1,1,0.163,0.677,0.543,126
infamy,1.393,6,24,1,1,0.177,0.676,0.421,30
recklessness,1.393,6,24,1,1,0.292,0.763,0.38,30
randomness,1.393,6,24,1,1,0.418,0.449,0.433,30
lilac,1.393,13,49,1,1,0.688,0.18,0.357,62
bebop,1.393,13,49,1,1,0.482,0.49,0.358,62
harbinger,1.393,6,24,1,1,0.49,0.389,0.692,30
secluded,1.392,100,360,1,1,0.357,0.265,0.24,460
elements,1.392,79,285,1,1,0.51,0.312,0.462,364
guards,1.391,51,185,1,1,0.448,0.663,0.72,236
quantum,1.391,18,67,1,1,0.704,0.5,0.6,85
desert,1.389,503,1805,1,1,0.469,0.279,0.389,2308
acquiring,1.389,11,42,1,1,0.735,0.51,0.817,53
covenant,1.389,11,42,1,1,0.594,0.462,0.667,53
adventures,1.389,252,906,1,1,0.812,0.764,0.749,1158
moss,1.389,28,103,1,1,0.235,0.27,0.245,131
torment,1.388,96,347,1,1,0.057,0.75,0.387,443
knack,1.385,14,53,1,1,0.562,0.518,0.82,67
ancestral,1.385,9,35,1,1,0.64,0.481,0.75,44
prolific,1.385,9,35,1,1,0.625,0.55,0.604,44
proceeding,1.385,9,35,1,1,0.688,0.428,0.753,44
revelation,1.384,52,190,1,1,0.879,0.5,0.865,242
scripture,1.384,47,172,1,1,0.745,0.27,0.63,219
solidarity,1.383,159,576,1,1,0.792,0.407,0.781,735
tending,1.383,27,100,1,1,0.622,0.556,0.594,127
masses,1.382,81,295,1,1,0.552,0.453,0.473,376
observant,1.382,17,64,1,1,0.74,0.422,0.708,81
purity,1.381,51,187,1,1,0.823,0.205,0.712,238
slink,1.378,7,28,1,1,0.46,0.546,0.314,35
flux,1.378,7,28,1,1,0.473,0.472,0.451,35
schoolyard,1.378,7,28,1,1,0.684,0.529,0.44,35
plentiful,1.378,7,28,1,1,0.833,0.735,0.745,35
foreground,1.378,7,28,1,1,0.708,0.491,0.59,35
relic,1.378,7,28,1,1,0.646,0.452,0.591,35
books,1.378,1485,5386,1,1,0.729,0.115,0.43,6871
cripple,1.376,18,68,1,1,0.094,0.392,0.161,86
repel,1.375,10,39,1,1,0.224,0.62,0.441,49
quivering,1.375,10,39,1,1,0.407,0.776,0.342,49
bunker,1.374,38,141,1,1,0.375,0.673,0.773,179
normalcy,1.373,13,50,1,1,0.805,0.151,0.62,63
settlement,1.373,13,50,1,1,0.635,0.412,0.723,63
disciple,1.373,13,50,1,1,0.765,0.385,0.462,63
absence,1.373,522,1905,1,1,0.153,0.235,0.266,2427
decor,1.372,16,61,1,1,0.734,0.311,0.573,77
godfather,1.372,16,61,1,1,0.694,0.45,0.509,77
doom,1.372,107,393,1,1,0.073,0.75,0.442,500
coastal,1.371,19,72,1,1,0.604,0.37,0.51,91
worship,1.37,196,719,1,1,0.688,0.38,0.573,915
sincere,1.369,159,584,1,1,0.918,0.265,0.725,743
itch,1.369,37,138,1,1,0.319,0.61,0.465,175
tactile,1.366,5,21,1,1,0.573,0.41,0.491,26
abbot,1.366,8,32,1,1,0.427,0.321,0.483,40
annihilate,1.366,5,21,1,1,0.115,0.918,0.681,26
yoke,1.366,5,21,1,1,0.281,0.62,0.582,26
nightfall,1.366,14,54,1,1,0.49,0.436,0.426,68
obstruct,1.366,5,21,1,1,0.115,0.66,0.458,26
eagerness,1.366,8,32,1,1,0.406,0.621,0.443,40
barrow,1.366,5,21,1,1,0.479,0.363,0.362,26
oblivion,1.366,83,307,1,1,0.153,0.33,0.282,390
disruptive,1.366,8,32,1,1,0.255,0.755,0.575,40
powder,1.366,26,98,1,1,0.521,0.25,0.194,124
elude,1.366,5,21,1,1,0.438,0.521,0.464,26
repertoire,1.366,5,21,1,1,0.633,0.594,0.667,26
decadence,1.366,8,32,1,1,0.237,0.455,0.291,40
propensity,1.366,5,21,1,1,0.521,0.462,0.66,26
upheaval,1.366,5,21,1,1,0.29,0.83,0.57,26
truce,1.366,8,32,1,1,0.688,0.441,0.453,40
mystique,1.366,5,21,1,1,0.668,0.633,0.667,26
vulgarity,1.366,5,21,1,1,0.104,0.87,0.346,26
bathe,1.366,32,120,1,1,0.677,0.294,0.371,152
divergent,1.366,5,21,1,1,0.449,0.66,0.587,26
optics,1.366,11,43,1,1,0.562,0.286,0.58,54
imprison,1.366,8,32,1,1,0.112,0.829,0.545,40
fled,1.364,30,113,1,1,0.224,0.639,0.322,143
treasured,1.363,24,91,1,1,0.849,0.471,0.73,115
earnest,1.362,21,80,1,1,0.653,0.38,0.67,101
familiarity,1.362,40,150,1,1,0.854,0.346,0.616,190
retain,1.362,18,69,1,1,0.367,0.451,0.63,87
cavern,1.361,15,58,1,1,0.323,0.36,0.365,73
bowed,1.361,15,58,1,1,0.41,0.418,0.368,73
disposition,1.36,25,95,1,1,0.663,0.542,0.734,120
cedar,1.36,12,47,1,1,0.56,0.267,0.577,59
distinguish,1.359,35,132,1,1,0.675,0.471,0.6,167
shaken,1.358,32,121,1,1,0.344,0.657,0.333,153
postponed,1.357,9,36,1,1,0.439,0.327,0.402,45
indecision,1.354,6,25,1,1,0.184,0.48,0.196,31
subtlety,1.354,6,25,1,1,0.615,0.176,0.363,31
elliptical,1.354,6,25,1,1,0.338,0.385,0.49,31
workings,1.354,6,25,1,1,0.704,0.56,0.745,31
proverb,1.354,13,51,1,1,0.714,0.26,0.518,64
heightened,1.354,27,103,1,1,0.592,0.529,0.788,130
prophet,1.351,71,267,1,1,0.673,0.462,0.774,338
mourn,1.35,91,342,1,1,0.056,0.583,0.15,433
woods,1.35,622,2322,1,1,0.594,0.269,0.364,2944
adverse,1.348,14,55,1,1,0.323,0.61,0.385,69
elegant,1.348,33,126,1,1,0.865,0.5,0.685,159
withdrawn,1.346,42,160,1,1,0.182,0.368,0.221,202
valley,1.345,219,823,1,1,0.729,0.306,0.386,1042
novel,1.345,371,1393,1,1,0.702,0.352,0.439,1764
robust,1.344,11,44,1,1,0.667,0.604,0.719,55
oppress,1.344,7,29,1,1,0.186,0.654,0.555,36
courtesy,1.344,55,209,1,1,0.927,0.287,0.431,264
envision,1.344,19,74,1,1,0.625,0.449,0.483,93
ethereal,1.344,27,104,1,1,0.52,0.419,0.518,131
flares,1.344,7,29,1,1,0.58,0.642,0.556,36
pomp,1.344,7,29,1,1,0.448,0.491,0.413,36
safari,1.344,15,59,1,1,0.663,0.673,0.64,74
regal,1.344,7,29,1,1,0.643,0.459,0.556,36
irritation,1.344,15,59,1,1,0.073,0.833,0.496,74
indulgent,1.344,11,44,1,1,0.56,0.481,0.529,55
playwright,1.344,7,29,1,1,0.672,0.55,0.667,36
desolation,1.343,84,318,1,1,0.073,0.481,0.273,402
beauty,1.343,1412,5304,1,1,0.842,0.6,0.644,6716
clumsy,1.342,40,153,1,1,0.125,0.42,0.144,193
chapel,1.342,36,138,1,1,0.573,0.24,0.44,174
grit,1.341,24,93,1,1,0.449,0.296,0.345,117
beach,1.341,806,3035,1,1,0.885,0.529,0.455,3841
lake,1.34,392,1478,1,1,0.694,0.196,0.425,1870
veiled,1.34,16,63,1,1,0.37,0.317,0.324,79
sorely,1.34,16,63,1,1,0.284,0.727,0.37,79
sunlight,1.339,107,406,1,1,0.906,0.407,0.639,513
scholar,1.339,25,97,1,1,0.694,0.421,0.731,122
compulsory,1.339,12,48,1,1,0.343,0.541,0.791,60
unannounced,1.339,12,48,1,1,0.24,0.588,0.291,60
softness,1.338,21,82,1,1,0.875,0.086,0.402,103
limitless,1.337,26,101,1,1,0.688,0.574,0.655,127
advancing,1.337,8,33,1,1,0.929,0.608,0.812,41
shaman,1.337,8,33,1,1,0.49,0.531,0.604,41
unreachable,1.337,26,101,1,1,0.208,0.679,0.557,127
evaluate,1.337,26,101,1,1,0.663,0.64,0.649,127
guard,1.335,241,915,1,1,0.592,0.51,0.725,1156
linear,1.335,13,52,1,1,0.646,0.25,0.472,65
shrink,1.335,41,158,1,1,0.385,0.453,0.272,199
bore,1.333,90,344,1,1,0.417,0.44,0.455,434
relax,1.331,374,1423,1,1,0.927,0.25,0.375,1797
allure,1.331,14,56,1,1,0.804,0.585,0.686,70
derive,1.331,14,56,1,1,0.396,0.324,0.36,70
magnificent,1.328,83,319,1,1,1,0.68,0.886,402
harness,1.327,15,60,1,1,0.57,0.549,0.508,75
eloquent,1.327,15,60,1,1,0.87,0.68,0.741,75
brute,1.326,10,41,1,1,0.115,0.547,0.379,51
typewriter,1.326,10,41,1,1,0.542,0.373,0.418,51
freedom,1.325,1287,4923,1,1,0.969,0.544,0.905,6210
technique,1.324,28,110,1,1,0.76,0.414,0.593,138
aloft,1.322,5,22,1,1,0.771,0.373,0.7,27
winged,1.322,11,45,1,1,0.646,0.469,0.519,56
disconcerting,1.322,5,22,1,1,0.106,0.549,0.269,27
holistic,1.322,11,45,1,1,0.67,0.348,0.547,56
sundown,1.322,11,45,1,1,0.812,0.276,0.445,56
sighting,1.322,5,22,1,1,0.582,0.56,0.627,27
doubtless,1.322,5,22,1,1,0.688,0.415,0.689,27
abominable,1.322,5,22,1,1,0.12,0.731,0.482,27
biologist,1.322,5,22,1,1,0.625,0.453,0.693,27
wartime,1.322,5,22,1,1,0.1,0.912,0.726,27
admiration,1.321,54,210,1,1,0.969,0.583,0.726,264
innovation,1.321,36,141,1,1,0.949,0.68,0.89,177
evanescence,1.32,18,72,1,1,0.527,0.519,0.458,90
metaphysical,1.319,12,49,1,1,0.63,0.573,0.686,61
regulate,1.319,12,49,1,1,0.51,0.275,0.481,61
weightless,1.319,12,49,1,1,0.46,0.426,0.375,61
unacknowledged,1.316,6,26,1,1,0.24,0.269,0.116,32
apparition,1.316,6,26,1,1,0.406,0.573,0.636,32
providence,1.316,13,53,1,1,0.603,0.337,0.755,66
drowsy,1.316,6,26,1,1,0.375,0.18,0.24,32
imprisonment,1.316,20,80,1,1,0.133,0.63,0.471,100
adobe,1.316,6,26,1,1,0.5,0.319,0.328,32
stimulate,1.316,13,53,1,1,0.792,0.798,0.754,66
heartily,1.316,6,26,1,1,0.927,0.531,0.664,32
cameraman,1.316,6,26,1,1,0.542,0.452,0.542,32
anointing,1.316,6,26,1,1,0.653,0.35,0.547,32
convoluted,1.316,6,26,1,1,0.323,0.614,0.433,32
plop,1.316,6,26,1,1,0.385,0.475,0.349,32
pulpit,1.316,6,26,1,1,0.469,0.449,0.517,32
distinctive,1.316,6,26,1,1,0.885,0.52,0.604,32
selflove,1.316,6,26,1,1,0.854,0.63,0.661,32
devote,1.316,27,107,1,1,0.802,0.49,0.642,134
axis,1.316,13,53,1,1,0.209,0.25,0.356,66
mahogany,1.316,6,26,1,1,0.602,0.225,0.393,32
thaw,1.316,6,26,1,1,0.438,0.321,0.327,32
hunchback,1.316,6,26,1,1,0.208,0.39,0.259,32
meadow,1.314,21,84,1,1,0.622,0.13,0.382,105
proportion,1.313,22,88,1,1,0.541,0.462,0.518,110
rebuild,1.312,61,239,1,1,0.656,0.557,0.519,300
physique,1.311,7,30,1,1,0.643,0.5,0.543,37
washroom,1.311,7,30,1,1,0.5,0.364,0.446,37
feigned,1.311,7,30,1,1,0.173,0.602,0.333,37
dispossessed,1.311,7,30,1,1,0.354,0.577,0.331,37
parable,1.311,7,30,1,1,0.479,0.357,0.525,37
reef,1.311,7,30,1,1,0.583,0.49,0.456,37
altar,1.311,23,92,1,1,0.724,0.387,0.635,115
basin,1.311,7,30,1,1,0.552,0.231,0.398,37
reciprocity,1.311,7,30,1,1,0.74,0.673,0.556,37
poetry,1.311,383,1488,1,1,0.697,0.235,0.629,1871
tolerance,1.31,65,255,1,1,0.875,0.206,0.649,320
excerpt,1.309,33,131,1,1,0.437,0.367,0.543,164
descending,1.309,16,65,1,1,0.219,0.493,0.25,81
advancement,1.308,8,34,1,1,0.776,0.65,0.839,42
clubhouse,1.308,8,34,1,1,0.694,0.571,0.493,42
indigo,1.306,18,73,1,1,0.514,0.365,0.473,91
calm,1.306,729,2843,1,1,0.875,0.1,0.282,3572
soothing,1.306,135,529,1,1,0.625,0.179,0.519,664
covert,1.305,9,38,1,1,0.5,0.57,0.508,47
rim,1.305,19,77,1,1,0.51,0.397,0.302,96
await,1.305,49,194,1,1,0.448,0.264,0.276,243
hypnotized,1.305,9,38,1,1,0.449,0.434,0.38,47
renew,1.304,30,120,1,1,0.868,0.481,0.713,150
descend,1.304,20,81,1,1,0.385,0.535,0.231,101
detach,1.303,42,167,1,1,0.357,0.625,0.45,209
brainstorm,1.302,10,42,1,1,0.794,0.784,0.636,52
clearing,1.302,44,175,1,1,0.68,0.333,0.509,219
adapt,1.301,93,367,1,1,0.74,0.355,0.551,460
tremble,1.301,23,93,1,1,0.177,0.878,0.388,116
accompaniment,1.301,11,46,1,1,0.74,0.479,0.695,57
nymph,1.301,11,46,1,1,0.542,0.529,0.472,57
grandeur,1.301,23,93,1,1,0.885,0.796,0.839,116
rosary,1.301,11,46,1,1,0.806,0.14,0.43,57
passage,1.3,60,238,1,1,0.429,0.314,0.37,298
brittle,1.299,12,50,1,1,0.276,0.49,0.272,62
unfold,1.299,38,152,1,1,0.612,0.51,0.52,190
peril,1.299,12,50,1,1,0.052,0.91,0.518,62
boon,1.297,13,54,1,1,0.878,0.294,0.642,67
quietly,1.297,308,1214,1,1,0.561,0.125,0.321,1522
banished,1.294,34,137,1,1,0.052,0.713,0.37,171
defined,1.294,106,421,1,1,0.67,0.214,0.646,527
rightly,1.293,35,141,1,1,0.74,0.471,0.782,176
vein,1.293,36,145,1,1,0.347,0.373,0.318,181
dominance,1.293,18,74,1,1,0.542,0.775,0.839,92
filth,1.292,57,228,1,1,0.194,0.592,0.319,285
cardinal,1.292,19,78,1,1,0.583,0.358,0.712,97
fragility,1.291,21,86,1,1,0.316,0.306,0.2,107
captivating,1.29,23,94,1,1,0.895,0.594,0.816,117
task,1.289,209,831,1,1,0.55,0.353,0.5,1040
sufficient,1.283,72,290,1,1,0.833,0.33,0.588,362
zone,1.283,483,1929,1,1,0.531,0.349,0.382,2412
refuge,1.281,193,774,1,1,0.64,0.238,0.481,967
starved,1.28,253,1014,1,1,0.097,0.689,0.219,1267
treadmill,1.279,15,63,1,1,0.459,0.636,0.436,78
unscathed,1.279,5,23,1,1,0.625,0.308,0.611,28
sovereign,1.279,14,59,1,1,0.698,0.5,0.885,73
peppermint,1.279,10,43,1,1,0.72,0.264,0.271,53
imitation,1.279,9,39,1,1,0.406,0.592,0.343,48
hindrance,1.279,8,35,1,1,0.135,0.545,0.473,43
coursing,1.279,5,23,1,1,0.542,0.472,0.546,28
liberated,1.279,28,115,1,1,0.78,0.63,0.683,143
belongings,1.279,19,79,1,1,0.592,0.38,0.75,98
unorthodox,1.279,5,23,1,1,0.34,0.48,0.441,28
sacrament,1.279,7,31,1,1,0.69,0.316,0.7,38
enthralled,1.279,5,23,1,1,0.745,0.602,0.615,28
inaccessible,1.279,13,55,1,1,0.083,0.585,0.446,68
improbable,1.279,5,23,1,1,0.097,0.412,0.439,28
retaliate,1.279,5,23,1,1,0.111,0.812,0.595,28
pointer,1.279,5,23,1,1,0.583,0.382,0.5,28
resourceful,1.279,9,39,1,1,0.906,0.704,0.886,48
nomadic,1.279,10,43,1,1,0.427,0.519,0.422,53
intrinsically,1.279,8,35,1,1,0.459,0.382,0.538,43
barred,1.279,7,31,1,1,0.143,0.741,0.535,38
compel,1.279,7,31,1,1,0.2,0.847,0.625,38
desertion,1.279,6,27,1,1,0.122,0.63,0.289,33
plowing,1.279,6,27,1,1,0.562,0.531,0.518,33
fragment,1.279,12,51,1,1,0.211,0.316,0.429,63
hopper,1.279,51,207,1,1,0.396,0.491,0.442,258
verily,1.279,9,39,1,1,0.713,0.351,0.585,48
ablaze,1.279,6,27,1,1,0.24,0.847,0.525,33
squint,1.279,6,27,1,1,0.385,0.461,0.452,33
sift,1.279,5,23,1,1,0.542,0.412,0.461,28
ogre,1.279,15,63,1,1,0.135,0.698,0.51,78
inhabited,1.279,11,47,1,1,0.667,0.361,0.51,58
adventurer,1.279,13,55,1,1,0.781,0.839,0.868,68
healer,1.279,47,191,1,1,0.863,0.378,0.741,238
unchanged,1.279,6,27,1,1,0.49,0.204,0.237,33
bead,1.279,6,27,1,1,0.592,0.388,0.381,33
parachute,1.279,9,39,1,1,0.562,0.787,0.564,48
reprieve,1.279,18,75,1,1,0.531,0.471,0.574,93
monsieur,1.279,7,31,1,1,0.552,0.34,0.623,38
comfort,1.279,2528,10122,1,1,0.863,0.231,0.67,12650
creation,1.275,163,658,1,1,0.927,0.575,0.868,821
pounding,1.274,42,172,1,1,0.333,0.843,0.731,214
refreshing,1.273,159,643,1,1,0.936,0.52,0.571,802
adoration,1.272,33,136,1,1,0.885,0.699,0.708,169
repent,1.272,32,132,1,1,0.449,0.422,0.386,164
bloom,1.271,171,693,1,1,0.816,0.453,0.587,864
examine,1.271,27,112,1,1,0.615,0.623,0.786,139
abyss,1.27,227,920,1,1,0.353,0.725,0.296,1147
oath,1.268,20,84,1,1,0.543,0.615,0.824,104
condemn,1.266,36,149,1,1,0.102,0.793,0.625,185
corps,1.266,17,72,1,1,0.551,0.453,0.483,89
sunken,1.265,16,68,1,1,0.103,0.476,0.173,84
surrender,1.265,100,409,1,1,0.115,0.396,0.186,509
observation,1.264,65,267,1,1,0.633,0.433,0.667,332
religion,1.264,279,1137,1,1,0.646,0.32,0.755,1416
raising,1.263,214,873,1,1,0.735,0.519,0.643,1087
inheritance,1.263,14,60,1,1,0.9,0.565,0.798,74
outgoing,1.262,83,341,1,1,0.65,0.472,0.538,424
stall,1.262,41,170,1,1,0.37,0.245,0.292,211
domain,1.26,25,105,1,1,0.573,0.549,0.828,130
unsung,1.26,12,52,1,1,0.296,0.33,0.314,64
skyline,1.26,12,52,1,1,0.592,0.412,0.662,64
planner,1.26,12,52,1,1,0.76,0.469,0.868,64
incarceration,1.259,11,48,1,1,0.1,0.8,0.397,59
barefoot,1.259,11,48,1,1,0.445,0.373,0.241,59
skewed,1.259,11,48,1,1,0.34,0.48,0.361,59
deceptive,1.257,10,44,1,1,0.027,0.605,0.294,54
contradictory,1.257,21,89,1,1,0.365,0.651,0.421,110
loosen,1.257,10,44,1,1,0.487,0.337,0.218,54
airs,1.257,10,44,1,1,0.583,0.196,0.37,54
buff,1.257,32,134,1,1,0.561,0.425,0.361,166
cave,1.255,481,1975,1,1,0.459,0.333,0.38,2456
unrest,1.255,9,40,1,1,0.102,0.577,0.231,49
gale,1.255,9,40,1,1,0.271,0.691,0.611,49
famously,1.255,9,40,1,1,0.856,0.765,0.787,49
planetary,1.255,9,40,1,1,0.604,0.5,0.62,49
willful,1.255,9,40,1,1,0.557,0.719,0.642,49
coil,1.255,9,40,1,1,0.448,0.343,0.298,49
pesky,1.255,9,40,1,1,0.25,0.76,0.431,49
ancient,1.254,146,602,1,1,0.42,0.217,0.439,748
ditto,1.253,27,114,1,1,0.449,0.418,0.411,141
sage,1.253,45,188,1,1,0.781,0.327,0.693,233
archangel,1.252,8,36,1,1,0.837,0.5,0.708,44
horizon,1.251,129,534,1,1,0.729,0.284,0.59,663
dialogue,1.25,101,419,1,1,0.599,0.441,0.625,520
clockwork,1.25,16,69,1,1,0.49,0.373,0.528,85
pry,1.25,16,69,1,1,0.406,0.482,0.5,85
doorway,1.25,24,102,1,1,0.573,0.304,0.496,126
unseen,1.25,73,304,1,1,0.427,0.351,0.421,377
plateau,1.249,7,32,1,1,0.611,0.316,0.4,39
forceful,1.249,7,32,1,1,0.533,0.673,0.898,39
origin,1.248,61,255,1,1,0.729,0.435,0.591,316
recite,1.247,22,94,1,1,0.688,0.398,0.453,116
grounded,1.247,75,313,1,1,0.531,0.601,0.509,388
framework,1.247,14,61,1,1,0.459,0.33,0.36,75
communal,1.247,44,185,1,1,0.592,0.321,0.556,229
imaginative,1.246,21,90,1,1,0.78,0.541,0.593,111
deer,1.246,72,301,1,1,0.583,0.375,0.292,373
strength,1.246,1209,5005,1,1,0.802,0.682,0.858,6214
fungus,1.244,6,28,1,1,0.388,0.337,0.173,34
idealistic,1.244,13,57,1,1,0.812,0.469,0.755,70
preface,1.244,6,28,1,1,0.459,0.375,0.557,34
projector,1.244,6,28,1,1,0.573,0.491,0.711,34
acquisition,1.244,6,28,1,1,0.698,0.509,0.736,34
unfettered,1.244,6,28,1,1,0.569,0.65,0.586,34
reverend,1.244,6,28,1,1,0.65,0.337,0.576,34
reverting,1.244,6,28,1,1,0.562,0.385,0.544,34
consciousness,1.244,125,521,1,1,0.84,0.483,0.755,646
interval,1.244,6,28,1,1,0.51,0.284,0.4,34
crystal,1.242,110,460,1,1,0.618,0.27,0.508,570
spotlight,1.241,95,398,1,1,0.688,0.353,0.519,493
symbolism,1.24,24,103,1,1,0.688,0.347,0.64,127
solid,1.239,353,1473,1,1,0.667,0.304,0.763,1826
standstill,1.239,5,24,1,1,0.441,0.203,0.5,29
quail,1.239,5,24,1,1,0.5,0.318,0.287,29
invasive,1.239,11,49,1,1,0.194,0.73,0.598,60
inexpensive,1.239,5,24,1,1,0.694,0.414,0.26,29
esteemed,1.239,5,24,1,1,0.694,0.418,0.531,29
opiate,1.239,5,24,1,1,0.281,0.594,0.598,29
hawking,1.239,5,24,1,1,0.521,0.509,0.491,29
mount,1.239,47,199,1,1,0.5,0.292,0.348,246
insistence,1.239,5,24,1,1,0.418,0.704,0.645,29
empirical,1.239,5,24,1,1,0.5,0.51,0.574,29
syndicate,1.239,5,24,1,1,0.439,0.491,0.673,29
concealed,1.239,11,49,1,1,0.344,0.363,0.352,60
unwise,1.239,5,24,1,1,0.141,0.61,0.304,29
undoing,1.239,11,49,1,1,0.219,0.452,0.298,60
epilogue,1.239,11,49,1,1,0.582,0.353,0.466,60
yew,1.239,11,49,1,1,0.312,0.207,0.311,60
runway,1.239,11,49,1,1,0.585,0.373,0.406,60
debauchery,1.239,5,24,1,1,0.354,0.901,0.5,29
exile,1.237,115,483,1,1,0.184,0.63,0.483,598
hustle,1.237,103,433,1,1,0.406,0.661,0.427,536
chastity,1.236,16,70,1,1,0.469,0.392,0.509,86
intermittent,1.235,10,45,1,1,0.337,0.565,0.436,55
erect,1.235,10,45,1,1,0.643,0.885,0.627,55
assorted,1.235,10,45,1,1,0.602,0.46,0.472,55
gulp,1.235,10,45,1,1,0.551,0.66,0.409,55
patio,1.235,21,91,1,1,0.562,0.245,0.402,112
classical,1.234,37,158,1,1,0.643,0.198,0.536,195
ugliness,1.234,53,225,1,1,0.094,0.407,0.267,278
integrate,1.234,15,66,1,1,0.729,0.39,0.7,81
tent,1.232,56,238,1,1,0.51,0.275,0.333,294
chirping,1.232,30,129,1,1,0.5,0.463,0.36,159
cusp,1.231,9,41,1,1,0.667,0.71,0.7,50
naval,1.231,9,41,1,1,0.542,0.449,0.679,50
sufficiently,1.231,14,62,1,1,0.776,0.367,0.714,76
sensitivity,1.229,28,121,1,1,0.75,0.417,0.395,149
varied,1.228,18,79,1,1,0.604,0.701,0.472,97
palace,1.228,112,475,1,1,0.878,0.51,0.804,587
dispel,1.227,13,58,1,1,0.388,0.402,0.411,71
impose,1.227,22,96,1,1,0.503,0.721,0.745,118
sag,1.227,22,96,1,1,0.153,0.578,0.445,118
mechanical,1.225,17,75,1,1,0.479,0.569,0.564,92
homage,1.225,17,75,1,1,0.833,0.56,0.737,92
infiltrate,1.225,8,37,1,1,0.408,0.745,0.587,45
intangible,1.225,8,37,1,1,0.525,0.48,0.473,45
pendulum,1.225,8,37,1,1,0.542,0.368,0.434,45
socialite,1.225,8,37,1,1,0.684,0.668,0.57,45
reborn,1.225,39,168,1,1,0.802,0.618,0.737,207
occasional,1.225,132,561,1,1,0.49,0.298,0.387,693
bounty,1.224,21,92,1,1,0.76,0.755,0.833,113
carriage,1.224,21,92,1,1,0.65,0.538,0.491,113
dwell,1.224,148,629,1,1,0.698,0.245,0.611,777
abrupt,1.223,12,54,1,1,0.271,0.819,0.545,66
tumble,1.223,12,54,1,1,0.276,0.556,0.272,66
architecture,1.223,25,109,1,1,0.82,0.39,0.694,134
glittering,1.223,12,54,1,1,0.86,0.588,0.818,66
affirm,1.222,16,71,1,1,0.745,0.509,0.731,87
chosen,1.222,317,1346,1,1,0.865,0.449,0.833,1663
stimulating,1.222,20,88,1,1,0.74,0.804,0.809,108
duke,1.22,52,224,1,1,0.667,0.44,0.669,276
enforce,1.219,11,50,1,1,0.583,0.644,0.836,61
resounding,1.219,7,33,1,1,0.49,0.708,0.596,40
errand,1.219,7,33,1,1,0.385,0.519,0.482,40
coveted,1.219,7,33,1,1,0.661,0.73,0.625,40
makeshift,1.219,7,33,1,1,0.479,0.611,0.389,40
exasperated,1.219,7,33,1,1,0.229,0.816,0.377,40
ebb,1.219,11,50,1,1,0.354,0.451,0.404,61
renowned,1.219,11,50,1,1,0.844,0.481,0.697,61
bordering,1.219,7,33,1,1,0.643,0.382,0.438,40
distinction,1.217,38,165,1,1,0.584,0.571,0.75,203
evolution,1.217,96,412,1,1,0.781,0.657,0.854,508
inhumane,1.216,22,97,1,1,0.104,0.587,0.402,119
reside,1.216,41,178,1,1,0.451,0.44,0.455,219
counterpart,1.215,14,63,1,1,0.448,0.608,0.577,77
vibration,1.214,21,93,1,1,0.583,0.657,0.528,114
ordained,1.214,10,46,1,1,0.735,0.409,0.731,56
flows,1.214,54,234,1,1,0.571,0.48,0.434,288
contradict,1.214,10,46,1,1,0.16,0.598,0.482,56
maximize,1.214,10,46,1,1,0.823,0.765,0.792,56
behold,1.213,57,247,1,1,0.61,0.284,0.449,304
nourish,1.212,56,243,1,1,0.878,0.46,0.639,299
crossword,1.21,6,29,1,1,0.611,0.423,0.455,35
unveil,1.21,6,29,1,1,0.439,0.442,0.562,35
subdue,1.21,6,29,1,1,0.275,0.64,0.784,35
monarchy,1.21,6,29,1,1,0.45,0.557,0.87,35
residual,1.21,6,29,1,1,0.448,0.288,0.327,35
resolute,1.21,6,29,1,1,0.771,0.51,0.712,35
jolt,1.21,6,29,1,1,0.365,0.708,0.358,35
frenzy,1.21,13,59,1,1,0.61,0.965,0.682,72
seals,1.21,13,59,1,1,0.412,0.241,0.402,72
eyesight,1.21,6,29,1,1,0.75,0.226,0.343,35
elect,1.21,13,59,1,1,0.667,0.554,0.661,72
total,1.21,507,2177,1,1,0.771,0.286,0.714,2684
trees,1.209,466,2003,1,1,0.653,0.137,0.537,2469
consolation,1.209,71,308,1,1,0.408,0.25,0.304,379
analyze,1.209,33,145,1,1,0.667,0.462,0.71,178
keeper,1.208,87,377,1,1,0.612,0.457,0.773,464
abundant,1.208,26,115,1,1,0.958,0.59,0.76,141
authenticity,1.208,26,115,1,1,0.67,0.548,0.845,141
aide,1.207,9,42,1,1,0.724,0.342,0.434,51
pane,1.207,9,42,1,1,0.385,0.25,0.444,51
grunt,1.207,9,42,1,1,0.286,0.798,0.392,51
reread,1.207,52,227,1,1,0.448,0.377,0.492,279
conversion,1.206,22,98,1,1,0.48,0.605,0.736,120
hinder,1.206,22,98,1,1,0.276,0.537,0.47,120
pause,1.206,104,451,1,1,0.429,0.188,0.264,555
humbly,1.205,12,55,1,1,0.771,0.194,0.37,67
startled,1.205,12,55,1,1,0.333,0.865,0.526,67
weakness,1.205,289,1249,1,1,0.088,0.37,0.125,1538
exploration,1.204,72,314,1,1,0.594,0.65,0.773,386
invisibility,1.203,21,94,1,1,0.438,0.461,0.382,115
invaluable,1.203,24,107,1,1,0.74,0.5,0.745,131
respecting,1.202,33,146,1,1,0.837,0.321,0.72,179
space,1.201,2972,12867,1,1,0.8,0.317,0.573,15839
affirmation,1.199,41,181,1,1,0.75,0.5,0.689,222
inaugural,1.199,5,25,1,1,0.684,0.567,0.608,30
spectator,1.199,8,38,1,1,0.694,0.56,0.667,46
darkened,1.199,35,155,1,1,0.135,0.44,0.452,190
panacea,1.199,5,25,1,1,0.42,0.427,0.613,30
disobedience,1.199,5,25,1,1,0.051,0.868,0.369,30
earnings,1.199,5,25,1,1,0.938,0.65,0.875,30
thump,1.199,8,38,1,1,0.28,0.792,0.608,46
sensor,1.199,5,25,1,1,0.571,0.377,0.542,30
tinker,1.199,8,38,1,1,0.396,0.528,0.275,46
cappuccino,1.199,5,25,1,1,0.792,0.279,0.384,30
yank,1.199,5,25,1,1,0.271,0.63,0.538,30
retract,1.199,8,38,1,1,0.316,0.443,0.358,46
align,1.197,31,138,1,1,0.656,0.364,0.627,169
euphoric,1.196,22,99,1,1,0.745,0.904,0.588,121
commence,1.196,19,86,1,1,0.76,0.585,0.741,105
tendency,1.195,70,308,1,1,0.684,0.5,0.675,378
imagery,1.194,30,134,1,1,0.653,0.327,0.39,164
dwelling,1.194,86,378,1,1,0.765,0.33,0.481,464
silent,1.194,927,4042,1,1,0.469,0.125,0.28,4969
output,1.194,13,60,1,1,0.604,0.389,0.434,73
liberating,1.194,97,426,1,1,0.915,0.62,0.745,523
hillside,1.194,13,60,1,1,0.625,0.292,0.458,73
rejoin,1.192,10,47,1,1,0.655,0.548,0.556,57
sermon,1.192,29,130,1,1,0.417,0.507,0.615,159
shrine,1.192,29,130,1,1,0.802,0.255,0.574,159
elevated,1.191,18,82,1,1,0.704,0.594,0.62,100
spacious,1.191,18,82,1,1,0.88,0.365,0.557,100
heathen,1.19,7,34,1,1,0.194,0.529,0.491,41
gradual,1.19,7,34,1,1,0.571,0.35,0.509,41
shoveling,1.19,7,34,1,1,0.265,0.62,0.537,41
inaction,1.19,7,34,1,1,0.323,0.225,0.325,41
disparity,1.19,7,34,1,1,0.208,0.482,0.361,41
barring,1.19,7,34,1,1,0.292,0.67,0.42,41
burrow,1.19,7,34,1,1,0.438,0.28,0.355,41
quota,1.19,7,34,1,1,0.427,0.41,0.4,41
ascension,1.19,15,69,1,1,0.765,0.72,0.714,84
canopy,1.19,7,34,1,1,0.615,0.264,0.398,41
muddy,1.19,15,69,1,1,0.292,0.4,0.283,84
convey,1.189,73,323,1,1,0.719,0.633,0.708,396
veil,1.189,41,183,1,1,0.5,0.235,0.415,224
outer,1.188,93,411,1,1,0.552,0.471,0.456,504
ode,1.187,84,372,1,1,0.604,0.269,0.519,456
evolve,1.186,50,223,1,1,0.655,0.692,0.896,273
pine,1.186,60,267,1,1,0.583,0.225,0.312,327
whittle,1.184,4,21,1,1,0.347,0.451,0.427,25
banishment,1.184,4,21,1,1,0.16,0.775,0.298,25
quotation,1.184,4,21,1,1,0.796,0.59,0.461,25
evasion,1.184,4,21,1,1,0.229,0.51,0.418,25
agate,1.184,4,21,1,1,0.54,0.377,0.483,25
copious,1.184,14,65,1,1,0.427,0.462,0.527,79
gratuitous,1.184,4,21,1,1,0.735,0.65,0.452,25
beverage,1.184,19,87,1,1,0.635,0.49,0.389,106
unresponsive,1.184,4,21,1,1,0.108,0.282,0.244,25
cooperating,1.184,4,21,1,1,0.76,0.39,0.693,25
forte,1.184,14,65,1,1,0.829,0.737,0.8,79
courthouse,1.184,4,21,1,1,0.571,0.503,0.818,25
alibi,1.184,4,21,1,1,0.396,0.528,0.556,25
vanquish,1.184,4,21,1,1,0.708,0.76,0.804,25
ruffle,1.184,4,21,1,1,0.443,0.561,0.518,25
psychotherapy,1.184,4,21,1,1,0.396,0.547,0.651,25
dunce,1.184,4,21,1,1,0.188,0.327,0.146,25
knotted,1.184,4,21,1,1,0.226,0.412,0.294,25
disengagement,1.184,4,21,1,1,0.327,0.373,0.395,25
thistle,1.184,4,21,1,1,0.427,0.423,0.357,25
microcosm,1.184,4,21,1,1,0.5,0.5,0.52,25
tariff,1.184,4,21,1,1,0.459,0.402,0.491,25
beset,1.184,4,21,1,1,0.385,0.717,0.317,25
elk,1.184,9,43,1,1,0.439,0.337,0.34,52
softening,1.184,4,21,1,1,0.7,0.255,0.361,25
swordsman,1.184,4,21,1,1,0.395,0.857,0.696,25
implement,1.184,14,65,1,1,0.72,0.573,0.792,79
transfixed,1.184,4,21,1,1,0.427,0.66,0.528,25
determination,1.182,53,237,1,1,0.776,0.725,0.795,290
newfound,1.182,21,96,1,1,0.745,0.741,0.52,117
retribution,1.18,11,52,1,1,0.625,0.49,0.708,63
infused,1.18,11,52,1,1,0.385,0.473,0.546,63
lens,1.18,35,158,1,1,0.42,0.245,0.472,193
exude,1.18,11,52,1,1,0.375,0.519,0.411,63
ennui,1.18,23,105,1,1,0.406,0.461,0.316,128
infinity,1.18,73,326,1,1,0.516,0.459,0.805,399
materials,1.18,30,136,1,1,0.633,0.361,0.473,166
liberty,1.178,60,269,1,1,0.938,0.579,0.836,329
puny,1.178,6,30,1,1,0.312,0.324,0.135,36
dotted,1.178,6,30,1,1,0.48,0.347,0.426,36
bluebird,1.178,6,30,1,1,0.573,0.35,0.45,36
cornerstone,1.178,6,30,1,1,0.55,0.388,0.596,36
silhouette,1.178,27,123,1,1,0.582,0.41,0.288,150
huntress,1.178,6,30,1,1,0.357,0.717,0.765,36
compressed,1.178,6,30,1,1,0.323,0.396,0.388,36
dell,1.178,6,30,1,1,0.458,0.38,0.453,36
lush,1.176,47,212,1,1,0.74,0.783,0.833,259
forge,1.176,31,141,1,1,0.52,0.424,0.686,172
revival,1.175,24,110,1,1,0.823,0.664,0.597,134
conquering,1.174,17,79,1,1,0.76,0.873,0.936,96
sans,1.174,44,199,1,1,0.459,0.294,0.246,243
abstain,1.174,8,39,1,1,0.385,0.385,0.427,47
energy,1.174,1599,7113,1,1,0.944,0.725,0.868,8712
sandy,1.173,37,168,1,1,0.406,0.265,0.296,205
fresh,1.173,394,1756,1,1,0.908,0.292,0.419,2150
backdrop,1.173,19,88,1,1,0.32,0.309,0.444,107
sociable,1.173,79,355,1,1,0.854,0.459,0.627,434
icy,1.172,52,235,1,1,0.684,0.375,0.345,287
fortunes,1.172,10,48,1,1,0.824,0.706,0.789,58
notably,1.172,10,48,1,1,0.792,0.533,0.689,58
kayak,1.17,12,57,1,1,0.592,0.6,0.364,69
imprisoned,1.17,51,231,1,1,0.032,0.717,0.302,282
depart,1.17,25,115,1,1,0.398,0.48,0.444,140
seduction,1.17,12,57,1,1,0.51,0.891,0.618,69
conformity,1.169,14,66,1,1,0.645,0.363,0.579,80
shudder,1.169,14,66,1,1,0.344,0.791,0.559,80
embark,1.167,20,93,1,1,0.541,0.55,0.619,113
painting,1.166,234,1052,1,1,0.792,0.324,0.333,1286
roaring,1.166,26,120,1,1,0.449,0.817,0.634,146
desire,1.166,829,3719,1,1,0.896,0.692,0.647,4548
learning,1.165,949,4262,1,1,0.833,0.588,0.574,5211
buildings,1.164,54,246,1,1,0.582,0.38,0.552,300
grass,1.164,170,767,1,1,0.604,0.164,0.333,937
headphones,1.163,169,763,1,1,0.6,0.357,0.336,932
senses,1.163,106,480,1,1,0.74,0.461,0.693,586
discomfort,1.162,61,278,1,1,0.153,0.719,0.272,339
daemon,1.162,5,26,1,1,0.333,0.49,0.5,31
occult,1.162,7,35,1,1,0.292,0.382,0.406,42
platter,1.162,7,35,1,1,0.686,0.245,0.219,42
housekeeper,1.162,5,26,1,1,0.694,0.279,0.52,31
interfere,1.162,19,89,1,1,0.323,0.714,0.471,108
apparatus,1.162,5,26,1,1,0.375,0.353,0.377,31
arch,1.162,23,107,1,1,0.5,0.354,0.468,130
barbershop,1.162,5,26,1,1,0.597,0.441,0.382,31
disintegrate,1.162,5,26,1,1,0.143,0.66,0.364,31
retention,1.162,5,26,1,1,0.344,0.49,0.558,31
soften,1.162,15,71,1,1,0.694,0.194,0.392,86
terrace,1.162,11,53,1,1,0.615,0.269,0.411,64
tenure,1.162,7,35,1,1,0.615,0.472,0.611,42
famished,1.162,5,26,1,1,0.177,0.654,0.282,31
intensity,1.162,45,206,1,1,0.622,0.93,0.952,251
curt,1.162,5,26,1,1,0.245,0.61,0.452,31
voluntarily,1.162,23,107,1,1,0.847,0.46,0.527,130
stunning,1.161,118,535,1,1,0.888,0.673,0.858,653
knowledge,1.16,376,1698,1,1,0.847,0.43,0.896,2074
minor,1.159,120,545,1,1,0.25,0.235,0.175,665
grounds,1.159,38,175,1,1,0.667,0.5,0.598,213
cape,1.158,53,243,1,1,0.531,0.235,0.357,296
participation,1.157,24,112,1,1,0.781,0.7,0.702,136
odyssey,1.157,22,103,1,1,0.622,0.692,0.71,125
excel,1.157,22,103,1,1,0.561,0.363,0.466,125
mat,1.156,37,171,1,1,0.459,0.221,0.304,208
graceful,1.156,18,85,1,1,0.906,0.51,0.655,103
cloak,1.156,37,171,1,1,0.469,0.188,0.333,208
imam,1.156,35,162,1,1,0.527,0.337,0.539,197
difficulty,1.155,88,402,1,1,0.079,0.74,0.368,490
gardening,1.155,33,153,1,1,0.854,0.333,0.361,186
seaside,1.155,16,76,1,1,0.887,0.52,0.508,92
scented,1.155,16,76,1,1,0.865,0.509,0.431,92
resolve,1.154,74,339,1,1,0.71,0.472,0.75,413
fuse,1.154,14,67,1,1,0.373,0.565,0.574,81
brief,1.153,162,739,1,1,0.469,0.3,0.279,901
slumber,1.152,45,208,1,1,0.592,0.191,0.426,253
persuasion,1.152,10,49,1,1,0.612,0.67,0.537,59
chopping,1.152,10,49,1,1,0.56,0.625,0.362,59
impromptu,1.152,10,49,1,1,0.541,0.729,0.415,59
retiring,1.151,19,90,1,1,0.408,0.376,0.214,109
jungle,1.15,106,486,1,1,0.5,0.51,0.481,592
unity,1.15,75,345,1,1,0.837,0.288,0.658,420
assert,1.149,8,40,1,1,0.75,0.619,0.809,48
marvelous,1.149,26,122,1,1,0.948,0.637,0.778,148
hedonism,1.149,8,40,1,1,0.51,0.5,0.608,48
ferocious,1.149,8,40,1,1,0.167,0.915,0.776,48
folklore,1.149,8,40,1,1,0.755,0.585,0.449,48
seagull,1.149,17,81,1,1,0.635,0.245,0.314,98
curriculum,1.149,8,40,1,1,0.708,0.306,0.62,48
alternating,1.149,8,40,1,1,0.48,0.494,0.542,48
arctic,1.149,69,318,1,1,0.615,0.352,0.546,387
reward,1.148,125,574,1,1,0.948,0.694,0.783,699
rare,1.148,389,1779,1,1,0.396,0.413,0.236,2168
heavenly,1.146,78,360,1,1,0.844,0.452,0.712,438
burden,1.146,502,2298,1,1,0.367,0.583,0.697,2800
macro,1.146,6,31,1,1,0.552,0.469,0.647,37
coarse,1.146,6,31,1,1,0.333,0.481,0.481,37
spacecraft,1.146,6,31,1,1,0.646,0.698,0.68,37
sonata,1.146,6,31,1,1,0.643,0.406,0.425,37
implore,1.146,6,31,1,1,0.396,0.65,0.377,37
correspond,1.146,6,31,1,1,0.71,0.452,0.545,37
sunburn,1.146,6,31,1,1,0.061,0.755,0.447,37
pastry,1.146,6,31,1,1,0.87,0.407,0.419,37
enlarge,1.146,6,31,1,1,0.735,0.606,0.688,37
handbook,1.146,6,31,1,1,0.6,0.224,0.567,37
urban,1.144,127,585,1,1,0.561,0.528,0.644,712
somber,1.144,42,196,1,1,0.184,0.5,0.38,238
flora,1.143,11,54,1,1,0.833,0.324,0.567,65
prejudice,1.143,45,210,1,1,0.11,0.613,0.407,255
abiding,1.142,16,77,1,1,0.796,0.327,0.75,93
simmering,1.14,4,22,1,1,0.382,0.613,0.412,26
submission,1.14,24,114,1,1,0.531,0.58,0.633,138
prehistoric,1.14,4,22,1,1,0.417,0.317,0.419,26
undermined,1.14,4,22,1,1,0.365,0.409,0.394,26
nether,1.14,4,22,1,1,0.24,0.265,0.259,26
inhumanity,1.14,4,22,1,1,0.143,0.54,0.405,26
spruce,1.14,4,22,1,1,0.604,0.288,0.38,26
astronomical,1.14,4,22,1,1,0.6,0.632,0.726,26
distinguished,1.14,9,45,1,1,0.823,0.593,0.759,54
redirect,1.14,9,45,1,1,0.469,0.36,0.648,54
adage,1.14,4,22,1,1,0.517,0.415,0.566,26
antagonistic,1.14,4,22,1,1,0.296,0.604,0.565,26
corporal,1.14,4,22,1,1,0.582,0.49,0.596,26
substantive,1.14,4,22,1,1,0.5,0.35,0.455,26
marketplace,1.14,9,45,1,1,0.698,0.42,0.525,54
delegate,1.14,4,22,1,1,0.612,0.491,0.658,26
theatrical,1.14,4,22,1,1,0.72,0.69,0.546,26
skim,1.14,4,22,1,1,0.418,0.328,0.322,26
detract,1.14,4,22,1,1,0.344,0.438,0.368,26
barter,1.14,4,22,1,1,0.465,0.559,0.596,26
hamlet,1.14,14,68,1,1,0.573,0.27,0.397,82
privy,1.14,4,22,1,1,0.583,0.481,0.648,26
shutter,1.14,4,22,1,1,0.191,0.38,0.482,26
microscopic,1.14,4,22,1,1,0.36,0.327,0.433,26
exceed,1.14,9,45,1,1,0.5,0.827,0.586,54
exquisitely,1.14,4,22,1,1,0.849,0.728,0.723,26
prize,1.139,97,450,1,1,0.885,0.763,0.67,547
spirits,1.139,223,1030,1,1,0.583,0.847,0.545,1253
utter,1.137,256,1184,1,1,0.531,0.422,0.549,1440
circuit,1.137,17,82,1,1,0.586,0.461,0.707,99
uphold,1.137,17,82,1,1,0.698,0.321,0.561,99
empathic,1.136,12,59,1,1,0.76,0.57,0.558,71
inter,1.136,12,59,1,1,0.51,0.375,0.466,71
charcoal,1.136,12,59,1,1,0.302,0.186,0.342,71
years,1.136,9708,44841,1,1,0.653,0.33,0.508,54549
biblical,1.136,20,96,1,1,0.635,0.304,0.712,116
restlessness,1.135,28,133,1,1,0.083,0.794,0.397,161
jest,1.134,23,110,1,1,0.52,0.736,0.222,133
array,1.134,15,73,1,1,0.521,0.396,0.568,88
carnal,1.134,7,36,1,1,0.417,0.679,0.421,43
scurry,1.134,7,36,1,1,0.398,0.647,0.509,43
mineral,1.134,7,36,1,1,0.519,0.287,0.605,43
conjunction,1.134,7,36,1,1,0.52,0.472,0.509,43
imprint,1.134,7,36,1,1,0.615,0.574,0.685,43
arrival,1.134,50,235,1,1,0.678,0.51,0.474,285
pastel,1.133,18,87,1,1,0.719,0.357,0.367,105
exhibition,1.133,48,226,1,1,0.698,0.59,0.531,274
prophetic,1.132,10,50,1,1,0.688,0.586,0.796,60
orthodox,1.132,10,50,1,1,0.388,0.471,0.647,60
helmet,1.132,21,101,1,1,0.573,0.327,0.402,122
clouded,1.132,21,101,1,1,0.24,0.213,0.302,122
wellness,1.131,35,166,1,1,0.969,0.441,0.73,201
nothingness,1.131,96,449,1,1,0.204,0.08,0.161,545
detest,1.13,13,64,1,1,0.083,0.8,0.492,77
breather,1.13,13,64,1,1,0.624,0.471,0.388,77
sailing,1.13,50,236,1,1,0.667,0.52,0.5,286
arise,1.129,36,171,1,1,0.75,0.582,0.725,207
soaring,1.129,19,92,1,1,0.708,0.704,0.65,111
stroll,1.128,57,269,1,1,0.745,0.415,0.444,326
operate,1.127,37,176,1,1,0.582,0.69,0.691,213
achievement,1.127,78,367,1,1,0.896,0.808,0.759,445
magic,1.127,550,2566,1,1,0.868,0.663,0.578,3116
extravagant,1.125,11,55,1,1,0.72,0.763,0.812,66
entrapment,1.125,5,27,1,1,0.177,0.604,0.441,32
prolong,1.125,8,41,1,1,0.573,0.567,0.535,49
berserk,1.125,8,41,1,1,0.398,0.556,0.48,49
dubious,1.125,8,41,1,1,0.414,0.48,0.198,49
origami,1.125,5,27,1,1,0.684,0.276,0.294,32
confrontation,1.125,20,97,1,1,0.177,0.87,0.658,117
storyteller,1.125,8,41,1,1,0.73,0.357,0.462,49
pollute,1.125,5,27,1,1,0.173,0.66,0.48,32
wavering,1.125,5,27,1,1,0.375,0.43,0.384,32
molding,1.125,5,27,1,1,0.552,0.308,0.546,32
behemoth,1.125,5,27,1,1,0.583,0.781,0.853,32
stature,1.125,8,41,1,1,0.47,0.353,0.664,49
capitals,1.125,5,27,1,1,0.755,0.5,0.655,32
ahoy,1.125,5,27,1,1,0.5,0.497,0.38,32
caveat,1.125,5,27,1,1,0.344,0.629,0.484,32
adept,1.125,8,41,1,1,0.594,0.539,0.789,49
zenith,1.125,5,27,1,1,0.582,0.387,0.589,32
outskirts,1.125,20,97,1,1,0.474,0.519,0.312,117
boisterous,1.125,8,41,1,1,0.385,0.806,0.565,49
trace,1.124,69,326,1,1,0.573,0.346,0.483,395
device,1.124,60,284,1,1,0.562,0.404,0.627,344
perceive,1.124,51,242,1,1,0.653,0.49,0.655,293
inclined,1.124,39,186,1,1,0.469,0.347,0.402,225
vocabulary,1.123,36,172,1,1,0.53,0.247,0.585,208
cease,1.123,55,261,1,1,0.388,0.25,0.42,316
primal,1.122,24,116,1,1,0.55,0.407,0.482,140
malice,1.122,21,102,1,1,0.073,0.811,0.492,123
protector,1.122,37,177,1,1,0.779,0.36,0.824,214
pour,1.121,183,861,1,1,0.448,0.57,0.375,1044
beginnings,1.121,34,163,1,1,0.837,0.527,0.6,197
whirlwind,1.121,15,74,1,1,0.417,0.915,0.67,89
greater,1.121,342,1607,1,1,0.755,0.519,0.796,1949
prospect,1.121,44,210,1,1,0.733,0.442,0.698,254
book,1.12,2469,11587,1,1,0.802,0.21,0.606,14056
atmospheric,1.119,22,107,1,1,0.531,0.42,0.594,129
pleasing,1.119,52,248,1,1,0.917,0.449,0.788,300
confront,1.119,62,295,1,1,0.281,0.76,0.746,357
perceptive,1.118,9,46,1,1,0.745,0.5,0.741,55
precisely,1.118,46,220,1,1,0.816,0.388,0.714,266
hue,1.116,23,112,1,1,0.507,0.416,0.417,135
togetherness,1.116,85,404,1,1,0.906,0.36,0.635,489
eerie,1.116,61,291,1,1,0.265,0.771,0.442,352
innocence,1.116,75,357,1,1,0.802,0.26,0.307,432
collision,1.115,6,32,1,1,0.245,0.848,0.585,38
doting,1.115,6,32,1,1,0.888,0.415,0.426,38
inventor,1.115,6,32,1,1,0.781,0.667,0.847,38
inquisitive,1.115,6,32,1,1,0.301,0.637,0.615,38
outbreak,1.115,6,32,1,1,0.26,0.632,0.472,38
aquatic,1.115,6,32,1,1,0.677,0.51,0.463,38
reluctance,1.115,6,32,1,1,0.24,0.606,0.373,38
receding,1.115,6,32,1,1,0.224,0.418,0.333,38
subversive,1.115,6,32,1,1,0.198,0.765,0.5,38
arbor,1.115,6,32,1,1,0.583,0.49,0.591,38
governing,1.115,6,32,1,1,0.635,0.7,0.9,38
safety,1.115,285,1348,1,1,0.708,0.491,0.868,1633
celestial,1.114,24,117,1,1,0.817,0.36,0.731,141
annoyance,1.113,35,169,1,1,0.167,0.718,0.342,204
atonement,1.112,10,51,1,1,0.55,0.602,0.683,61
declaration,1.112,10,51,1,1,0.551,0.59,0.714,61
disappearance,1.111,14,70,1,1,0.214,0.698,0.367,84
intriguing,1.111,33,160,1,1,0.422,0.713,0.462,193
fog,1.11,91,435,1,1,0.51,0.213,0.26,526
disturb,1.108,145,692,1,1,0.175,0.76,0.481,837
fond,1.108,82,393,1,1,0.885,0.602,0.518,475
efficiency,1.108,11,56,1,1,0.802,0.509,0.892,67
blurred,1.108,19,94,1,1,0.32,0.367,0.231,113
hind,1.108,7,37,1,1,0.483,0.644,0.337,44
victor,1.108,51,246,1,1,0.802,0.587,0.796,297
unplugged,1.108,19,94,1,1,0.367,0.375,0.318,113
polished,1.108,11,56,1,1,0.667,0.413,0.491,67
flask,1.108,7,37,1,1,0.418,0.412,0.454,44
tug,1.108,31,151,1,1,0.32,0.604,0.558,182
private,1.108,507,2412,1,1,0.661,0.422,0.644,2919
stern,1.108,15,75,1,1,0.552,0.394,0.415,90
property,1.108,63,303,1,1,0.74,0.221,0.805,366
militant,1.108,7,37,1,1,0.418,0.667,0.75,44
absolute,1.107,562,2674,1,1,0.526,0.51,0.827,3236
austere,1.106,32,156,1,1,0.5,0.39,0.422,188
wanderer,1.106,53,256,1,1,0.458,0.519,0.396,309
dimension,1.105,58,280,1,1,0.592,0.415,0.627,338
examination,1.105,16,80,1,1,0.378,0.657,0.679,96
compete,1.104,68,328,1,1,0.573,0.745,0.786,396
imposing,1.104,12,61,1,1,0.392,0.731,0.836,73
proverbial,1.102,8,42,1,1,0.583,0.43,0.697,50
synonym,1.102,8,42,1,1,0.615,0.21,0.433,50
alight,1.102,8,42,1,1,0.667,0.657,0.605,50
deprivation,1.101,58,281,1,1,0.194,0.61,0.413,339
distraction,1.1,201,966,1,1,0.402,0.557,0.39,1167
requirement,1.1,32,157,1,1,0.51,0.439,0.728,189
demeanor,1.099,18,90,1,1,0.633,0.433,0.657,108
cathartic,1.099,28,138,1,1,0.45,0.51,0.604,166
excess,1.098,38,186,1,1,0.385,0.889,0.712,224
groggy,1.097,4,23,1,1,0.235,0.265,0.194,27
soiled,1.097,4,23,1,1,0.106,0.529,0.213,27
combative,1.097,4,23,1,1,0.381,0.69,0.816,27
temporal,1.097,9,47,1,1,0.5,0.413,0.36,56
perfectionist,1.097,9,47,1,1,0.667,0.704,0.905,56
docile,1.097,4,23,1,1,0.604,0.259,0.264,27
amethyst,1.097,4,23,1,1,0.622,0.406,0.517,27
formality,1.097,4,23,1,1,0.594,0.353,0.75,27
elm,1.097,4,23,1,1,0.51,0.345,0.321,27
maligned,1.097,4,23,1,1,0.102,0.684,0.218,27
velocity,1.097,4,23,1,1,0.673,0.769,0.783,27
mimicking,1.097,4,23,1,1,0.316,0.433,0.364,27
geometry,1.097,4,23,1,1,0.49,0.27,0.537,27
quasi,1.097,4,23,1,1,0.51,0.343,0.33,27
housekeeping,1.097,4,23,1,1,0.604,0.5,0.445,27
taxed,1.097,4,23,1,1,0.255,0.456,0.5,27
tremor,1.097,4,23,1,1,0.104,0.833,0.455,27
mri,1.097,4,23,1,1,0.365,0.431,0.349,27
accomplice,1.097,4,23,1,1,0.408,0.58,0.51,27
quilt,1.097,9,47,1,1,0.643,0.123,0.226,56
lien,1.097,4,23,1,1,0.396,0.58,0.441,27
blare,1.097,4,23,1,1,0.439,0.561,0.519,27
carving,1.097,19,95,1,1,0.541,0.444,0.368,114
piccolo,1.097,4,23,1,1,0.625,0.423,0.38,27
frivolous,1.097,9,47,1,1,0.271,0.565,0.377,56
shallows,1.097,4,23,1,1,0.388,0.368,0.368,27
bourbon,1.096,25,124,1,1,0.602,0.49,0.517,149
snowy,1.095,46,225,1,1,0.656,0.304,0.357,271
itching,1.095,20,100,1,1,0.208,0.69,0.3,120
grand,1.094,232,1121,1,1,0.898,0.74,0.888,1353
stagnation,1.093,10,52,1,1,0.276,0.324,0.396,62
robe,1.093,21,105,1,1,0.594,0.216,0.298,126
barbecue,1.093,10,52,1,1,0.792,0.643,0.456,62
unexplained,1.093,10,52,1,1,0.271,0.531,0.349,62
heinous,1.093,10,52,1,1,0.133,0.792,0.471,62
rainfall,1.09,5,28,1,1,0.604,0.314,0.378,33
suede,1.09,5,28,1,1,0.542,0.259,0.259,33
fanfare,1.09,5,28,1,1,0.656,0.64,0.437,33
specie,1.09,5,28,1,1,0.583,0.471,0.65,33
greenhouse,1.09,5,28,1,1,0.719,0.438,0.384,33
saturation,1.09,5,28,1,1,0.255,0.582,0.583,33
harshness,1.09,5,28,1,1,0.323,0.6,0.779,33
author,1.089,225,1093,1,1,0.775,0.343,0.749,1318
madame,1.088,18,91,1,1,0.604,0.5,0.635,109
verb,1.088,12,62,1,1,0.582,0.312,0.414,74
preparation,1.087,39,193,1,1,0.771,0.5,0.679,232
fiction,1.086,176,858,1,1,0.438,0.657,0.441,1034
intricate,1.085,13,67,1,1,0.559,0.704,0.5,80
gravitate,1.085,20,101,1,1,0.479,0.472,0.476,121
caravan,1.085,27,135,1,1,0.635,0.559,0.455,162
drab,1.085,6,33,1,1,0.327,0.3,0.242,39
eggnog,1.085,6,33,1,1,0.635,0.36,0.259,39
reviewer,1.085,6,33,1,1,0.562,0.344,0.5,39
rusted,1.085,6,33,1,1,0.286,0.357,0.302,39
scarlet,1.084,28,140,1,1,0.507,0.39,0.411,168
finding,1.084,1383,6729,1,1,0.796,0.469,0.664,8112
wield,1.082,7,38,1,1,0.347,0.66,0.625,45
sturdy,1.082,7,38,1,1,0.58,0.642,0.824,45
assertive,1.082,7,38,1,1,0.719,0.412,0.77,45
hover,1.082,7,38,1,1,0.51,0.431,0.404,45
ambiguity,1.082,7,38,1,1,0.164,0.46,0.37,45
bedding,1.082,7,38,1,1,0.704,0.276,0.377,45
reverie,1.082,15,77,1,1,0.667,0.413,0.471,92
doctrine,1.082,7,38,1,1,0.5,0.394,0.769,45
majesty,1.081,24,121,1,1,0.823,0.602,0.955,145
overcrowded,1.08,16,82,1,1,0.292,0.52,0.491,98
activity,1.078,238,1168,1,1,0.701,0.66,0.807,1406
conditioned,1.078,27,136,1,1,0.49,0.417,0.616,163
convict,1.077,9,48,1,1,0.177,0.84,0.477,57
utility,1.077,9,48,1,1,0.622,0.4,0.704,57
swirl,1.077,9,48,1,1,0.49,0.726,0.639,57
detriment,1.077,9,48,1,1,0.281,0.538,0.263,57
enchanting,1.077,29,146,1,1,0.917,0.681,0.708,175
feud,1.077,9,48,1,1,0.146,0.796,0.312,57
explore,1.076,237,1166,1,1,0.776,0.66,0.727,1403
outdoor,1.076,62,308,1,1,0.814,0.256,0.447,370
unintended,1.075,10,53,1,1,0.438,0.385,0.349,63
acknowledgment,1.075,10,53,1,1,0.796,0.528,0.777,63
realm,1.074,99,490,1,1,0.708,0.509,0.878,589
reconnect,1.074,88,436,1,1,0.63,0.548,0.667,524
sweeping,1.074,22,112,1,1,0.344,0.431,0.355,134
tropical,1.073,23,117,1,1,0.74,0.461,0.509,140
imitate,1.073,11,58,1,1,0.469,0.561,0.336,69
eternity,1.071,234,1157,1,1,0.765,0.52,0.911,1391
spirit,1.071,834,4114,1,1,0.786,0.37,0.621,4948
psyche,1.071,41,206,1,1,0.427,0.375,0.435,247
incomprehensible,1.071,13,68,1,1,0.25,0.55,0.344,81
collaboration,1.07,57,285,1,1,0.885,0.628,0.741,342
dreamy,1.069,31,157,1,1,0.837,0.35,0.5,188
vital,1.068,117,582,1,1,0.75,0.716,0.847,699
fragrance,1.068,17,88,1,1,0.847,0.357,0.667,105
frantic,1.068,17,88,1,1,0.21,0.89,0.627,105
cigar,1.068,17,88,1,1,0.306,0.463,0.346,105
fort,1.066,84,420,1,1,0.78,0.673,0.86,504
wonderfully,1.066,42,212,1,1,0.969,0.76,0.821,254
sparkling,1.064,27,138,1,1,0.7,0.418,0.598,165
genre,1.063,96,481,1,1,0.52,0.433,0.5,577
wander,1.061,175,875,1,1,0.427,0.417,0.33,1050
eternal,1.057,439,2197,1,1,0.854,0.409,0.843,2636
aura,1.056,62,314,1,1,0.76,0.333,0.5,376
iridescent,1.056,4,24,1,1,0.602,0.588,0.539,28
undergo,1.056,12,64,1,1,0.398,0.554,0.339,76
quarrel,1.056,6,34,1,1,0.112,0.929,0.496,40
primordial,1.056,6,34,1,1,0.625,0.569,0.771,40
racking,1.056,6,34,1,1,0.411,0.442,0.375,40
establishment,1.056,23,119,1,1,0.69,0.398,0.631,142
vermin,1.056,8,44,1,1,0.167,0.712,0.385,52
maniacal,1.056,4,24,1,1,0.2,0.848,0.5,28
amorous,1.056,4,24,1,1,0.844,0.67,0.636,28
evaporate,1.056,4,24,1,1,0.357,0.469,0.402,28
parole,1.056,6,34,1,1,0.388,0.62,0.526,40
totem,1.056,4,24,1,1,0.639,0.35,0.571,28
indistinguishable,1.056,4,24,1,1,0.346,0.458,0.548,28
highness,1.056,7,39,1,1,0.74,0.67,0.931,46
exponential,1.056,4,24,1,1,0.704,0.588,0.763,28
humid,1.056,9,49,1,1,0.375,0.324,0.366,58
prowess,1.056,6,34,1,1,0.792,0.657,0.833,40
cellular,1.056,6,34,1,1,0.643,0.398,0.517,40
brunt,1.056,6,34,1,1,0.204,0.75,0.349,40
normality,1.056,12,64,1,1,0.781,0.089,0.444,76
regulation,1.056,8,44,1,1,0.542,0.425,0.667,52
abound,1.056,10,54,1,1,0.704,0.49,0.681,64
disposed,1.056,4,24,1,1,0.688,0.441,0.625,28
devout,1.056,8,44,1,1,0.62,0.357,0.464,52
strategic,1.056,15,79,1,1,0.786,0.708,0.861,94
treasury,1.056,5,29,1,1,0.812,0.541,0.736,34
scramble,1.056,5,29,1,1,0.469,0.744,0.5,34
toasty,1.056,4,24,1,1,0.698,0.461,0.396,28
herring,1.056,4,24,1,1,0.531,0.387,0.422,28
sketching,1.056,10,54,1,1,0.729,0.327,0.4,64
complicate,1.056,7,39,1,1,0.21,0.657,0.404,46
muses,1.056,15,79,1,1,0.714,0.434,0.571,94
northwest,1.056,15,79,1,1,0.604,0.345,0.451,94
tedium,1.056,4,24,1,1,0.224,0.331,0.298,28
foresight,1.056,5,29,1,1,0.68,0.482,0.64,34
candlelight,1.056,11,59,1,1,0.789,0.294,0.417,70
ghastly,1.056,8,44,1,1,0.125,0.79,0.472,52
morph,1.056,7,39,1,1,0.448,0.469,0.451,46
menagerie,1.056,4,24,1,1,0.573,0.48,0.538,28
competence,1.056,5,29,1,1,0.615,0.802,0.823,34
wilt,1.056,11,59,1,1,0.226,0.354,0.312,70
mead,1.056,4,24,1,1,0.667,0.337,0.441,28
feasible,1.056,8,44,1,1,0.694,0.388,0.611,52
accord,1.056,9,49,1,1,0.898,0.264,0.382,58
nudist,1.056,5,29,1,1,0.44,0.796,0.483,34
breezy,1.056,12,64,1,1,0.531,0.472,0.482,76
monument,1.056,18,94,1,1,0.833,0.404,0.811,112
seafood,1.056,13,69,1,1,0.656,0.5,0.328,82
orgies,1.056,6,34,1,1,0.388,0.953,0.433,40
purgatory,1.056,24,124,1,1,0.255,0.705,0.413,148
onslaught,1.056,9,49,1,1,0.198,0.939,0.717,58
soulful,1.056,25,129,1,1,0.755,0.331,0.5,154
perversion,1.056,7,39,1,1,0.083,0.83,0.49,46
hostess,1.056,6,34,1,1,0.792,0.604,0.688,40
complimentary,1.056,5,29,1,1,0.823,0.413,0.435,34
illuminating,1.056,12,64,1,1,0.949,0.613,0.773,76
frazzled,1.056,4,24,1,1,0.344,0.415,0.339,28
intact,1.056,28,144,1,1,0.716,0.212,0.602,172
poetic,1.054,81,410,1,1,0.86,0.269,0.548,491
symbol,1.054,70,355,1,1,0.643,0.388,0.527,425
maximum,1.052,41,210,1,1,0.724,0.724,0.852,251
forced,1.049,506,2553,1,1,0.18,0.721,0.458,3059
haiku,1.049,25,130,1,1,0.583,0.356,0.392,155
pier,1.048,23,120,1,1,0.583,0.279,0.445,143
metal,1.048,136,690,1,1,0.551,0.429,0.547,826
internal,1.047,149,756,1,1,0.439,0.349,0.423,905
satanic,1.046,18,95,1,1,0.062,0.843,0.72,113
occasionally,1.046,201,1020,1,1,0.538,0.24,0.264,1221
vicinity,1.045,17,90,1,1,0.7,0.353,0.466,107
stained,1.045,33,171,1,1,0.245,0.46,0.209,204
conventional,1.045,16,85,1,1,0.594,0.292,0.634,101
rebellion,1.044,32,166,1,1,0.245,0.843,0.746,198
natural,1.044,383,1943,1,1,0.854,0.118,0.481,2326
horde,1.044,15,80,1,1,0.286,0.713,0.684,95
burial,1.043,14,75,1,1,0.203,0.577,0.333,89
disclosure,1.043,14,75,1,1,0.5,0.615,0.71,89
insanity,1.043,102,521,1,1,0.098,0.847,0.337,623
expand,1.043,57,293,1,1,0.792,0.559,0.686,350
master,1.042,368,1870,1,1,0.694,0.49,0.849,2238
mechanics,1.042,13,70,1,1,0.542,0.5,0.761,83
perch,1.042,13,70,1,1,0.531,0.3,0.314,83
obligation,1.042,40,207,1,1,0.222,0.596,0.718,247
offering,1.041,195,994,1,1,0.688,0.462,0.585,1189
revive,1.04,24,126,1,1,0.676,0.78,0.778,150
escaped,1.04,74,380,1,1,0.365,0.755,0.518,454
victory,1.04,135,690,1,1,0.938,0.735,0.931,825
compound,1.04,23,121,1,1,0.635,0.385,0.735,144
musing,1.04,11,60,1,1,0.74,0.151,0.465,71
marked,1.04,47,243,1,1,0.592,0.358,0.554,290
foundation,1.04,94,482,1,1,0.771,0.385,0.73,576
flow,1.039,211,1077,1,1,0.696,0.316,0.464,1288
firm,1.039,69,355,1,1,0.635,0.38,0.728,424
coding,1.039,22,116,1,1,0.442,0.344,0.667,138
flexible,1.039,22,116,1,1,0.719,0.46,0.465,138
basil,1.038,10,55,1,1,0.534,0.274,0.309,65
chaotic,1.038,109,559,1,1,0.115,0.847,0.442,668
bosom,1.038,10,55,1,1,0.612,0.588,0.404,65
loner,1.038,693,3534,1,1,0.347,0.152,0.221,4227
providing,1.037,130,667,1,1,0.816,0.55,0.896,797
debris,1.037,9,50,1,1,0.135,0.396,0.327,59
historian,1.037,9,50,1,1,0.688,0.27,0.637,59
rabbi,1.037,9,50,1,1,0.459,0.362,0.723,59
homeland,1.037,19,101,1,1,0.663,0.439,0.868,120
cuisine,1.037,9,50,1,1,0.714,0.365,0.39,59
chamber,1.036,94,484,1,1,0.583,0.373,0.455,578
vault,1.035,27,142,1,1,0.49,0.378,0.644,169
commute,1.035,63,326,1,1,0.622,0.582,0.565,389
crypt,1.034,8,45,1,1,0.156,0.431,0.386,53
ignite,1.034,17,91,1,1,0.458,0.785,0.675,108
luminous,1.034,8,45,1,1,0.918,0.392,0.783,53
edging,1.034,8,45,1,1,0.479,0.394,0.37,53
faction,1.034,8,45,1,1,0.469,0.43,0.448,53
treasure,1.034,191,981,1,1,0.927,0.592,0.821,1172
draining,1.033,163,838,1,1,0.337,0.396,0.304,1001
kneel,1.033,16,86,1,1,0.426,0.417,0.217,102
craving,1.032,373,1915,1,1,0.51,0.755,0.636,2288
completed,1.032,80,414,1,1,0.823,0.357,0.777,494
budge,1.032,7,40,1,1,0.719,0.755,0.543,47
foreboding,1.032,7,40,1,1,0.439,0.706,0.636,47
rehabilitation,1.032,7,40,1,1,0.406,0.528,0.606,47
withered,1.032,23,122,1,1,0.188,0.292,0.16,145
prestigious,1.032,7,40,1,1,0.979,0.644,0.925,47
soc,1.032,7,40,1,1,0.427,0.431,0.38,47
backward,1.032,15,81,1,1,0.309,0.367,0.25,96
tethered,1.032,7,40,1,1,0.26,0.472,0.351,47
motherless,1.032,7,40,1,1,0.163,0.541,0.337,47
repair,1.031,46,240,1,1,0.583,0.46,0.589,286
resort,1.031,139,717,1,1,0.573,0.441,0.632,856
gift,1.031,747,3836,1,1,0.88,0.539,0.483,4583
breeze,1.031,214,1102,1,1,0.837,0.284,0.37,1316
element,1.03,60,312,1,1,0.531,0.259,0.481,372
harvest,1.03,36,189,1,1,0.781,0.353,0.548,225
ranch,1.029,42,220,1,1,0.357,0.42,0.409,262
serendipity,1.028,27,143,1,1,0.677,0.413,0.5,170
teeming,1.028,6,35,1,1,0.582,0.55,0.727,41
icing,1.028,13,71,1,1,0.688,0.452,0.411,84
disciplined,1.028,13,71,1,1,0.728,0.45,0.75,84
daybreak,1.028,6,35,1,1,0.802,0.358,0.474,41
swig,1.028,6,35,1,1,0.604,0.481,0.406,41
enter,1.028,311,1604,1,1,0.708,0.47,0.5,1915
learn,1.027,2309,11888,1,1,0.833,0.643,0.829,14197
scent,1.027,79,411,1,1,0.633,0.41,0.491,490
habitual,1.026,12,66,1,1,0.527,0.208,0.49,78
lunar,1.026,25,133,1,1,0.562,0.296,0.427,158
scorn,1.026,12,66,1,1,0.11,0.721,0.356,78
disturbed,1.025,93,484,1,1,0.125,0.87,0.305,577
pure,1.024,640,3309,1,1,0.811,0.306,0.652,3949
pace,1.024,133,691,1,1,0.51,0.38,0.39,824
meddling,1.024,5,30,1,1,0.245,0.6,0.461,35
angered,1.024,11,61,1,1,0.01,0.86,0.547,72
chore,1.024,23,123,1,1,0.406,0.462,0.5,146
identification,1.024,5,30,1,1,0.714,0.451,0.692,35
omnipresent,1.024,5,30,1,1,0.688,0.452,0.825,35
amiable,1.024,11,61,1,1,0.847,0.29,0.483,72
prompt,1.024,41,216,1,1,0.602,0.548,0.582,257
commanding,1.024,5,30,1,1,0.562,0.664,0.925,35
lactose,1.024,5,30,1,1,0.479,0.29,0.433,35
nexus,1.024,5,30,1,1,0.496,0.368,0.412,35
collective,1.023,106,552,1,1,0.583,0.458,0.698,658
bathroom,1.023,307,1591,1,1,0.561,0.283,0.345,1898
relaxed,1.023,81,423,1,1,0.865,0.09,0.382,504
unpredictable,1.021,32,170,1,1,0.429,0.769,0.515,202
romanticism,1.021,10,56,1,1,0.854,0.521,0.593,66
select,1.019,41,217,1,1,0.615,0.406,0.602,258
habitat,1.019,20,108,1,1,0.633,0.343,0.553,128
weight,1.018,683,3551,1,1,0.45,0.38,0.577,4234
thinker,1.018,30,160,1,1,0.706,0.386,0.764,190
possibility,1.017,105,550,1,1,0.816,0.481,0.596,655
tortuous,1.017,4,25,1,1,0.194,0.755,0.382,29
clad,1.017,9,51,1,1,0.583,0.373,0.481,60
crease,1.017,4,25,1,1,0.44,0.286,0.3,29
accommodate,1.017,19,103,1,1,0.844,0.375,0.566,122
hark,1.017,4,25,1,1,0.571,0.5,0.398,29
unison,1.017,9,51,1,1,0.51,0.439,0.583,60
doze,1.017,4,25,1,1,0.592,0.2,0.405,29
crossover,1.017,19,103,1,1,0.559,0.55,0.5,122
layered,1.017,9,51,1,1,0.571,0.306,0.436,60
announcer,1.017,4,25,1,1,0.602,0.57,0.732,29
brilliance,1.017,19,103,1,1,0.99,0.673,0.83,122
fossils,1.017,4,25,1,1,0.52,0.314,0.422,29
dignified,1.017,14,77,1,1,0.766,0.481,0.635,91
frosted,1.017,4,25,1,1,0.748,0.471,0.218,29
calculus,1.017,4,25,1,1,0.36,0.36,0.562,29
sightseeing,1.017,4,25,1,1,0.875,0.552,0.697,29
rifles,1.017,4,25,1,1,0.337,0.864,0.765,29
decode,1.017,4,25,1,1,0.551,0.51,0.64,29
hellish,1.015,18,98,1,1,0.125,0.86,0.545,116
decipher,1.014,13,72,1,1,0.417,0.63,0.652,85
capability,1.014,13,72,1,1,0.833,0.571,0.73,85
quad,1.014,13,72,1,1,0.52,0.441,0.391,85
wrought,1.013,8,46,1,1,0.322,0.559,0.681,54
strait,1.013,8,46,1,1,0.438,0.433,0.412,54
memorize,1.013,8,46,1,1,0.52,0.451,0.716,54
roe,1.013,8,46,1,1,0.49,0.382,0.398,54
impeccable,1.013,8,46,1,1,0.833,0.37,0.824,54
freely,1.012,88,464,1,1,0.875,0.456,0.716,552
indifference,1.012,39,208,1,1,0.265,0.417,0.299,247
chant,1.012,21,114,1,1,0.771,0.698,0.65,135
raft,1.011,12,67,1,1,0.51,0.229,0.228,79
paradigm,1.011,12,67,1,1,0.573,0.429,0.779,79
ability,1.011,361,1893,1,1,0.875,0.51,0.816,2254
revolve,1.011,29,156,1,1,0.592,0.546,0.402,185
loo,1.01,16,88,1,1,0.385,0.357,0.283,104
humankind,1.01,16,88,1,1,0.885,0.394,0.714,104
materialism,1.01,16,88,1,1,0.22,0.39,0.556,104
deafening,1.01,79,418,1,1,0.281,0.835,0.482,497
museum,1.009,74,392,1,1,0.792,0.206,0.481,466
nurture,1.009,57,303,1,1,0.745,0.378,0.657,360
brotherhood,1.009,28,151,1,1,0.99,0.471,0.76,179
understanding,1.009,525,2757,1,1,0.865,0.304,0.689,3282
heritage,1.009,40,214,1,1,0.842,0.512,0.815,254
unintentional,1.008,7,41,1,1,0.333,0.538,0.306,48
fidelity,1.008,7,41,1,1,0.765,0.58,0.709,48
intake,1.008,11,62,1,1,0.604,0.527,0.442,73
mist,1.008,67,356,1,1,0.375,0.194,0.221,423
mole,1.008,15,83,1,1,0.436,0.377,0.352,98
sword,1.008,103,545,1,1,0.438,0.653,0.713,648
unconventional,1.008,11,62,1,1,0.177,0.509,0.288,73
craziness,1.008,31,167,1,1,0.238,0.908,0.255,198
orchard,1.008,11,62,1,1,0.76,0.269,0.333,73
operations,1.008,11,62,1,1,0.48,0.549,0.798,73
versus,1.007,58,309,1,1,0.31,0.5,0.447,367
enjoyable,1.006,116,614,1,1,1,0.481,0.605,730
consumption,1.006,30,162,1,1,0.39,0.531,0.538,192
organize,1.006,30,162,1,1,0.802,0.655,0.781,192
innate,1.006,26,141,1,1,0.49,0.4,0.521,167
premier,1.005,22,120,1,1,0.755,0.519,0.792,142
miniature,1.004,14,78,1,1,0.429,0.292,0.204,92
consistency,1.004,36,194,1,1,0.714,0.5,0.887,230
purge,1.003,21,115,1,1,0.125,0.566,0.327,136
muffled,1.003,10,57,1,1,0.479,0.33,0.421,67
pagan,1.003,10,57,1,1,0.292,0.578,0.542,67
restored,1.003,28,152,1,1,0.892,0.41,0.728,180
merit,1.002,17,94,1,1,0.854,0.5,0.722,111
artistic,1.002,56,300,1,1,0.802,0.646,0.632,356
agile,1.001,6,36,1,1,0.8,0.657,0.775,42
cavernous,1.001,6,36,1,1,0.354,0.548,0.462,42
disillusionment,1.001,6,36,1,1,0.051,0.519,0.19,42
sentinel,1.001,6,36,1,1,0.531,0.602,0.845,42
gall,1.001,6,36,1,1,0.417,0.51,0.353,42
resurrect,1.001,6,36,1,1,0.781,0.725,0.817,42
reinforcement,1.001,6,36,1,1,0.729,0.702,0.902,42
hex,1.001,6,36,1,1,0.41,0.51,0.363,42
displeasure,1.001,6,36,1,1,0.115,0.559,0.25,42
nefarious,1.001,6,36,1,1,0.184,0.72,0.528,42
aloud,1,44,237,1,1,0.458,0.713,0.75,281
infinite,0.999,193,1026,1,1,0.724,0.583,0.735,1219
periodically,0.999,16,89,1,1,0.48,0.314,0.515,105
slavery,0.999,33,179,1,1,0.052,0.783,0.218,212
archer,0.999,16,89,1,1,0.573,0.622,0.661,105
fundamental,0.999,43,232,1,1,0.708,0.422,0.903,275
venture,0.998,56,301,1,1,0.893,0.81,0.644,357
observer,0.998,19,105,1,1,0.663,0.363,0.603,124
crunchy,0.998,9,52,1,1,0.625,0.56,0.539,61
weights,0.998,19,105,1,1,0.458,0.5,0.722,124
instrument,0.998,29,158,1,1,0.562,0.537,0.655,187
contrast,0.997,58,312,1,1,0.48,0.406,0.52,370
steel,0.997,58,312,1,1,0.521,0.42,0.714,370
stability,0.997,71,381,1,1,0.812,0.264,0.849,452
likewise,0.996,31,169,1,1,0.651,0.217,0.312,200
symbolic,0.996,15,84,1,1,0.67,0.385,0.574,99
reminiscent,0.996,15,84,1,1,0.5,0.481,0.611,99
adventure,0.994,249,1329,1,1,0.917,0.857,0.71,1578
deadline,0.994,24,132,1,1,0.214,0.615,0.46,156
reserved,0.994,58,313,1,1,0.594,0.316,0.583,371
depth,0.993,146,782,1,1,0.708,0.561,0.759,928
shitload,0.992,5,31,1,1,0.02,0.606,0.161,36
clasp,0.992,5,31,1,1,0.448,0.375,0.241,36
liable,0.992,5,31,1,1,0.656,0.519,0.821,36
inhuman,0.992,11,63,1,1,0.107,0.66,0.492,74
gauntlet,0.992,8,47,1,1,0.42,0.491,0.39,55
dismantle,0.992,5,31,1,1,0.347,0.644,0.462,36
modicum,0.992,5,31,1,1,0.234,0.417,0.327,36
terrify,0.992,5,31,1,1,0.052,0.889,0.509,36
fervent,0.992,5,31,1,1,0.646,0.632,0.773,36
unruly,0.992,5,31,1,1,0.24,0.745,0.547,36
trot,0.992,8,47,1,1,0.531,0.664,0.396,55
communicator,0.992,5,31,1,1,0.573,0.509,0.796,36
decree,0.992,5,31,1,1,0.552,0.478,0.746,36
rarity,0.992,14,79,1,1,0.646,0.548,0.364,93
distort,0.992,5,31,1,1,0.1,0.74,0.366,36
entrance,0.992,41,223,1,1,0.698,0.393,0.526,264
protective,0.99,57,309,1,1,0.844,0.459,0.86,366
blinding,0.989,22,122,1,1,0.304,0.596,0.406,144
cosy,0.989,22,122,1,1,0.847,0.255,0.518,144
devoted,0.989,42,229,1,1,0.867,0.32,0.698,271
frost,0.989,42,229,1,1,0.449,0.455,0.385,271
resignation,0.989,19,106,1,1,0.145,0.392,0.31,125
marble,0.987,24,133,1,1,0.604,0.212,0.667,157
whisky,0.986,21,117,1,1,0.64,0.615,0.49,138
intrigue,0.986,10,58,1,1,0.362,0.83,0.327,68
revolutionary,0.986,21,117,1,1,0.635,0.887,0.824,138
religious,0.986,153,825,1,1,0.74,0.238,0.696,978
abysmal,0.986,10,58,1,1,0.25,0.71,0.598,68
minimal,0.986,40,219,1,1,0.448,0.147,0.206,259
suffocate,0.985,26,144,1,1,0.219,0.764,0.44,170
friction,0.984,7,42,1,1,0.271,0.778,0.534,49
mending,0.984,7,42,1,1,0.5,0.633,0.657,49
paving,0.984,7,42,1,1,0.408,0.469,0.545,49
mandate,0.984,7,42,1,1,0.448,0.67,0.779,49
constitute,0.984,7,42,1,1,0.812,0.349,0.906,49
civilians,0.984,7,42,1,1,0.49,0.448,0.525,49
reluctant,0.982,25,139,1,1,0.292,0.63,0.432,164
harp,0.982,12,69,1,1,0.618,0.31,0.356,81
intentionally,0.982,69,376,1,1,0.45,0.676,0.696,445
capture,0.982,87,473,1,1,0.357,0.65,0.537,560
mountain,0.982,526,2838,1,1,0.698,0.408,0.649,3364
blessings,0.982,177,958,1,1,0.929,0.361,0.623,1135
enjoyment,0.982,84,457,1,1,0.93,0.612,0.716,541
dreaded,0.981,22,123,1,1,0.122,0.706,0.46,145
lieu,0.979,9,53,1,1,0.427,0.41,0.312,62
pottery,0.979,4,26,1,1,0.594,0.286,0.422,30
dent,0.979,9,53,1,1,0.306,0.606,0.325,62
lavish,0.979,19,107,1,1,0.792,0.648,0.73,126
typhoon,0.979,4,26,1,1,0.323,0.796,0.697,30
stripe,0.979,4,26,1,1,0.629,0.302,0.361,30
rein,0.979,4,26,1,1,0.5,0.357,0.438,30
sultan,0.979,4,26,1,1,0.529,0.423,0.821,30
artifact,0.979,4,26,1,1,0.51,0.5,0.566,30
brazen,0.979,4,26,1,1,0.292,0.64,0.518,30
wobbly,0.979,4,26,1,1,0.208,0.759,0.225,30
spire,0.979,4,26,1,1,0.354,0.358,0.389,30
successor,0.979,4,26,1,1,0.729,0.531,0.648,30
intruder,0.979,4,26,1,1,0.146,0.74,0.324,30
barf,0.979,4,26,1,1,0.34,0.491,0.394,30
affiliated,0.979,9,53,1,1,0.673,0.519,0.535,62
reading,0.979,1883,10175,1,1,0.781,0.183,0.415,12058
classics,0.979,46,253,1,1,0.75,0.333,0.51,299
restore,0.978,63,345,1,1,0.765,0.49,0.625,408
lotus,0.977,16,91,1,1,0.604,0.377,0.51,107
vision,0.977,224,1217,1,1,0.708,0.447,0.742,1441
gather,0.977,132,719,1,1,0.648,0.51,0.546,851
residence,0.977,28,156,1,1,0.615,0.382,0.585,184
forty,0.977,28,156,1,1,0.458,0.367,0.482,184
abstract,0.977,40,221,1,1,0.438,0.292,0.444,261
brimming,0.976,11,64,1,1,0.656,0.69,0.758,75
enslaved,0.976,11,64,1,1,0.104,0.72,0.321,75
depend,0.975,234,1273,1,1,0.388,0.429,0.358,1507
flowering,0.974,6,37,1,1,0.906,0.627,0.5,43
agitation,0.974,6,37,1,1,0.24,0.931,0.447,43
immeasurable,0.974,13,75,1,1,0.51,0.539,0.712,88
simultaneous,0.974,6,37,1,1,0.691,0.577,0.554,43
luscious,0.974,6,37,1,1,0.885,0.552,0.545,43
integral,0.974,13,75,1,1,0.59,0.337,0.615,88
croissant,0.974,6,37,1,1,0.745,0.33,0.43,43
storm,0.973,320,1744,1,1,0.188,0.94,0.543,2064
bane,0.972,15,86,1,1,0.265,0.694,0.366,101
grieve,0.972,58,320,1,1,0.122,0.5,0.333,378
lands,0.971,78,429,1,1,0.594,0.28,0.492,507
sporadic,0.971,8,48,1,1,0.333,0.394,0.5,56
womanhood,0.971,8,48,1,1,0.812,0.656,0.602,56
unspoken,0.971,35,195,1,1,0.177,0.26,0.208,230
resilient,0.971,26,146,1,1,0.542,0.54,0.801,172
pragmatic,0.971,8,48,1,1,0.573,0.433,0.637,56
habit,0.971,279,1524,1,1,0.625,0.226,0.585,1803
temp,0.97,19,108,1,1,0.49,0.44,0.314,127
symbolize,0.969,10,59,1,1,0.633,0.327,0.673,69
parcel,0.969,10,59,1,1,0.66,0.324,0.411,69
tempest,0.969,10,59,1,1,0.245,0.843,0.653,69
nausea,0.969,10,59,1,1,0.104,0.781,0.273,69
civilized,0.969,10,59,1,1,0.792,0.231,0.796,69
specialty,0.969,10,59,1,1,0.724,0.479,0.783,69
magical,0.969,327,1789,1,1,0.875,0.651,0.595,2116
pleasure,0.969,539,2946,1,1,0.939,0.74,0.682,3485
restroom,0.969,23,130,1,1,0.653,0.279,0.267,153
anticipation,0.969,23,130,1,1,0.698,0.539,0.711,153
gulf,0.968,12,70,1,1,0.52,0.365,0.398,82
towering,0.968,12,70,1,1,0.5,0.69,0.806,82
resigned,0.968,38,212,1,1,0.24,0.17,0.268,250
poop,0.967,61,338,1,1,0.163,0.43,0.172,399
upwards,0.966,16,92,1,1,0.724,0.439,0.638,108
buzzing,0.966,33,185,1,1,0.43,0.588,0.37,218
sentiment,0.966,56,311,1,1,0.765,0.451,0.639,367
ruins,0.966,77,426,1,1,0.25,0.49,0.248,503
exposure,0.965,45,251,1,1,0.57,0.83,0.63,296
dive,0.964,98,542,1,1,0.583,0.531,0.5,640
sunset,0.964,213,1173,1,1,0.875,0.231,0.298,1386
accountability,0.963,36,202,1,1,0.755,0.537,0.833,238
fleeting,0.963,75,416,1,1,0.439,0.65,0.387,491
historical,0.963,42,235,1,1,0.653,0.357,0.833,277
mundane,0.963,48,268,1,1,0.312,0.42,0.48,316
exercise,0.963,166,916,1,1,0.75,0.789,0.625,1082
writing,0.961,1439,7916,1,1,0.694,0.475,0.645,9355
physiological,0.961,5,32,1,1,0.51,0.418,0.62,37
deco,0.961,5,32,1,1,0.625,0.274,0.356,37
rosemary,0.961,7,43,1,1,0.688,0.381,0.425,50
institute,0.961,17,98,1,1,0.604,0.48,0.807,115
lull,0.961,11,65,1,1,0.602,0.13,0.402,76
demos,0.961,5,32,1,1,0.418,0.37,0.368,37
farmhouse,0.961,9,54,1,1,0.69,0.33,0.444,63
precipice,0.961,5,32,1,1,0.198,0.784,0.396,37
monumental,0.961,11,65,1,1,0.656,0.594,0.955,76
meager,0.961,5,32,1,1,0.144,0.389,0.281,37
posture,0.961,17,98,1,1,0.562,0.309,0.598,115
cognition,0.961,5,32,1,1,0.635,0.344,0.706,37
jumbled,0.961,5,32,1,1,0.292,0.602,0.445,37
overrun,0.961,7,43,1,1,0.271,0.764,0.598,50
signify,0.961,7,43,1,1,0.453,0.422,0.634,50
drudgery,0.961,5,32,1,1,0.094,0.522,0.241,37
avalanche,0.961,11,65,1,1,0.265,0.915,0.683,76
navigation,0.961,5,32,1,1,0.841,0.47,0.72,37
menace,0.961,15,87,1,1,0.125,0.894,0.759,102
composition,0.961,21,120,1,1,0.765,0.408,0.652,141
laser,0.961,13,76,1,1,0.469,0.531,0.769,89
wrench,0.961,5,32,1,1,0.396,0.202,0.545,37
enlightened,0.961,25,142,1,1,0.956,0.566,0.7,167
shrunk,0.961,5,32,1,1,0.163,0.354,0.218,37
detect,0.961,11,65,1,1,0.531,0.52,0.565,76
bicycle,0.957,22,126,1,1,0.708,0.519,0.425,148
polar,0.956,56,314,1,1,0.468,0.261,0.5,370
remote,0.955,213,1183,1,1,0.458,0.333,0.477,1396
regard,0.955,59,331,1,1,0.802,0.336,0.809,390
possess,0.954,40,226,1,1,0.67,0.59,0.727,266
scatter,0.954,12,71,1,1,0.229,0.62,0.404,83
dichotomy,0.954,12,71,1,1,0.323,0.482,0.483,83
congregation,0.954,12,71,1,1,0.561,0.49,0.7,83
vintage,0.954,36,204,1,1,0.68,0.39,0.481,240
coffee,0.953,947,5254,1,1,0.823,0.418,0.309,6201
tenth,0.953,10,60,1,1,0.51,0.349,0.382,70
defiant,0.953,10,60,1,1,0.25,0.792,0.769,70
mystic,0.952,50,282,1,1,0.643,0.52,0.535,332
deceit,0.952,19,110,1,1,0.02,0.696,0.343,129
deck,0.951,53,299,1,1,0.42,0.333,0.394,352
solidified,0.951,8,49,1,1,0.633,0.415,0.745,57
persecution,0.951,17,99,1,1,0.229,0.865,0.66,116
prickly,0.951,8,49,1,1,0.333,0.587,0.456,57
crafts,0.951,17,99,1,1,0.667,0.38,0.391,116
oxymoron,0.951,8,49,1,1,0.427,0.481,0.398,57
unequal,0.948,6,38,1,1,0.118,0.433,0.202,44
hardware,0.948,6,38,1,1,0.594,0.289,0.686,44
falter,0.948,6,38,1,1,0.421,0.65,0.346,44
sordid,0.948,6,38,1,1,0.219,0.555,0.447,44
witchcraft,0.948,13,77,1,1,0.183,0.779,0.555,90
sherry,0.948,13,77,1,1,0.594,0.477,0.315,90
irresistible,0.948,13,77,1,1,0.823,0.833,0.839,90
commonplace,0.948,6,38,1,1,0.52,0.337,0.442,44
discerning,0.948,6,38,1,1,0.542,0.584,0.78,44
aggravated,0.948,13,77,1,1,0.079,0.76,0.43,90
helium,0.948,6,38,1,1,0.49,0.316,0.304,44
turbulence,0.948,6,38,1,1,0.062,0.922,0.532,44
scrutiny,0.946,11,66,1,1,0.5,0.653,0.658,77
tempered,0.946,11,66,1,1,0.583,0.437,0.667,77
pleasant,0.946,163,915,1,1,0.939,0.31,0.673,1078
snow,0.945,402,2252,1,1,0.667,0.363,0.309,2654
latte,0.945,21,122,1,1,0.615,0.32,0.311,143
undiscovered,0.943,9,55,1,1,0.438,0.347,0.261,64
adrenaline,0.943,19,111,1,1,0.765,0.965,0.825,130
bureaucracy,0.943,4,27,1,1,0.38,0.578,0.74,31
percussion,0.943,4,27,1,1,0.622,0.635,0.642,31
artiste,0.943,4,27,1,1,0.844,0.512,0.565,31
inactivity,0.943,14,83,1,1,0.135,0.143,0.227,97
dismay,0.943,9,55,1,1,0.314,0.681,0.459,64
mammal,0.943,4,27,1,1,0.618,0.449,0.421,31
encompass,0.943,4,27,1,1,0.52,0.298,0.661,31
bungalow,0.943,4,27,1,1,0.562,0.352,0.406,31
gladness,0.943,4,27,1,1,0.896,0.67,0.643,31
vested,0.943,4,27,1,1,0.663,0.415,0.648,31
weeding,0.943,4,27,1,1,0.458,0.528,0.454,31
flour,0.943,4,27,1,1,0.53,0.235,0.239,31
tempting,0.943,39,223,1,1,0.615,0.74,0.519,262
stratosphere,0.943,4,27,1,1,0.604,0.583,0.636,31
politeness,0.943,4,27,1,1,0.875,0.353,0.618,31
objectivity,0.943,4,27,1,1,0.765,0.431,0.711,31
scanner,0.943,4,27,1,1,0.531,0.356,0.567,31
warranted,0.943,4,27,1,1,0.714,0.367,0.69,31
pogo,0.943,4,27,1,1,0.48,0.426,0.368,31
auditory,0.943,4,27,1,1,0.531,0.481,0.57,31
restrained,0.943,4,27,1,1,0.354,0.59,0.509,31
calorie,0.943,4,27,1,1,0.333,0.54,0.427,31
crimson,0.941,45,257,1,1,0.667,0.385,0.37,302
grant,0.941,120,678,1,1,0.719,0.38,0.667,798
crowd,0.94,1079,6063,1,1,0.35,0.827,0.731,7142
tenacious,0.94,12,72,1,1,0.724,0.658,0.692,84
metaphorical,0.94,12,72,1,1,0.5,0.412,0.48,84
guarded,0.94,25,145,1,1,0.758,0.686,0.5,170
remarkable,0.94,38,218,1,1,0.88,0.573,0.72,256
extended,0.94,137,774,1,1,0.57,0.304,0.649,911
prioritize,0.94,33,190,1,1,0.671,0.594,0.784,223
breathless,0.94,20,117,1,1,0.323,0.49,0.222,137
sphere,0.94,20,117,1,1,0.633,0.277,0.5,137
exempt,0.939,7,44,1,1,0.588,0.455,0.664,51
snowstorm,0.939,7,44,1,1,0.204,0.833,0.629,51
expendable,0.939,7,44,1,1,0.479,0.49,0.423,51
southwest,0.939,7,44,1,1,0.406,0.314,0.355,51
grapple,0.939,7,44,1,1,0.49,0.577,0.482,51
unfeeling,0.939,7,44,1,1,0.235,0.377,0.345,51
wrath,0.939,39,224,1,1,0.039,0.908,0.548,263
exert,0.939,7,44,1,1,0.694,0.735,0.806,51
achieved,0.937,94,534,1,1,0.896,0.519,0.775,628
quest,0.937,143,810,1,1,0.643,0.716,0.545,953
mage,0.937,21,123,1,1,0.622,0.373,0.453,144
requiem,0.937,10,61,1,1,0.475,0.382,0.426,71
riveting,0.937,10,61,1,1,0.448,0.544,0.394,71
fraught,0.937,10,61,1,1,0.266,0.662,0.596,71
reign,0.936,35,202,1,1,0.806,0.567,0.873,237
outgrow,0.935,13,78,1,1,0.51,0.529,0.722,91
establish,0.934,36,208,1,1,0.708,0.5,0.688,244
complexity,0.933,25,146,1,1,0.479,0.62,0.595,171
commodity,0.931,11,67,1,1,0.615,0.394,0.537,78
unconscious,0.931,26,152,1,1,0.24,0.356,0.195,178
slaughter,0.931,20,118,1,1,0.052,0.953,0.602,138
outrun,0.931,5,33,1,1,0.531,0.833,0.573,38
pallet,0.931,5,33,1,1,0.604,0.241,0.349,38
snob,0.931,8,50,1,1,0.296,0.52,0.309,58
satisfactory,0.931,5,33,1,1,0.959,0.569,0.702,38
setback,0.931,8,50,1,1,0.198,0.451,0.25,58
precursor,0.931,5,33,1,1,0.58,0.672,0.783,38
vanity,0.931,41,237,1,1,0.26,0.54,0.439,278
unbiased,0.931,5,33,1,1,0.625,0.378,0.618,38
blitz,0.931,5,33,1,1,0.417,0.722,0.789,38
metallic,0.931,5,33,1,1,0.615,0.33,0.607,38
mischievous,0.931,14,84,1,1,0.439,0.804,0.472,98
loathe,0.931,29,169,1,1,0.094,0.73,0.429,198
rubble,0.931,5,33,1,1,0.308,0.509,0.289,38
rake,0.931,5,33,1,1,0.41,0.286,0.314,38
crunch,0.931,20,118,1,1,0.292,0.63,0.406,138
infertile,0.931,5,33,1,1,0.274,0.458,0.255,38
reappear,0.931,5,33,1,1,0.688,0.625,0.632,38
rampage,0.931,11,67,1,1,0.24,0.875,0.509,78
warfare,0.931,14,84,1,1,0.062,0.885,0.845,98
waves,0.931,327,1858,1,1,0.643,0.47,0.509,2185
valuable,0.931,156,889,1,1,0.899,0.547,0.798,1045
power,0.93,1256,7133,1,1,0.719,0.67,0.953,8389
ink,0.929,52,300,1,1,0.471,0.408,0.235,352
rested,0.928,37,215,1,1,0.792,0.235,0.462,252
trilogy,0.928,47,272,1,1,0.615,0.52,0.664,319
collector,0.928,15,90,1,1,0.552,0.481,0.648,105
blessing,0.927,359,2047,1,1,0.929,0.264,0.8,2406
partisan,0.927,12,73,1,1,0.615,0.549,0.669,85
sobriety,0.926,35,204,1,1,0.68,0.31,0.583,239
sync,0.926,22,130,1,1,0.802,0.44,0.67,152
retrieve,0.925,9,56,1,1,0.74,0.576,0.705,65
sedentary,0.925,9,56,1,1,0.292,0.185,0.273,65
brim,0.925,9,56,1,1,0.469,0.333,0.33,65
fateful,0.925,9,56,1,1,0.29,0.583,0.402,65
maintain,0.925,156,894,1,1,0.684,0.398,0.647,1050
beloved,0.924,213,1220,1,1,0.969,0.613,0.708,1433
readily,0.924,16,96,1,1,0.74,0.29,0.547,112
inn,0.924,30,176,1,1,0.66,0.284,0.475,206
gaze,0.924,130,747,1,1,0.633,0.588,0.586,877
salvation,0.923,75,433,1,1,0.857,0.48,0.8,508
oblivious,0.923,41,239,1,1,0.229,0.388,0.355,280
wrinkle,0.923,6,39,1,1,0.15,0.37,0.274,45
lingo,0.923,6,39,1,1,0.448,0.364,0.447,45
thereof,0.923,13,79,1,1,0.542,0.265,0.281,92
thoughtfulness,0.923,6,39,1,1,0.867,0.269,0.667,45
pearly,0.923,6,39,1,1,0.635,0.337,0.373,45
instill,0.923,6,39,1,1,0.562,0.49,0.618,45
astonished,0.923,6,39,1,1,0.51,0.775,0.574,45
unthinkable,0.923,6,39,1,1,0.365,0.48,0.481,45
hurricanes,0.923,6,39,1,1,0.286,0.898,0.784,45
monogamy,0.923,13,79,1,1,0.542,0.38,0.455,92
obligatory,0.923,13,79,1,1,0.337,0.571,0.78,92
dense,0.922,31,182,1,1,0.354,0.343,0.536,213
testament,0.922,24,142,1,1,0.594,0.42,0.806,166
superpower,0.922,24,142,1,1,0.806,0.784,0.972,166
grapes,0.922,24,142,1,1,0.784,0.24,0.236,166
perpetual,0.922,96,554,1,1,0.625,0.438,0.741,650
appreciate,0.921,1340,7678,1,1,0.885,0.422,0.741,9018
volatile,0.921,10,62,1,1,0.323,0.786,0.565,72
vertical,0.921,10,62,1,1,0.52,0.387,0.492,72
sustain,0.921,43,251,1,1,0.635,0.358,0.593,294
satisfying,0.92,84,486,1,1,0.89,0.606,0.814,570
dependant,0.919,14,85,1,1,0.357,0.404,0.451,99
companion,0.918,678,3897,1,1,0.77,0.377,0.618,4575
nodding,0.918,30,177,1,1,0.694,0.294,0.426,207
anguish,0.917,117,677,1,1,0.153,0.792,0.265,794
farm,0.917,178,1028,1,1,0.781,0.327,0.297,1206
swarming,0.917,3,22,1,1,0.375,0.6,0.435,25
recourse,0.917,3,22,1,1,0.402,0.337,0.598,25
noteworthy,0.917,3,22,1,1,0.704,0.481,0.759,25
moisture,0.917,3,22,1,1,0.406,0.398,0.327,25
monotonous,0.917,15,91,1,1,0.354,0.221,0.4,106
boar,0.917,3,22,1,1,0.406,0.5,0.351,25
illogical,0.917,11,68,1,1,0.208,0.63,0.251,79
manure,0.917,3,22,1,1,0.25,0.471,0.241,25
referee,0.917,7,45,1,1,0.531,0.644,0.778,52
columnist,0.917,3,22,1,1,0.646,0.365,0.648,25
adaptable,0.917,3,22,1,1,0.735,0.423,0.641,25
pantheon,0.917,3,22,1,1,0.144,0.41,0.61,25
readiness,0.917,3,22,1,1,0.708,0.531,0.7,25
intimately,0.917,19,114,1,1,0.806,0.573,0.59,133
tasteful,0.917,3,22,1,1,0.918,0.458,0.625,25
preposterous,0.917,3,22,1,1,0.167,0.827,0.483,25
molten,0.917,3,22,1,1,0.417,0.49,0.339,25
suburbia,0.917,7,45,1,1,0.438,0.49,0.421,52
ineptitude,0.917,7,45,1,1,0.177,0.471,0.25,52
sheik,0.917,3,22,1,1,0.521,0.579,0.708,25
bushy,0.917,3,22,1,1,0.562,0.321,0.427,25
recount,0.917,3,22,1,1,0.479,0.402,0.509,25
befall,0.917,3,22,1,1,0.52,0.663,0.585,25
regularity,0.917,3,22,1,1,0.663,0.337,0.585,25
hives,0.917,3,22,1,1,0.417,0.473,0.591,25
brackets,0.917,3,22,1,1,0.573,0.281,0.435,25
averse,0.917,3,22,1,1,0.253,0.569,0.492,25
reprehensible,0.917,3,22,1,1,0.316,0.569,0.351,25
published,0.916,85,494,1,1,0.667,0.429,0.57,579
function,0.915,151,874,1,1,0.694,0.296,0.618,1025
construction,0.915,32,189,1,1,0.848,0.612,0.759,221
surreal,0.915,49,287,1,1,0.55,0.529,0.67,336
bounds,0.914,16,97,1,1,0.378,0.426,0.604,113
occurrence,0.913,12,74,1,1,0.573,0.69,0.541,86
spontaneous,0.913,34,201,1,1,0.78,0.578,0.655,235
chasm,0.913,21,126,1,1,0.265,0.579,0.5,147
indicating,0.912,8,51,1,1,0.745,0.339,0.555,59
appreciative,0.912,26,155,1,1,0.857,0.38,0.654,181
blending,0.912,8,51,1,1,0.56,0.418,0.637,59
antisocial,0.912,148,860,1,1,0.146,0.686,0.391,1008
lifetime,0.911,365,2116,1,1,0.816,0.559,0.736,2481
transform,0.911,50,294,1,1,0.735,0.667,0.696,344
assess,0.91,13,80,1,1,0.698,0.5,0.623,93
shovel,0.91,13,80,1,1,0.427,0.308,0.267,93
par,0.91,60,352,1,1,0.615,0.372,0.429,412
contented,0.91,46,271,1,1,0.857,0.612,0.746,317
dreary,0.91,32,190,1,1,0.26,0.49,0.324,222
secure,0.91,118,688,1,1,0.844,0.38,0.914,806
resilience,0.909,38,225,1,1,0.531,0.44,0.667,263
microscope,0.908,4,28,1,1,0.531,0.33,0.464,32
endowed,0.908,4,28,1,1,0.755,0.51,0.769,32
outlines,0.908,4,28,1,1,0.656,0.402,0.651,32
crux,0.908,4,28,1,1,0.469,0.558,0.519,32
narrowing,0.908,4,28,1,1,0.354,0.593,0.357,32
hone,0.908,14,86,1,1,0.688,0.392,0.473,100
prompting,0.908,4,28,1,1,0.587,0.423,0.571,32
wring,0.908,4,28,1,1,0.36,0.656,0.348,32
quartet,0.908,9,57,1,1,0.479,0.377,0.472,66
psychedelic,0.908,9,57,1,1,0.45,0.63,0.482,66
recognizable,0.908,4,28,1,1,0.625,0.4,0.609,32
tripod,0.908,4,28,1,1,0.406,0.388,0.483,32
cheerfulness,0.908,4,28,1,1,0.969,0.802,0.675,32
avid,0.908,14,86,1,1,0.582,0.459,0.593,100
exhilaration,0.908,4,28,1,1,0.792,0.868,0.783,32
viper,0.908,4,28,1,1,0.173,0.846,0.632,32
deceitful,0.908,9,57,1,1,0.071,0.788,0.371,66
attribute,0.908,14,86,1,1,0.781,0.439,0.795,100
astronomy,0.908,9,57,1,1,0.613,0.474,0.722,66
undress,0.908,4,28,1,1,0.438,0.9,0.336,32
deepen,0.908,9,57,1,1,0.625,0.53,0.776,66
uncanny,0.908,9,57,1,1,0.469,0.461,0.43,66
cyclone,0.908,4,28,1,1,0.416,0.796,0.673,32
vane,0.908,4,28,1,1,0.561,0.28,0.231,32
achieve,0.907,200,1166,1,1,0.816,0.545,0.843,1366
brook,0.906,15,92,1,1,0.594,0.347,0.412,107
iced,0.905,37,220,1,1,0.564,0.482,0.339,257
paperback,0.905,10,63,1,1,0.633,0.269,0.314,73
artwork,0.905,43,255,1,1,0.896,0.368,0.679,298
flashlight,0.905,10,63,1,1,0.653,0.414,0.356,73
outlive,0.905,10,63,1,1,0.565,0.769,0.724,73
speech,0.904,199,1163,1,1,0.656,0.47,0.688,1362
contradiction,0.903,22,133,1,1,0.25,0.66,0.377,155
shall,0.903,577,3367,1,1,0.51,0.385,0.412,3944
madness,0.903,213,1246,1,1,0.104,0.804,0.44,1459
mantra,0.903,28,168,1,1,0.396,0.249,0.357,196
emperor,0.903,34,203,1,1,0.651,0.704,0.962,237
pacific,0.903,34,203,1,1,0.627,0.118,0.58,237
writer,0.903,368,2150,1,1,0.806,0.33,0.78,2518
comfy,0.903,111,652,1,1,0.93,0.241,0.625,763
conflict,0.902,94,553,1,1,0.335,0.906,0.471,647
texture,0.902,11,69,1,1,0.615,0.215,0.412,80
publication,0.902,17,104,1,1,0.549,0.47,0.6,121
insinuate,0.902,5,34,1,1,0.292,0.635,0.413,39
aspiration,0.902,5,34,1,1,0.704,0.724,0.675,39
molded,0.902,11,69,1,1,0.667,0.361,0.373,80
overgrown,0.902,11,69,1,1,0.333,0.5,0.369,80
swat,0.902,5,34,1,1,0.38,0.694,0.571,39
gallows,0.902,5,34,1,1,0.167,0.712,0.422,39
irreparable,0.902,5,34,1,1,0.061,0.53,0.43,39
rowdy,0.902,11,69,1,1,0.255,0.9,0.518,80
fictitious,0.902,5,34,1,1,0.224,0.444,0.293,39
charter,0.902,5,34,1,1,0.677,0.382,0.518,39
subconscious,0.901,49,291,1,1,0.531,0.375,0.415,340
limit,0.901,118,694,1,1,0.427,0.453,0.5,812
rigid,0.9,12,75,1,1,0.357,0.552,0.591,87
avenger,0.9,12,75,1,1,0.337,0.865,0.67,87
novelty,0.9,12,75,1,1,0.673,0.521,0.74,87
copyright,0.9,12,75,1,1,0.458,0.402,0.663,87
organized,0.899,33,198,1,1,0.816,0.337,0.746,231
clouds,0.898,241,1416,1,1,0.735,0.195,0.324,1657
antique,0.898,6,40,1,1,0.634,0.29,0.518,46
overpower,0.898,6,40,1,1,0.448,0.859,0.783,46
ensue,0.898,6,40,1,1,0.698,0.363,0.332,46
nuances,0.898,6,40,1,1,0.49,0.375,0.527,46
warrants,0.898,6,40,1,1,0.562,0.431,0.881,46
annihilation,0.898,6,40,1,1,0.041,0.8,0.591,46
penalty,0.898,27,163,1,1,0.062,0.49,0.24,190
windmill,0.898,6,40,1,1,0.773,0.412,0.412,46
sith,0.898,6,40,1,1,0.439,0.564,0.373,46
baffled,0.898,13,81,1,1,0.151,0.6,0.339,94
apprehensive,0.898,6,40,1,1,0.406,0.592,0.431,46
tenacity,0.898,6,40,1,1,0.74,0.657,0.889,46
caste,0.895,7,46,1,1,0.51,0.333,0.374,53
symposium,0.895,7,46,1,1,0.573,0.394,0.644,53
dreamland,0.895,7,46,1,1,0.844,0.471,0.566,53
seducing,0.895,7,46,1,1,0.569,0.794,0.708,53
druid,0.895,7,46,1,1,0.517,0.445,0.481,53
insight,0.894,90,534,1,1,0.613,0.363,0.649,624
adjust,0.894,57,340,1,1,0.647,0.327,0.638,397
learned,0.894,1018,5993,1,1,0.704,0.462,0.543,7011
iris,0.894,33,199,1,1,0.708,0.275,0.38,232
stargazing,0.894,16,99,1,1,0.802,0.461,0.709,115
language,0.894,379,2235,1,1,0.677,0.337,0.704,2614
balcony,0.893,52,311,1,1,0.562,0.392,0.38,363
expire,0.893,8,52,1,1,0.573,0.745,0.702,60
aforementioned,0.893,8,52,1,1,0.49,0.316,0.408,60
similarity,0.893,8,52,1,1,0.729,0.255,0.518,60
portable,0.893,8,52,1,1,0.615,0.356,0.582,60
submitting,0.893,8,52,1,1,0.667,0.61,0.611,60
cradle,0.893,17,105,1,1,0.776,0.194,0.333,122
chitchat,0.893,8,52,1,1,0.673,0.455,0.403,60
distinct,0.892,27,164,1,1,0.542,0.578,0.509,191
cider,0.892,18,111,1,1,0.53,0.346,0.398,129
burned,0.891,96,571,1,1,0.163,0.603,0.347,667
disservice,0.891,9,58,1,1,0.25,0.794,0.48,67
faithfulness,0.891,9,58,1,1,0.833,0.426,0.602,67
brutality,0.891,9,58,1,1,0.122,0.832,0.571,67
validity,0.891,9,58,1,1,0.646,0.47,0.706,67
mocha,0.891,9,58,1,1,0.5,0.396,0.311,67
whereabouts,0.891,9,58,1,1,0.439,0.382,0.356,67
present,0.89,469,2773,1,1,0.724,0.286,0.634,3242
reconcile,0.89,20,123,1,1,0.76,0.47,0.625,143
determine,0.89,42,253,1,1,0.612,0.368,0.776,295
hospitality,0.889,22,135,1,1,0.865,0.333,0.725,157
pond,0.888,57,342,1,1,0.52,0.337,0.358,399
cooperation,0.888,11,70,1,1,0.847,0.473,0.686,81
coexist,0.888,11,70,1,1,0.708,0.46,0.536,81
protection,0.888,97,579,1,1,0.863,0.53,0.664,676
wired,0.888,36,218,1,1,0.398,0.42,0.537,254
surveillance,0.887,12,76,1,1,0.365,0.72,0.718,88
seldom,0.886,41,248,1,1,0.323,0.379,0.287,289
faint,0.886,57,343,1,1,0.063,0.429,0.167,400
cemetery,0.885,43,260,1,1,0.051,0.63,0.417,303
region,0.885,43,260,1,1,0.54,0.295,0.712,303
gratifying,0.885,14,88,1,1,0.857,0.606,0.776,102
conviction,0.884,31,189,1,1,0.615,0.704,0.826,220
enigma,0.884,15,94,1,1,0.513,0.7,0.5,109
manifest,0.884,48,290,1,1,0.667,0.647,0.704,338
dexter,0.884,16,100,1,1,0.458,0.473,0.444,116
conditioning,0.884,16,100,1,1,0.44,0.468,0.617,116
battered,0.883,17,106,1,1,0.08,0.79,0.306,123
deserted,0.883,94,564,1,1,0.156,0.48,0.214,658
extraordinary,0.882,61,368,1,1,0.969,0.728,0.86,429
plague,0.881,49,297,1,1,0.083,0.596,0.355,346
gallery,0.879,69,417,1,1,0.659,0.433,0.569,486
mere,0.878,117,704,1,1,0.396,0.221,0.176,821
painter,0.878,42,256,1,1,0.677,0.366,0.487,298
toss,0.878,42,256,1,1,0.418,0.725,0.575,298
poems,0.876,155,933,1,1,0.833,0.388,0.418,1088
saint,0.876,102,616,1,1,0.812,0.24,0.693,718
guidance,0.876,102,616,1,1,0.729,0.471,0.718,718
excepting,0.874,4,29,1,1,0.408,0.413,0.526,33
highland,0.874,6,41,1,1,0.615,0.481,0.611,47
chaste,0.874,4,29,1,1,0.408,0.248,0.453,33
dismayed,0.874,4,29,1,1,0.165,0.735,0.389,33
faithless,0.874,3,23,1,1,0.102,0.683,0.304,26
stumped,0.874,3,23,1,1,0.344,0.604,0.392,26
watchful,0.874,4,29,1,1,0.386,0.49,0.675,33
recorder,0.874,4,29,1,1,0.551,0.374,0.481,33
reinforcements,0.874,3,23,1,1,0.646,0.719,0.875,26
electronics,0.874,13,83,1,1,0.708,0.545,0.574,96
ecstatic,0.874,28,173,1,1,0.875,0.769,0.742,201
expansion,0.874,15,95,1,1,0.776,0.618,0.787,110
elimination,0.874,3,23,1,1,0.052,0.667,0.431,26
limitation,0.874,4,29,1,1,0.19,0.431,0.225,33
antagonize,0.874,4,29,1,1,0.143,0.663,0.629,33
anointed,0.874,3,23,1,1,0.5,0.368,0.579,26
handwriting,0.874,8,53,1,1,0.615,0.378,0.381,61
feathered,0.874,6,41,1,1,0.438,0.288,0.214,47
espresso,0.874,10,65,1,1,0.677,0.62,0.508,75
unfounded,0.874,7,47,1,1,0.271,0.52,0.41,54
concluding,0.874,3,23,1,1,0.531,0.382,0.603,26
compliance,0.874,4,29,1,1,0.75,0.462,0.75,33
trance,0.874,14,89,1,1,0.469,0.481,0.382,103
infernal,0.874,3,23,1,1,0.083,0.837,0.571,26
patent,0.874,3,23,1,1,0.724,0.391,0.609,26
prodigal,0.874,3,23,1,1,0.643,0.491,0.66,26
tulip,0.874,7,47,1,1,0.73,0.189,0.356,54
decidedly,0.874,5,35,1,1,0.75,0.48,0.843,40
iota,0.874,5,35,1,1,0.344,0.385,0.314,40
hoof,0.874,3,23,1,1,0.427,0.341,0.365,26
mathematical,0.874,3,23,1,1,0.62,0.5,0.548,26
fated,0.874,21,131,1,1,0.582,0.472,0.692,152
bodily,0.874,12,77,1,1,0.594,0.481,0.557,89
moor,0.874,15,95,1,1,0.311,0.464,0.378,110
listless,0.874,9,59,1,1,0.219,0.35,0.231,68
technological,0.874,11,71,1,1,0.68,0.452,0.815,82
prosper,0.874,32,197,1,1,0.935,0.633,0.857,229
courtship,0.874,6,41,1,1,0.667,0.49,0.654,47
adhere,0.874,4,29,1,1,0.633,0.339,0.554,33
protocol,0.874,9,59,1,1,0.178,0.5,0.786,68
mesmerized,0.874,7,47,1,1,0.52,0.552,0.421,54
uproar,0.874,4,29,1,1,0.271,0.902,0.462,33
disable,0.874,5,35,1,1,0.115,0.43,0.269,40
blackberry,0.874,3,23,1,1,0.667,0.413,0.453,26
muster,0.874,25,155,1,1,0.635,0.46,0.548,180
nemesis,0.874,9,59,1,1,0.271,0.688,0.647,68
glint,0.874,4,29,1,1,0.677,0.538,0.541,33
tenant,0.874,5,35,1,1,0.385,0.36,0.398,40
beads,0.874,5,35,1,1,0.673,0.388,0.552,40
patronize,0.874,3,23,1,1,0.43,0.451,0.591,26
glitch,0.874,13,83,1,1,0.444,0.448,0.269,96
conversing,0.874,21,131,1,1,0.755,0.409,0.442,152
yonder,0.874,8,53,1,1,0.615,0.33,0.318,61
banker,0.874,6,41,1,1,0.586,0.588,0.792,47
comparative,0.874,3,23,1,1,0.47,0.273,0.562,26
unbecoming,0.874,4,29,1,1,0.123,0.471,0.288,33
gatekeeper,0.874,4,29,1,1,0.51,0.49,0.598,33
barricade,0.874,8,53,1,1,0.323,0.667,0.673,61
spacing,0.874,6,41,1,1,0.621,0.425,0.507,47
optional,0.874,17,107,1,1,0.755,0.35,0.44,124
motif,0.874,5,35,1,1,0.688,0.481,0.527,40
souvenir,0.874,4,29,1,1,0.844,0.311,0.466,33
ballerina,0.874,4,29,1,1,0.802,0.66,0.475,33
southeast,0.874,6,41,1,1,0.51,0.283,0.413,47
neurosis,0.874,3,23,1,1,0.122,0.766,0.418,26
delegation,0.874,3,23,1,1,0.562,0.431,0.609,26
unoccupied,0.874,3,23,1,1,0.258,0.245,0.412,26
thorough,0.874,8,53,1,1,0.467,0.35,0.558,61
animosity,0.874,6,41,1,1,0.51,0.724,0.545,47
gadget,0.874,4,29,1,1,0.635,0.559,0.382,33
bookish,0.874,7,47,1,1,0.604,0.236,0.43,54
charade,0.874,8,53,1,1,0.458,0.55,0.346,61
kernel,0.874,3,23,1,1,0.542,0.453,0.462,26
settler,0.874,4,29,1,1,0.573,0.453,0.519,33
contrived,0.874,6,41,1,1,0.408,0.53,0.458,47
disappearing,0.874,48,293,1,1,0.167,0.427,0.379,341
uncouth,0.874,3,23,1,1,0.08,0.761,0.35,26
battery,0.872,73,444,1,1,0.48,0.425,0.442,517
dusk,0.871,58,354,1,1,0.532,0.276,0.519,412
gazing,0.87,40,246,1,1,0.677,0.413,0.362,286
picnic,0.87,38,234,1,1,0.625,0.47,0.375,272
environment,0.87,265,1602,1,1,0.646,0.194,0.528,1867
oftentimes,0.867,23,144,1,1,0.571,0.5,0.482,167
delicate,0.867,45,277,1,1,0.583,0.294,0.366,322
dependence,0.866,21,132,1,1,0.25,0.451,0.433,153
glen,0.866,19,120,1,1,0.573,0.337,0.406,139
absurd,0.865,52,320,1,1,0.188,0.656,0.284,372
discourse,0.864,33,205,1,1,0.41,0.55,0.803,238
affections,0.864,16,102,1,1,0.76,0.547,0.655,118
supplies,0.864,32,199,1,1,0.698,0.39,0.595,231
messiah,0.864,15,96,1,1,0.781,0.634,0.8,111
maple,0.864,15,96,1,1,0.541,0.39,0.339,111
control,0.863,853,5178,1,1,0.729,0.352,0.808,6031
query,0.863,14,90,1,1,0.521,0.42,0.467,104
integration,0.863,14,90,1,1,0.771,0.48,0.737,104
dire,0.863,58,357,1,1,0.214,0.66,0.259,415
portrait,0.863,58,357,1,1,0.698,0.186,0.467,415
mankind,0.863,57,351,1,1,0.823,0.471,0.768,408
cosmos,0.863,28,175,1,1,0.86,0.478,0.664,203
petrified,0.862,13,84,1,1,0.221,0.625,0.232,97
provided,0.862,82,503,1,1,0.871,0.353,0.648,585
organic,0.862,26,163,1,1,0.719,0.343,0.535,189
clear,0.862,573,3486,1,1,0.857,0.327,0.573,4059
prep,0.862,39,242,1,1,0.688,0.509,0.555,281
win,0.861,876,5329,1,1,0.927,0.694,0.888,6205
profound,0.861,152,929,1,1,0.755,0.546,0.736,1081
anew,0.86,23,145,1,1,0.771,0.358,0.385,168
apocalyptic,0.86,11,72,1,1,0.173,0.88,0.75,83
relentless,0.86,35,218,1,1,0.333,0.713,0.904,253
art,0.86,1172,7137,1,1,0.812,0.36,0.603,8309
storytelling,0.86,22,139,1,1,0.643,0.375,0.472,161
aimless,0.859,21,133,1,1,0.15,0.267,0.183,154
formula,0.859,21,133,1,1,0.521,0.45,0.585,154
library,0.859,293,1790,1,1,0.776,0.122,0.549,2083
superhero,0.859,42,261,1,1,0.91,0.82,0.893,303
frequent,0.858,52,322,1,1,0.594,0.481,0.525,374
fiery,0.858,20,127,1,1,0.418,0.85,0.721,147
formation,0.857,19,121,1,1,0.615,0.453,0.731,140
underestimate,0.857,59,365,1,1,0.413,0.464,0.193,424
formative,0.857,9,60,1,1,0.688,0.442,0.8,69
succumb,0.857,37,231,1,1,0.202,0.787,0.292,268
artistry,0.856,8,54,1,1,0.823,0.346,0.769,62
fiddle,0.856,8,54,1,1,0.571,0.449,0.391,62
reboot,0.856,35,219,1,1,0.673,0.577,0.519,254
apocalypse,0.856,44,274,1,1,0.05,0.867,0.736,318
craft,0.855,79,488,1,1,0.76,0.321,0.539,567
fury,0.855,34,213,1,1,0.062,0.875,0.676,247
opportunity,0.855,416,2550,1,1,0.938,0.745,0.833,2966
vanishing,0.855,16,103,1,1,0.292,0.55,0.322,119
hectic,0.854,58,360,1,1,0.167,0.811,0.438,418
suffice,0.854,24,152,1,1,0.643,0.326,0.504,176
crispy,0.853,7,48,1,1,0.656,0.55,0.509,55
incompleteness,0.853,7,48,1,1,0.271,0.451,0.234,55
bathing,0.853,23,146,1,1,0.74,0.276,0.361,169
disclose,0.853,7,48,1,1,0.49,0.57,0.545,55
chardonnay,0.853,7,48,1,1,0.677,0.567,0.492,55
quartz,0.853,7,48,1,1,0.704,0.292,0.481,55
irks,0.853,7,48,1,1,0.276,0.781,0.339,55
belittled,0.853,7,48,1,1,0.177,0.392,0.226,55
fraction,0.853,15,97,1,1,0.417,0.33,0.4,112
sorcerer,0.853,7,48,1,1,0.377,0.633,0.632,55
critique,0.853,22,140,1,1,0.302,0.76,0.537,162
excluding,0.853,22,140,1,1,0.271,0.55,0.324,162
humanity,0.852,277,1704,1,1,0.75,0.36,0.727,1981
vivid,0.852,44,275,1,1,0.698,0.627,0.667,319
pillar,0.852,14,91,1,1,0.583,0.33,0.684,105
intellect,0.852,36,226,1,1,0.844,0.418,0.87,262
continually,0.852,43,269,1,1,0.646,0.438,0.698,312
arrogance,0.852,43,269,1,1,0.143,0.75,0.62,312
instinct,0.852,43,269,1,1,0.771,0.602,0.642,312
immense,0.851,101,625,1,1,0.755,0.75,0.811,726
pursuit,0.851,93,576,1,1,0.643,0.453,0.617,669
practitioner,0.85,6,42,1,1,0.704,0.497,0.684,48
cultured,0.85,6,42,1,1,0.635,0.429,0.625,48
entice,0.85,6,42,1,1,0.521,0.887,0.518,48
summarize,0.85,6,42,1,1,0.59,0.323,0.471,48
bellow,0.85,6,42,1,1,0.248,0.337,0.212,48
protect,0.85,441,2715,1,1,0.823,0.714,0.791,3156
caffeine,0.85,26,165,1,1,0.562,0.759,0.5,191
trivial,0.849,19,122,1,1,0.406,0.387,0.337,141
express,0.849,545,3357,1,1,0.76,0.623,0.691,3902
wild,0.849,767,4723,1,1,0.312,0.922,0.75,5490
repetition,0.849,12,79,1,1,0.375,0.519,0.396,91
pseudo,0.849,12,79,1,1,0.367,0.389,0.282,91
archive,0.849,12,79,1,1,0.438,0.294,0.527,91
mirage,0.848,31,196,1,1,0.546,0.487,0.562,227
dependent,0.848,120,744,1,1,0.354,0.455,0.404,864
pollution,0.848,18,116,1,1,0.062,0.694,0.445,134
motion,0.847,72,449,1,1,0.667,0.538,0.657,521
frozen,0.847,132,819,1,1,0.344,0.346,0.375,951
tool,0.847,119,739,1,1,0.49,0.35,0.594,858
thumping,0.847,5,36,1,1,0.214,0.755,0.566,41
staircase,0.847,11,73,1,1,0.469,0.347,0.44,84
forearm,0.847,5,36,1,1,0.469,0.304,0.509,41
transparent,0.847,35,221,1,1,0.542,0.33,0.667,256
bulk,0.847,11,73,1,1,0.469,0.413,0.509,84
deli,0.847,5,36,1,1,0.561,0.448,0.447,41
outspoken,0.847,11,73,1,1,0.582,0.413,0.667,84
utopian,0.847,5,36,1,1,0.542,0.327,0.552,41
sprawl,0.847,5,36,1,1,0.6,0.596,0.672,41
eclectic,0.847,5,36,1,1,0.646,0.542,0.508,41
seminary,0.847,5,36,1,1,0.594,0.367,0.589,41
skill,0.846,88,548,1,1,0.847,0.701,0.833,636
poisonous,0.845,22,141,1,1,0.102,0.87,0.533,163
proclaim,0.844,10,67,1,1,0.719,0.673,0.876,77
segregation,0.844,10,67,1,1,0.302,0.545,0.39,77
slender,0.844,10,67,1,1,0.812,0.548,0.664,77
continuity,0.844,10,67,1,1,0.781,0.439,0.684,77
tomb,0.844,37,234,1,1,0.112,0.5,0.343,271
jewel,0.843,15,98,1,1,0.827,0.588,0.625,113
lookout,0.843,15,98,1,1,0.698,0.538,0.639,113
coconut,0.843,15,98,1,1,0.622,0.265,0.227,113
cleaner,0.843,20,129,1,1,0.604,0.556,0.375,149
conform,0.843,20,129,1,1,0.479,0.38,0.375,149
bush,0.842,80,501,1,1,0.413,0.22,0.315,581
weep,0.842,161,1003,1,1,0.053,0.621,0.164,1164
guillotine,0.841,4,30,1,1,0.163,0.817,0.585,34
fatherhood,0.841,4,30,1,1,0.885,0.519,0.682,34
inning,0.841,4,30,1,1,0.602,0.315,0.52,34
malevolent,0.841,4,30,1,1,0.094,0.854,0.613,34
modesty,0.841,4,30,1,1,0.778,0.24,0.5,34
moonshine,0.841,4,30,1,1,0.633,0.389,0.491,34
heist,0.841,4,30,1,1,0.184,0.85,0.645,34
fallow,0.841,4,30,1,1,0.375,0.368,0.464,34
newsletter,0.841,9,61,1,1,0.622,0.385,0.49,70
cooperative,0.841,4,30,1,1,0.816,0.461,0.67,34
dialect,0.841,4,30,1,1,0.635,0.422,0.526,34
mustang,0.841,4,30,1,1,0.635,0.642,0.708,34
domesticated,0.841,4,30,1,1,0.635,0.36,0.294,34
rickety,0.841,4,30,1,1,0.224,0.402,0.241,34
atlas,0.841,19,123,1,1,0.531,0.306,0.554,142
inverse,0.841,4,30,1,1,0.459,0.337,0.319,34
heighten,0.841,4,30,1,1,0.755,0.622,0.765,34
gill,0.841,9,61,1,1,0.521,0.473,0.382,70
design,0.841,146,911,1,1,0.796,0.327,0.632,1057
haul,0.84,18,117,1,1,0.551,0.564,0.453,135
escape,0.839,804,5001,1,1,0.367,0.765,0.448,5805
candid,0.839,13,86,1,1,0.667,0.349,0.458,99
onward,0.839,13,86,1,1,0.667,0.538,0.741,99
tortured,0.839,73,459,1,1,0.062,0.89,0.361,532
spending,0.838,1008,6273,1,1,0.333,0.556,0.33,7281
lavender,0.838,31,198,1,1,0.812,0.198,0.388,229
review,0.838,135,845,1,1,0.667,0.408,0.636,980
weave,0.838,17,111,1,1,0.604,0.265,0.172,128
flint,0.838,8,55,1,1,0.521,0.439,0.536,63
hare,0.838,8,55,1,1,0.62,0.41,0.345,63
submit,0.838,44,279,1,1,0.635,0.448,0.5,323
cubicle,0.838,17,111,1,1,0.479,0.343,0.417,128
unstoppable,0.838,17,111,1,1,0.625,0.887,0.862,128
banquet,0.838,8,55,1,1,0.765,0.571,0.6,63
rhetorical,0.838,8,55,1,1,0.417,0.569,0.635,63
bubbling,0.838,8,55,1,1,0.5,0.438,0.384,63
bombing,0.838,8,55,1,1,0.167,0.963,0.732,63
northern,0.837,69,435,1,1,0.57,0.34,0.472,504
triumph,0.836,25,161,1,1,0.969,0.798,0.926,186
theology,0.836,12,80,1,1,0.448,0.33,0.711,92
singularity,0.836,25,161,1,1,0.582,0.348,0.654,186
sharp,0.836,98,616,1,1,0.459,0.585,0.585,714
thief,0.836,46,292,1,1,0.088,0.888,0.443,338
persistence,0.836,16,105,1,1,0.684,0.611,0.873,121
gradually,0.835,54,342,1,1,0.583,0.385,0.464,396
hangover,0.834,32,205,1,1,0.188,0.565,0.267,237
society,0.834,1124,7022,1,1,0.674,0.464,0.782,8146
ludicrous,0.833,7,49,1,1,0.137,0.553,0.274,56
minimize,0.833,11,74,1,1,0.36,0.236,0.311,85
definite,0.833,19,124,1,1,0.708,0.292,0.741,143
granola,0.833,3,24,1,1,0.625,0.24,0.281,27
uncompromising,0.833,3,24,1,1,0.32,0.531,0.613,27
expectation,0.833,55,349,1,1,0.771,0.69,0.707,404
piping,0.833,3,24,1,1,0.365,0.337,0.405,27
proximity,0.833,27,174,1,1,0.677,0.508,0.569,201
exemplary,0.833,3,24,1,1,0.833,0.343,0.729,27
alas,0.833,83,524,1,1,0.571,0.31,0.279,607
complacent,0.833,11,74,1,1,0.625,0.452,0.518,85
uprising,0.833,3,24,1,1,0.561,0.777,0.704,27
golf,0.833,87,549,1,1,0.573,0.358,0.447,636
felony,0.833,3,24,1,1,0.206,0.808,0.472,27
photogenic,0.833,3,24,1,1,0.78,0.5,0.495,27
turntable,0.833,3,24,1,1,0.531,0.455,0.406,27
underprivileged,0.833,3,24,1,1,0.167,0.449,0.172,27
budding,0.833,7,49,1,1,0.49,0.5,0.355,56
godlike,0.833,3,24,1,1,0.854,0.648,0.87,27
addendum,0.833,3,24,1,1,0.392,0.37,0.418,27
nitwit,0.833,3,24,1,1,0.146,0.606,0.139,27
haughty,0.833,3,24,1,1,0.24,0.708,0.588,27
leper,0.833,3,24,1,1,0.075,0.589,0.206,27
vigilant,0.833,7,49,1,1,0.469,0.643,0.791,56
brotherly,0.833,3,24,1,1,0.865,0.306,0.596,27
taker,0.833,7,49,1,1,0.375,0.521,0.618,56
headstrong,0.833,3,24,1,1,0.31,0.714,0.5,27
compulsion,0.833,11,74,1,1,0.118,0.76,0.604,85
fascination,0.833,11,74,1,1,0.885,0.773,0.835,85
misfortune,0.832,38,243,1,1,0.094,0.78,0.311,281
convert,0.832,34,218,1,1,0.551,0.538,0.704,252
resonate,0.831,41,262,1,1,0.582,0.61,0.644,303
drained,0.831,140,882,1,1,0.31,0.441,0.352,1022
hardened,0.831,14,93,1,1,0.406,0.618,0.764,107
kindred,0.83,25,162,1,1,0.76,0.418,0.517,187
stagnant,0.83,25,162,1,1,0.3,0.5,0.208,187
paradox,0.83,47,300,1,1,0.417,0.442,0.482,347
distant,0.83,342,2150,1,1,0.229,0.324,0.269,2492
modeling,0.83,10,68,1,1,0.684,0.404,0.49,78
viewpoint,0.83,10,68,1,1,0.673,0.306,0.644,78
portfolio,0.83,10,68,1,1,0.625,0.28,0.498,78
barge,0.83,10,68,1,1,0.469,0.388,0.465,78
chimes,0.83,10,68,1,1,0.625,0.49,0.402,78
contempt,0.83,32,206,1,1,0.206,0.635,0.396,238
crammed,0.827,6,43,1,1,0.406,0.74,0.466,49
tapestry,0.827,6,43,1,1,0.52,0.176,0.362,49
motorbike,0.827,6,43,1,1,0.552,0.608,0.616,49
vigilante,0.827,6,43,1,1,0.418,0.627,0.72,49
river,0.827,270,1703,1,1,0.688,0.392,0.605,1973
linger,0.826,40,257,1,1,0.48,0.311,0.412,297
location,0.826,137,868,1,1,0.615,0.375,0.546,1005
martini,0.825,9,62,1,1,0.828,0.5,0.519,71
paddy,0.825,9,62,1,1,0.653,0.33,0.33,71
fallacy,0.825,9,62,1,1,0.112,0.561,0.43,71
disposal,0.825,9,62,1,1,0.135,0.608,0.396,71
incomparable,0.825,9,62,1,1,0.625,0.577,0.67,71
nod,0.825,52,333,1,1,0.59,0.367,0.427,385
playoff,0.824,12,81,1,1,0.622,0.716,0.55,93
plethora,0.824,12,81,1,1,0.646,0.602,0.547,93
vast,0.824,232,1469,1,1,0.52,0.535,0.545,1701
nocturnal,0.823,31,201,1,1,0.54,0.5,0.462,232
subjected,0.823,15,100,1,1,0.286,0.52,0.221,115
nerves,0.823,72,460,1,1,0.333,0.783,0.264,532
gathering,0.823,91,580,1,1,0.854,0.657,0.667,671
malicious,0.823,18,119,1,1,0.177,0.765,0.607,137
rising,0.822,134,852,1,1,0.75,0.602,0.696,986
compelled,0.822,24,157,1,1,0.333,0.654,0.347,181
enthusiasm,0.822,30,195,1,1,0.938,0.816,0.798,225
oasis,0.821,45,290,1,1,0.796,0.283,0.429,335
healthy,0.82,678,4298,1,1,0.938,0.319,0.818,4976
installation,0.82,8,56,1,1,0.656,0.469,0.759,64
bog,0.82,11,75,1,1,0.302,0.361,0.365,86
broaden,0.82,5,37,1,1,0.678,0.602,0.61,42
smoothie,0.82,8,56,1,1,0.806,0.333,0.281,64
renaissance,0.82,8,56,1,1,0.771,0.67,0.767,64
flapping,0.82,5,37,1,1,0.458,0.728,0.404,42
development,0.82,125,797,1,1,0.827,0.5,0.796,922
delirium,0.82,5,37,1,1,0.233,0.694,0.484,42
deem,0.82,11,75,1,1,0.594,0.529,0.69,86
bygone,0.82,5,37,1,1,0.229,0.31,0.315,42
builder,0.82,8,56,1,1,0.66,0.642,0.701,64
hunky,0.82,5,37,1,1,0.469,0.571,0.438,42
shrivel,0.82,8,56,1,1,0.16,0.409,0.143,64
conduct,0.82,17,113,1,1,0.453,0.51,0.75,130
pierce,0.82,29,189,1,1,0.365,0.67,0.611,218
pulp,0.82,11,75,1,1,0.469,0.231,0.324,86
fiber,0.82,11,75,1,1,0.719,0.284,0.39,86
avenge,0.82,5,37,1,1,0.073,0.867,0.559,42
drones,0.82,11,75,1,1,0.398,0.577,0.588,86
hologram,0.82,11,75,1,1,0.615,0.461,0.575,86
placid,0.82,8,56,1,1,0.64,0.317,0.491,64
competent,0.82,14,94,1,1,0.865,0.56,0.904,108
pronounce,0.82,11,75,1,1,0.653,0.52,0.563,86
personal,0.819,1022,6483,1,1,0.75,0.311,0.467,7505
wood,0.819,126,804,1,1,0.494,0.182,0.373,930
greatest,0.819,494,3138,1,1,0.847,0.627,0.922,3632
air,0.817,798,5072,1,1,0.708,0.163,0.427,5870
caretaker,0.817,19,126,1,1,0.714,0.531,0.759,145
ongoing,0.817,50,323,1,1,0.674,0.484,0.556,373
closeness,0.817,47,304,1,1,0.796,0.237,0.45,351
brethren,0.816,13,88,1,1,0.917,0.38,0.641,101
intolerable,0.816,13,88,1,1,0.146,0.66,0.439,101
digest,0.816,27,177,1,1,0.72,0.413,0.483,204
satisfaction,0.816,110,705,1,1,0.939,0.637,0.673,815
detrimental,0.816,35,228,1,1,0.203,0.679,0.387,263
surface,0.815,134,858,1,1,0.448,0.375,0.604,992
scales,0.815,10,69,1,1,0.439,0.33,0.491,79
daydreaming,0.815,32,209,1,1,0.776,0.36,0.479,241
tidy,0.815,10,69,1,1,0.76,0.208,0.647,79
sulk,0.815,29,190,1,1,0.25,0.58,0.406,219
fountain,0.815,29,190,1,1,0.704,0.292,0.559,219
damp,0.815,29,190,1,1,0.36,0.279,0.21,219
protected,0.815,67,432,1,1,0.854,0.378,0.709,499
rugby,0.814,18,120,1,1,0.677,0.82,0.708,138
painted,0.814,72,464,1,1,0.667,0.333,0.424,536
suitable,0.814,42,273,1,1,0.792,0.298,0.722,315
grace,0.814,270,1726,1,1,0.906,0.304,0.462,1996
gate,0.814,66,426,1,1,0.51,0.235,0.426,492
holiness,0.813,15,101,1,1,0.86,0.264,0.742,116
jammed,0.813,7,50,1,1,0.235,0.817,0.411,57
invoke,0.813,7,50,1,1,0.583,0.74,0.579,57
sapphire,0.813,7,50,1,1,0.77,0.472,0.651,57
plantation,0.813,7,50,1,1,0.573,0.585,0.575,57
crank,0.813,15,101,1,1,0.448,0.275,0.417,116
aftermath,0.813,28,184,1,1,0.312,0.449,0.444,212
infant,0.812,20,133,1,1,0.802,0.431,0.328,153
separation,0.812,134,861,1,1,0.198,0.592,0.409,995
science,0.811,189,1213,1,1,0.588,0.429,0.741,1402
heal,0.811,489,3130,1,1,0.765,0.245,0.556,3619
harmony,0.81,98,632,1,1,0.949,0.23,0.509,730
racer,0.809,4,31,1,1,0.48,0.631,0.678,35
negotiation,0.809,4,31,1,1,0.49,0.615,0.728,35
heir,0.809,14,95,1,1,0.84,0.654,0.764,109
rigorous,0.809,4,31,1,1,0.438,0.818,0.847,35
screenplay,0.809,9,63,1,1,0.5,0.406,0.518,72
cauliflower,0.809,4,31,1,1,0.448,0.255,0.231,35
wight,0.809,4,31,1,1,0.542,0.404,0.395,35
symmetry,0.809,4,31,1,1,0.604,0.274,0.5,35
fixer,0.809,4,31,1,1,0.633,0.375,0.606,35
rationale,0.809,4,31,1,1,0.656,0.4,0.815,35
hijack,0.809,4,31,1,1,0.042,0.908,0.594,35
nineteen,0.809,9,63,1,1,0.673,0.304,0.375,72
timely,0.808,21,140,1,1,0.865,0.387,0.591,161
communism,0.807,11,76,1,1,0.264,0.57,0.623,87
adjacent,0.807,11,76,1,1,0.645,0.276,0.536,87
exhilarating,0.806,18,121,1,1,0.917,0.823,0.81,139
spent,0.806,1320,8486,1,1,0.296,0.296,0.263,9806
subtle,0.805,67,436,1,1,0.708,0.167,0.228,503
ideal,0.805,151,976,1,1,0.802,0.437,0.736,1127
mesa,0.805,6,44,1,1,0.604,0.191,0.319,50
cater,0.805,20,134,1,1,0.802,0.5,0.509,154
drizzle,0.805,6,44,1,1,0.521,0.353,0.319,50
simplistic,0.805,6,44,1,1,0.49,0.245,0.391,50
isle,0.804,36,237,1,1,0.667,0.39,0.443,273
drenched,0.804,22,147,1,1,0.302,0.361,0.388,169
brooding,0.804,31,205,1,1,0.327,0.367,0.333,236
dual,0.804,15,102,1,1,0.573,0.33,0.384,117
perspective,0.803,260,1680,1,1,0.688,0.47,0.704,1940
stint,0.803,8,57,1,1,0.49,0.326,0.342,65
scrape,0.803,8,57,1,1,0.365,0.615,0.384,65
whimsical,0.803,8,57,1,1,0.449,0.637,0.371,65
detour,0.803,8,57,1,1,0.398,0.539,0.309,65
damnation,0.803,8,57,1,1,0.135,0.75,0.416,65
unselfish,0.803,8,57,1,1,0.615,0.353,0.377,65
masterful,0.803,8,57,1,1,0.854,0.51,0.96,65
unimaginable,0.803,17,115,1,1,0.573,0.634,0.589,132
melancholy,0.802,179,1160,1,1,0.188,0.26,0.237,1339
leverage,0.801,10,70,1,1,0.459,0.5,0.629,80
gritty,0.801,10,70,1,1,0.417,0.373,0.375,80
mesh,0.801,10,70,1,1,0.429,0.235,0.371,80
insect,0.801,10,70,1,1,0.276,0.633,0.242,80
progression,0.8,23,154,1,1,0.74,0.562,0.8,177
process,0.8,634,4102,1,1,0.51,0.471,0.615,4736
myriad,0.8,12,83,1,1,0.48,0.429,0.55,95
gleam,0.8,12,83,1,1,0.781,0.52,0.741,95
civilian,0.8,12,83,1,1,0.7,0.229,0.598,95
falsehood,0.8,12,83,1,1,0.031,0.625,0.384,95
forgiveness,0.8,90,587,1,1,0.667,0.43,0.471,677
theft,0.799,14,96,1,1,0.135,0.867,0.394,110
concentrate,0.799,78,510,1,1,0.75,0.439,0.743,588
sophisticated,0.799,16,109,1,1,0.865,0.481,0.845,125
staggering,0.799,16,109,1,1,0.52,0.657,0.683,125
extensive,0.799,16,109,1,1,0.635,0.52,0.76,125
hassle,0.798,18,122,1,1,0.177,0.74,0.489,140
ruler,0.798,18,122,1,1,0.44,0.4,0.631,140
wounded,0.798,64,420,1,1,0.115,0.77,0.275,484
disguised,0.797,22,148,1,1,0.5,0.615,0.326,170
muse,0.797,76,498,1,1,0.76,0.36,0.509,574
tourist,0.796,38,252,1,1,0.745,0.48,0.43,290
deploy,0.794,3,25,1,1,0.5,0.52,0.585,28
funnel,0.794,3,25,1,1,0.354,0.274,0.336,28
multiplied,0.794,7,51,1,1,0.802,0.559,0.729,58
enhance,0.794,21,142,1,1,0.802,0.578,0.814,163
whiskers,0.794,3,25,1,1,0.439,0.278,0.27,28
reproach,0.794,3,25,1,1,0.24,0.755,0.384,28
sentencing,0.794,5,38,1,1,0.12,0.782,0.561,43
elastic,0.794,3,25,1,1,0.656,0.518,0.385,28
benevolent,0.794,7,51,1,1,0.786,0.407,0.651,58
slope,0.794,13,90,1,1,0.347,0.438,0.279,103
intolerant,0.794,13,90,1,1,0.135,0.676,0.509,103
arrange,0.794,31,207,1,1,0.74,0.49,0.571,238
carp,0.794,5,38,1,1,0.531,0.324,0.375,43
doable,0.794,7,51,1,1,0.76,0.404,0.675,58
emulate,0.794,7,51,1,1,0.438,0.34,0.549,58
diplomat,0.794,3,25,1,1,0.563,0.262,0.868,28
simulated,0.794,3,25,1,1,0.5,0.461,0.356,28
inquire,0.794,7,51,1,1,0.583,0.519,0.363,58
padded,0.794,9,64,1,1,0.606,0.212,0.371,73
lac,0.794,3,25,1,1,0.408,0.418,0.331,28
suspense,0.794,9,64,1,1,0.286,0.775,0.402,73
liberate,0.794,9,64,1,1,0.76,0.632,0.708,73
cleanup,0.794,3,25,1,1,0.729,0.314,0.451,28
unlock,0.794,21,142,1,1,0.582,0.442,0.592,163
degeneracy,0.794,3,25,1,1,0.143,0.72,0.298,28
farce,0.794,7,51,1,1,0.265,0.667,0.246,58
coven,0.794,9,64,1,1,0.458,0.578,0.591,73
hearty,0.794,7,51,1,1,0.76,0.684,0.792,58
cyclist,0.794,5,38,1,1,0.684,0.582,0.576,43
vocalist,0.794,13,90,1,1,0.688,0.596,0.596,103
interchangeable,0.794,3,25,1,1,0.615,0.459,0.526,28
sorcery,0.794,5,38,1,1,0.279,0.74,0.64,43
dearth,0.794,5,38,1,1,0.156,0.539,0.255,43
commerce,0.794,3,25,1,1,0.646,0.5,0.788,28
flutter,0.794,15,103,1,1,0.479,0.548,0.33,118
loom,0.794,5,38,1,1,0.531,0.245,0.325,43
shipwreck,0.794,5,38,1,1,0.268,0.768,0.373,43
titan,0.794,21,142,1,1,0.598,0.653,0.811,163
conceive,0.794,9,64,1,1,0.708,0.538,0.7,73
wounds,0.793,105,689,1,1,0.102,0.735,0.345,794
genius,0.792,215,1406,1,1,0.878,0.667,0.846,1621
opposed,0.791,59,390,1,1,0.092,0.46,0.606,449
akin,0.791,28,188,1,1,0.639,0.343,0.523,216
attitude,0.791,323,2111,1,1,0.76,0.644,0.861,2434
pi,0.789,16,110,1,1,0.469,0.265,0.4,126
prime,0.789,125,822,1,1,0.708,0.275,0.446,947
alternate,0.789,46,306,1,1,0.625,0.363,0.589,352
singular,0.789,61,404,1,1,0.61,0.302,0.482,465
swiftly,0.789,14,97,1,1,0.66,0.885,0.618,111
shack,0.788,27,182,1,1,0.396,0.425,0.339,209
taught,0.788,466,3052,1,1,0.814,0.481,0.642,3518
forces,0.788,118,777,1,1,0.551,0.686,0.886,895
piles,0.788,12,84,1,1,0.469,0.423,0.468,96
pending,0.788,12,84,1,1,0.396,0.441,0.473,96
absorbed,0.788,36,241,1,1,0.49,0.471,0.519,277
ministry,0.788,71,470,1,1,0.51,0.346,0.717,541
immortality,0.787,34,228,1,1,0.688,0.635,0.861,262
willingness,0.787,21,143,1,1,0.786,0.5,0.729,164
bending,0.787,10,71,1,1,0.448,0.565,0.455,81
cramped,0.787,10,71,1,1,0.24,0.567,0.36,81
impatience,0.787,10,71,1,1,0.278,0.78,0.411,81
destruction,0.787,96,634,1,1,0.102,0.929,0.613,730
afar,0.786,48,320,1,1,0.396,0.373,0.358,368
curiosity,0.786,66,438,1,1,0.75,0.755,0.463,504
impotence,0.785,8,58,1,1,0.198,0.689,0.224,66
commend,0.785,8,58,1,1,0.906,0.694,0.711,66
weeping,0.785,58,386,1,1,0.082,0.688,0.168,444
measure,0.784,93,616,1,1,0.51,0.375,0.365,709
continue,0.784,819,5384,1,1,0.63,0.427,0.612,6203
remain,0.783,516,3395,1,1,0.709,0.365,0.731,3911
integrity,0.783,71,472,1,1,0.865,0.413,0.848,543
nigh,0.783,20,137,1,1,0.653,0.216,0.336,157
reasoning,0.783,34,229,1,1,0.729,0.365,0.729,263
surly,0.783,6,45,1,1,0.221,0.469,0.493,51
snooze,0.783,6,45,1,1,0.235,0.357,0.282,51
swagger,0.783,6,45,1,1,0.333,0.731,0.538,51
shortcut,0.783,6,45,1,1,0.594,0.308,0.426,51
blueprint,0.783,6,45,1,1,0.49,0.173,0.425,51
forlorn,0.782,42,282,1,1,0.316,0.571,0.217,324
canceling,0.781,11,78,1,1,0.229,0.47,0.349,89
camper,0.781,11,78,1,1,0.573,0.529,0.482,89
inferno,0.781,11,78,1,1,0.051,0.857,0.463,89
neglecting,0.781,23,157,1,1,0.177,0.441,0.23,180
mourning,0.781,64,427,1,1,0.177,0.49,0.266,491
port,0.781,40,269,1,1,0.55,0.409,0.513,309
backyard,0.781,45,302,1,1,0.552,0.28,0.302,347
ferry,0.78,16,111,1,1,0.604,0.509,0.389,127
involvement,0.78,16,111,1,1,0.76,0.62,0.696,127
bend,0.78,48,322,1,1,0.571,0.324,0.368,370
volumes,0.78,31,210,1,1,0.552,0.452,0.52,241
dose,0.779,88,586,1,1,0.458,0.49,0.427,674
jazz,0.779,76,507,1,1,0.677,0.362,0.45,583
casualty,0.779,4,32,1,1,0.235,0.274,0.132,36
unwavering,0.779,9,65,1,1,0.74,0.63,0.858,74
concoction,0.779,4,32,1,1,0.448,0.459,0.417,36
newcomer,0.779,4,32,1,1,0.622,0.38,0.396,36
swimmer,0.779,4,32,1,1,0.657,0.698,0.61,36
keg,0.779,4,32,1,1,0.551,0.389,0.404,36
dependable,0.779,9,65,1,1,0.88,0.357,0.741,74
override,0.779,4,32,1,1,0.316,0.491,0.529,36
rapport,0.779,4,32,1,1,0.771,0.664,0.567,36
groundhog,0.779,4,32,1,1,0.385,0.324,0.377,36
barbarian,0.779,4,32,1,1,0.323,0.896,0.713,36
unyielding,0.779,4,32,1,1,0.367,0.806,0.738,36
visage,0.779,9,65,1,1,0.7,0.361,0.482,74
allotment,0.779,4,32,1,1,0.6,0.39,0.64,36
badger,0.779,9,65,1,1,0.344,0.429,0.357,74
grandiose,0.779,4,32,1,1,0.9,0.682,0.864,36
midtown,0.779,4,32,1,1,0.479,0.442,0.538,36
regrettable,0.779,4,32,1,1,0.104,0.374,0.245,36
boiler,0.779,4,32,1,1,0.561,0.59,0.509,36
overdue,0.779,19,131,1,1,0.125,0.427,0.259,150
mammoth,0.779,4,32,1,1,0.48,0.471,0.537,36
eagle,0.778,42,283,1,1,0.604,0.594,0.679,325
isolation,0.777,2019,13357,1,1,0.198,0.338,0.339,15376
stride,0.776,12,85,1,1,0.49,0.67,0.434,97
addicted,0.776,229,1521,1,1,0.156,0.712,0.483,1750
inhale,0.776,20,138,1,1,0.427,0.34,0.492,158
poverty,0.776,414,2746,1,1,0.071,0.519,0.183,3160
rocks,0.775,118,787,1,1,0.365,0.209,0.543,905
gracious,0.775,39,264,1,1,0.918,0.634,0.637,303
raider,0.775,7,52,1,1,0.302,0.86,0.525,59
reckoning,0.775,7,52,1,1,0.418,0.622,0.532,59
variation,0.775,7,52,1,1,0.635,0.561,0.406,59
mound,0.775,7,52,1,1,0.52,0.481,0.509,59
critter,0.775,7,52,1,1,0.542,0.539,0.482,59
stadium,0.775,55,370,1,1,0.635,0.679,0.611,425
tracing,0.775,7,52,1,1,0.418,0.591,0.565,59
salt,0.775,90,602,1,1,0.323,0.312,0.306,692
dimensional,0.773,10,72,1,1,0.561,0.484,0.596,82
unbalanced,0.773,10,72,1,1,0.302,0.596,0.343,82
defy,0.773,10,72,1,1,0.353,0.884,0.657,82
aspire,0.772,27,185,1,1,0.812,0.469,0.722,212
consequence,0.772,44,298,1,1,0.24,0.721,0.593,342
devour,0.772,30,205,1,1,0.344,0.888,0.574,235
efficient,0.771,19,132,1,1,0.959,0.604,0.83,151
blossom,0.771,45,305,1,1,0.792,0.275,0.309,350
fascinating,0.77,90,605,1,1,0.979,0.817,0.784,695
cellar,0.769,11,79,1,1,0.51,0.277,0.406,90
outing,0.769,23,159,1,1,0.771,0.672,0.634,182
queues,0.769,5,39,1,1,0.385,0.479,0.269,44
vanquished,0.769,5,39,1,1,0.496,0.529,0.176,44
namesake,0.769,5,39,1,1,0.418,0.327,0.404,44
mimic,0.769,11,79,1,1,0.557,0.587,0.391,90
chestnut,0.769,5,39,1,1,0.714,0.21,0.294,44
procrastination,0.769,17,119,1,1,0.323,0.43,0.491,136
concur,0.769,8,59,1,1,0.459,0.394,0.429,67
gravitational,0.769,5,39,1,1,0.528,0.51,0.691,44
vibrate,0.769,11,79,1,1,0.5,0.698,0.604,90
stationary,0.769,5,39,1,1,0.408,0.24,0.484,44
tracker,0.769,5,39,1,1,0.398,0.744,0.731,44
currency,0.769,14,99,1,1,0.583,0.418,0.592,113
checkmate,0.769,5,39,1,1,0.667,0.708,0.75,44
violation,0.769,5,39,1,1,0.083,0.892,0.413,44
pathology,0.769,5,39,1,1,0.271,0.56,0.558,44
backpack,0.769,23,159,1,1,0.729,0.278,0.333,182
dazzling,0.769,8,59,1,1,0.854,0.88,0.767,67
dingy,0.769,5,39,1,1,0.156,0.483,0.343,44
beagle,0.769,8,59,1,1,0.649,0.47,0.395,67
diner,0.769,35,239,1,1,0.643,0.302,0.538,274
bearing,0.769,35,239,1,1,0.571,0.367,0.474,274
sociology,0.769,8,59,1,1,0.615,0.439,0.694,67
exchange,0.768,160,1073,1,1,0.74,0.569,0.491,1233
darkness,0.768,1266,8454,1,1,0.102,0.602,0.418,9720
rewarding,0.768,88,593,1,1,0.958,0.637,0.783,681
courageous,0.767,39,266,1,1,0.918,0.587,0.879,305
naturally,0.767,152,1021,1,1,0.854,0.276,0.549,1173
default,0.766,62,420,1,1,0.459,0.343,0.712,482
developer,0.766,15,106,1,1,0.844,0.653,0.864,121
command,0.765,38,260,1,1,0.427,0.79,0.849,298
watcher,0.765,12,86,1,1,0.562,0.401,0.702,98
shun,0.764,22,153,1,1,0.418,0.604,0.389,175
implication,0.764,9,66,1,1,0.337,0.528,0.69,75
foam,0.764,9,66,1,1,0.698,0.23,0.204,75
quarters,0.764,19,133,1,1,0.51,0.412,0.48,152
sharpen,0.764,9,66,1,1,0.582,0.694,0.611,75
dove,0.763,33,227,1,1,0.729,0.235,0.437,260
wheat,0.763,16,113,1,1,0.531,0.185,0.25,129
cocoa,0.763,16,113,1,1,0.776,0.255,0.322,129
bubble,0.762,181,1220,1,1,0.774,0.213,0.364,1401
return,0.762,631,4240,1,1,0.602,0.412,0.463,4871
thoughts,0.762,2175,14604,1,1,0.745,0.382,0.691,16779
dispersed,0.762,6,46,1,1,0.344,0.49,0.274,52
darkly,0.762,6,46,1,1,0.219,0.548,0.443,52
torrent,0.762,6,46,1,1,0.541,0.745,0.676,52
superiority,0.762,20,140,1,1,0.582,0.602,0.959,160
cup,0.76,361,2434,1,1,0.615,0.167,0.231,2795
north,0.759,269,1816,1,1,0.531,0.255,0.45,2085
hidden,0.758,268,1812,1,1,0.208,0.43,0.327,2080
verbal,0.757,30,208,1,1,0.52,0.291,0.562,238
gentle,0.757,213,1443,1,1,0.847,0.353,0.589,1656
orchid,0.756,7,53,1,1,0.84,0.345,0.382,60
slammer,0.756,3,26,1,1,0.417,0.565,0.391,29
permit,0.756,11,80,1,1,0.733,0.349,0.518,91
hazardous,0.756,3,26,1,1,0.061,0.75,0.67,29
babbling,0.756,11,80,1,1,0.396,0.418,0.241,91
seeker,0.756,71,485,1,1,0.646,0.464,0.553,556
creak,0.756,3,26,1,1,0.344,0.67,0.411,29
specs,0.756,3,26,1,1,0.54,0.398,0.618,29
correspondence,0.756,3,26,1,1,0.663,0.423,0.491,29
drawback,0.756,3,26,1,1,0.302,0.422,0.148,29
fatigued,0.756,7,53,1,1,0.146,0.433,0.245,60
deterrent,0.756,3,26,1,1,0.292,0.461,0.385,29
anemone,0.756,3,26,1,1,0.552,0.538,0.327,29
expectant,0.756,3,26,1,1,0.708,0.65,0.474,29
extinguish,0.756,3,26,1,1,0.24,0.576,0.482,29
veneer,0.756,3,26,1,1,0.49,0.265,0.289,29
acclaim,0.756,3,26,1,1,0.562,0.809,0.718,29
overlapping,0.756,3,26,1,1,0.595,0.578,0.684,29
mariner,0.756,3,26,1,1,0.652,0.491,0.676,29
robbery,0.756,7,53,1,1,0.133,0.843,0.435,60
canal,0.756,11,80,1,1,0.673,0.259,0.321,91
pathos,0.756,7,53,1,1,0.35,0.449,0.462,60
compliant,0.756,3,26,1,1,0.677,0.31,0.519,29
standby,0.756,7,53,1,1,0.26,0.224,0.386,60
registry,0.756,3,26,1,1,0.573,0.32,0.583,29
flesh,0.756,99,674,1,1,0.604,0.39,0.475,773
martyrdom,0.756,3,26,1,1,0.323,0.745,0.442,29
outstretched,0.756,3,26,1,1,0.448,0.481,0.519,29
dissent,0.756,7,53,1,1,0.3,0.655,0.407,60
suffocation,0.756,7,53,1,1,0.02,0.83,0.462,60
obscured,0.756,3,26,1,1,0.115,0.356,0.298,29
immediate,0.756,68,465,1,1,0.656,0.548,0.716,533
conscious,0.756,113,769,1,1,0.74,0.333,0.705,882
preservation,0.755,24,168,1,1,0.667,0.51,0.686,192
ark,0.754,20,141,1,1,0.396,0.427,0.543,161
encounter,0.754,92,628,1,1,0.865,0.702,0.689,720
prepare,0.754,143,973,1,1,0.656,0.542,0.603,1116
catholic,0.754,72,493,1,1,0.646,0.24,0.575,565
desirable,0.753,25,175,1,1,0.74,0.735,0.75,200
antsy,0.752,8,60,1,1,0.449,0.558,0.417,68
shadowy,0.752,8,60,1,1,0.135,0.373,0.33,68
binding,0.752,8,60,1,1,0.438,0.425,0.64,68
rationalize,0.752,8,60,1,1,0.633,0.4,0.746,68
thrice,0.752,8,60,1,1,0.469,0.442,0.462,68
housework,0.752,8,60,1,1,0.484,0.413,0.342,68
sand,0.751,151,1030,1,1,0.582,0.279,0.304,1181
prior,0.751,59,406,1,1,0.468,0.35,0.417,465
palmer,0.751,13,94,1,1,0.48,0.269,0.413,107
obliged,0.751,13,94,1,1,0.327,0.68,0.411,107
foggy,0.75,23,162,1,1,0.354,0.337,0.302,185
underground,0.75,52,359,1,1,0.396,0.455,0.452,411
molestation,0.749,4,33,1,1,0.102,0.808,0.407,37
visitation,0.749,4,33,1,1,0.729,0.346,0.534,37
tangerine,0.749,4,33,1,1,0.571,0.271,0.395,37
wording,0.749,9,67,1,1,0.653,0.5,0.588,76
significance,0.749,19,135,1,1,0.82,0.46,0.644,154
persuasive,0.749,4,33,1,1,0.74,0.7,0.657,37
nomination,0.749,14,101,1,1,0.663,0.637,0.696,115
merchant,0.749,9,67,1,1,0.675,0.5,0.62,76
object,0.749,59,407,1,1,0.531,0.356,0.375,466
accumulate,0.749,4,33,1,1,0.573,0.536,0.607,37
unknowable,0.749,4,33,1,1,0.347,0.54,0.396,37
learner,0.749,4,33,1,1,0.698,0.475,0.398,37
bayou,0.749,4,33,1,1,0.469,0.431,0.324,37
parasitic,0.749,4,33,1,1,0.037,0.6,0.364,37
debatable,0.749,4,33,1,1,0.181,0.61,0.474,37
subsequently,0.749,9,67,1,1,0.38,0.337,0.336,76
ambush,0.749,4,33,1,1,0.281,0.83,0.5,37
scrambling,0.749,4,33,1,1,0.421,0.81,0.731,37
sipping,0.749,85,584,1,1,0.469,0.349,0.377,669
laziness,0.748,30,210,1,1,0.271,0.24,0.132,240
differ,0.748,25,176,1,1,0.23,0.398,0.396,201
moment,0.748,2515,17130,1,1,0.604,0.435,0.509,19645
instruction,0.747,15,108,1,1,0.656,0.434,0.736,123
condolences,0.747,26,183,1,1,0.198,0.48,0.288,209
evaluation,0.746,10,74,1,1,0.542,0.667,0.764,84
magnetic,0.746,10,74,1,1,0.612,0.529,0.673,84
graphics,0.746,10,74,1,1,0.542,0.431,0.509,84
perfect,0.746,1381,9425,1,1,0.98,0.471,0.87,10806
endure,0.745,188,1289,1,1,0.32,0.61,0.574,1477
breathe,0.745,509,3480,1,1,0.833,0.373,0.518,3989
develop,0.745,154,1057,1,1,0.771,0.67,0.821,1211
slay,0.745,22,156,1,1,0.133,0.92,0.585,178
oil,0.744,94,648,1,1,0.521,0.278,0.306,742
diligent,0.744,5,40,1,1,0.76,0.426,0.759,45
priory,0.744,5,40,1,1,0.561,0.413,0.629,45
fen,0.744,5,40,1,1,0.49,0.276,0.379,45
tentative,0.744,5,40,1,1,0.582,0.657,0.534,45
footing,0.744,5,40,1,1,0.76,0.346,0.464,45
vulture,0.744,5,40,1,1,0.316,0.604,0.472,45
sinister,0.744,17,122,1,1,0.125,0.896,0.581,139
facet,0.744,5,40,1,1,0.667,0.324,0.382,45
custard,0.744,5,40,1,1,0.618,0.26,0.293,45
joy,0.744,1098,7510,1,1,0.98,0.824,0.794,8608
construct,0.743,24,170,1,1,0.75,0.648,0.792,194
circumstance,0.743,37,259,1,1,0.52,0.565,0.596,296
tricky,0.743,37,259,1,1,0.219,0.651,0.5,296
crude,0.742,12,88,1,1,0.198,0.402,0.357,100
fray,0.742,12,88,1,1,0.337,0.542,0.482,100
thunderstorm,0.742,12,88,1,1,0.135,0.86,0.784,100
goal,0.742,326,2238,1,1,0.83,0.356,0.669,2564
praises,0.742,19,136,1,1,0.878,0.491,0.75,155
kingdom,0.741,170,1171,1,1,0.714,0.547,0.91,1341
blazing,0.74,13,95,1,1,0.594,0.896,0.735,108
mastermind,0.74,6,47,1,1,0.792,0.625,0.918,53
affiliation,0.74,6,47,1,1,0.615,0.594,0.5,53
undecided,0.74,6,47,1,1,0.286,0.433,0.127,53
captivity,0.74,20,143,1,1,0.225,0.493,0.387,163
payoff,0.74,6,47,1,1,0.74,0.644,0.673,53
worsening,0.74,6,47,1,1,0.115,0.685,0.202,53
honor,0.74,148,1021,1,1,0.896,0.587,0.857,1169
final,0.74,331,2277,1,1,0.276,0.575,0.508,2608
departed,0.74,21,150,1,1,0.245,0.536,0.391,171
misty,0.739,29,205,1,1,0.427,0.451,0.278,234
inflict,0.739,14,102,1,1,0.167,0.76,0.609,116
raspberry,0.738,7,54,1,1,0.735,0.336,0.291,61
uncover,0.738,7,54,1,1,0.771,0.552,0.648,61
jog,0.738,15,109,1,1,0.51,0.708,0.519,124
almond,0.738,7,54,1,1,0.698,0.183,0.314,61
lyrical,0.737,24,171,1,1,0.708,0.451,0.618,195
cozy,0.737,100,694,1,1,0.91,0.356,0.545,794
voyage,0.736,25,178,1,1,0.816,0.714,0.58,203
training,0.736,217,1500,1,1,0.714,0.776,0.788,1717
maze,0.736,34,240,1,1,0.438,0.608,0.444,274
inconsequential,0.736,8,61,1,1,0.25,0.48,0.345,69
manners,0.736,26,185,1,1,0.816,0.284,0.517,211
goddamned,0.736,8,61,1,1,0.042,0.758,0.42,69
fascinated,0.736,26,185,1,1,0.812,0.714,0.788,211
patter,0.736,8,61,1,1,0.312,0.635,0.451,69
intimate,0.736,135,936,1,1,0.724,0.598,0.393,1071
hardy,0.735,18,130,1,1,0.571,0.569,0.81,148
possible,0.735,808,5577,1,1,0.688,0.316,0.548,6385
irritable,0.734,19,137,1,1,0.112,0.952,0.462,156
irritates,0.734,9,68,1,1,0.173,0.81,0.295,77
metropolitan,0.734,9,68,1,1,0.387,0.408,0.723,77
communication,0.734,213,1476,1,1,0.837,0.4,0.649,1689
focus,0.733,784,5420,1,1,0.69,0.382,0.648,6204
sacrifice,0.733,190,1318,1,1,0.208,0.833,0.534,1508
relive,0.733,21,151,1,1,0.75,0.65,0.693,172
anthology,0.733,10,75,1,1,0.338,0.406,0.537,85
chai,0.733,21,151,1,1,0.5,0.375,0.363,172
permission,0.733,54,379,1,1,0.612,0.311,0.58,433
honored,0.733,33,234,1,1,0.938,0.447,0.732,267
fruit,0.732,92,642,1,1,0.896,0.291,0.312,734
inspiration,0.732,225,1562,1,1,0.938,0.6,0.779,1787
snug,0.732,11,82,1,1,0.867,0.173,0.5,93
exotic,0.731,24,172,1,1,0.84,0.711,0.727,196
mod,0.731,24,172,1,1,0.458,0.367,0.384,196
manifestation,0.731,25,179,1,1,0.583,0.75,0.655,204
soaked,0.731,25,179,1,1,0.365,0.462,0.358,204
anarchy,0.731,12,89,1,1,0.146,0.755,0.62,101
whisper,0.73,122,851,1,1,0.49,0.225,0.265,973
mythical,0.73,13,96,1,1,0.625,0.556,0.583,109
vegetarian,0.73,13,96,1,1,0.562,0.255,0.407,109
opposites,0.73,13,96,1,1,0.281,0.518,0.462,109
electronic,0.73,28,200,1,1,0.571,0.49,0.704,228
lantern,0.729,14,103,1,1,0.622,0.25,0.243,117
willpower,0.729,14,103,1,1,0.823,0.776,0.897,117
secret,0.729,456,3168,1,1,0.479,0.58,0.509,3624
feared,0.729,61,429,1,1,0.24,0.733,0.509,490
conflicting,0.728,17,124,1,1,0.173,0.738,0.553,141
chapter,0.727,172,1201,1,1,0.58,0.308,0.461,1373
fully,0.727,406,2829,1,1,0.763,0.45,0.779,3235
pajamas,0.726,21,152,1,1,0.719,0.17,0.264,173
wind,0.726,532,3706,1,1,0.531,0.404,0.578,4238
manner,0.726,68,479,1,1,0.618,0.25,0.32,547
pretentious,0.726,23,166,1,1,0.156,0.736,0.444,189
detached,0.726,73,514,1,1,0.28,0.396,0.216,587
trinity,0.725,29,208,1,1,0.635,0.346,0.66,237
movement,0.724,157,1100,1,1,0.656,0.654,0.658,1257
bond,0.722,213,1494,1,1,0.667,0.519,0.63,1707
muddled,0.72,3,27,1,1,0.25,0.615,0.263,30
branch,0.72,58,412,1,1,0.538,0.206,0.25,470
cinematic,0.72,18,132,1,1,0.663,0.49,0.6,150
charmed,0.72,10,76,1,1,0.938,0.57,0.769,86
varying,0.72,12,90,1,1,0.552,0.471,0.385,102
glide,0.72,4,34,1,1,0.561,0.706,0.415,38
plumbing,0.72,4,34,1,1,0.469,0.427,0.441,38
pupil,0.72,4,34,1,1,0.729,0.406,0.368,38
engulf,0.72,11,83,1,1,0.398,0.573,0.5,94
pantry,0.72,8,62,1,1,0.622,0.294,0.312,70
jubilee,0.72,3,27,1,1,0.916,0.5,0.579,30
owing,0.72,4,34,1,1,0.396,0.307,0.381,38
adequate,0.72,15,111,1,1,0.854,0.264,0.705,126
reservation,0.72,8,62,1,1,0.688,0.343,0.561,70
withering,0.72,11,83,1,1,0.271,0.65,0.345,94
congregate,0.72,5,41,1,1,0.653,0.53,0.733,46
lackluster,0.72,4,34,1,1,0.25,0.311,0.264,38
specify,0.72,4,34,1,1,0.656,0.405,0.6,38
skeletal,0.72,3,27,1,1,0.306,0.558,0.318,30
revise,0.72,5,41,1,1,0.5,0.469,0.509,46
whiteness,0.72,6,48,1,1,0.688,0.235,0.519,54
ticked,0.72,7,55,1,1,0.469,0.386,0.455,62
counsel,0.72,19,139,1,1,0.594,0.519,0.73,158
neatly,0.72,7,55,1,1,0.802,0.412,0.588,62
jaguar,0.72,3,27,1,1,0.559,0.71,0.654,30
restoring,0.72,6,48,1,1,0.82,0.49,0.783,54
bishop,0.72,26,188,1,1,0.594,0.184,0.725,214
insignificance,0.72,9,69,1,1,0.25,0.216,0.222,78
elemental,0.72,4,34,1,1,0.627,0.306,0.711,38
kite,0.72,30,216,1,1,0.643,0.5,0.573,246
enlarged,0.72,5,41,1,1,0.673,0.49,0.518,46
eyelash,0.72,3,27,1,1,0.48,0.25,0.278,30
nomad,0.72,9,69,1,1,0.375,0.413,0.433,78
aaaaaaah,0.72,3,27,1,1,0.479,0.606,0.291,30
stony,0.72,7,55,1,1,0.356,0.494,0.525,62
prairie,0.72,13,97,1,1,0.673,0.183,0.415,110
omen,0.72,10,76,1,1,0.39,0.657,0.583,86
agriculture,0.72,6,48,1,1,0.64,0.357,0.465,54
noggin,0.72,3,27,1,1,0.51,0.433,0.382,30
recurring,0.72,18,132,1,1,0.37,0.56,0.445,150
floral,0.72,5,41,1,1,0.833,0.235,0.264,46
mismatched,0.72,4,34,1,1,0.25,0.557,0.302,38
meanness,0.72,4,34,1,1,0.102,0.694,0.368,38
mayhem,0.72,16,118,1,1,0.188,0.87,0.364,134
shaft,0.72,8,62,1,1,0.549,0.275,0.472,70
northeast,0.72,5,41,1,1,0.562,0.26,0.375,46
sickle,0.72,3,27,1,1,0.427,0.585,0.37,30
treachery,0.72,4,34,1,1,0.104,0.852,0.448,38
glaring,0.72,10,76,1,1,0.694,0.794,0.798,86
wretch,0.72,7,55,1,1,0.04,0.667,0.25,62
stairwell,0.72,3,27,1,1,0.51,0.292,0.333,30
liability,0.72,18,132,1,1,0.646,0.5,0.802,150
strut,0.72,3,27,1,1,0.58,0.48,0.464,30
compact,0.72,3,27,1,1,0.458,0.417,0.673,30
prosecution,0.72,3,27,1,1,0.245,0.857,0.647,30
appreciation,0.72,121,853,1,1,0.917,0.529,0.588,974
fiscal,0.72,3,27,1,1,0.5,0.582,0.845,30
alarmed,0.72,6,48,1,1,0.188,0.822,0.492,54
gem,0.72,66,468,1,1,0.917,0.48,0.582,534
glow,0.72,90,636,1,1,0.918,0.5,0.745,726
conceit,0.72,3,27,1,1,0.354,0.625,0.309,30
render,0.72,16,118,1,1,0.541,0.395,0.448,134
persevere,0.72,16,118,1,1,0.802,0.583,0.937,134
serpent,0.72,12,90,1,1,0.115,0.696,0.679,102
sinus,0.72,3,27,1,1,0.531,0.563,0.34,30
untimely,0.72,4,34,1,1,0.245,0.676,0.233,38
autumn,0.719,135,952,1,1,0.765,0.204,0.45,1087
attachment,0.718,88,623,1,1,0.57,0.343,0.5,711
park,0.718,590,4145,1,1,0.816,0.343,0.414,4735
roam,0.717,57,406,1,1,0.51,0.55,0.444,463
traveler,0.717,52,371,1,1,0.837,0.571,0.7,423
virtually,0.716,40,287,1,1,0.594,0.521,0.625,327
doomed,0.716,113,800,1,1,0.041,0.755,0.301,913
reap,0.716,33,238,1,1,0.677,0.422,0.623,271
collected,0.715,29,210,1,1,0.57,0.402,0.588,239
aggression,0.714,25,182,1,1,0.094,0.929,0.533,207
swim,0.714,91,647,1,1,0.688,0.461,0.529,738
tangible,0.714,22,161,1,1,0.646,0.35,0.679,183
important,0.714,1607,11325,1,1,0.827,0.63,0.836,12932
occasion,0.713,60,429,1,1,0.7,0.451,0.398,489
respects,0.713,38,274,1,1,0.84,0.387,0.824,312
vacation,0.712,268,1896,1,1,0.84,0.49,0.598,2164
uncertain,0.711,49,352,1,1,0.363,0.5,0.164,401
engaging,0.711,82,585,1,1,0.948,0.612,0.862,667
judgment,0.711,47,338,1,1,0.396,0.6,0.816,385
find,0.711,8881,62750,1,1,0.774,0.555,0.58,71631
keen,0.71,44,317,1,1,0.823,0.719,0.806,361
duality,0.71,14,105,1,1,0.438,0.52,0.503,119
strolling,0.71,14,105,1,1,0.755,0.515,0.34,119
remaining,0.71,100,713,1,1,0.449,0.29,0.296,813
youth,0.71,327,2318,1,1,0.938,0.608,0.736,2645
unpack,0.71,13,98,1,1,0.531,0.528,0.445,111
quote,0.71,334,2368,1,1,0.68,0.55,0.43,2702
read,0.709,2780,19672,1,1,0.74,0.283,0.611,22452
eradicate,0.709,12,91,1,1,0.26,0.69,0.686,103
birth,0.709,204,1450,1,1,0.896,0.655,0.536,1654
tradition,0.708,48,346,1,1,0.83,0.43,0.75,394
youthful,0.708,11,84,1,1,0.827,0.48,0.686,95
slice,0.708,57,410,1,1,0.583,0.375,0.303,467
tow,0.707,10,77,1,1,0.531,0.5,0.508,87
imaginable,0.707,10,77,1,1,0.613,0.529,0.596,87
merciful,0.707,10,77,1,1,0.854,0.346,0.5,87
sun,0.706,1074,7627,1,1,0.877,0.4,0.681,8701
interpretation,0.706,30,219,1,1,0.677,0.594,0.62,249
mode,0.706,189,1348,1,1,0.531,0.185,0.367,1537
wail,0.706,9,70,1,1,0.418,0.724,0.393,79
applicable,0.706,9,70,1,1,0.469,0.43,0.667,79
inconvenience,0.706,19,141,1,1,0.063,0.667,0.291,160
miracle,0.705,116,830,1,1,0.917,0.607,0.806,946
archetype,0.704,8,63,1,1,0.448,0.52,0.569,71
laurel,0.704,8,63,1,1,0.646,0.146,0.302,71
greatly,0.703,76,547,1,1,0.75,0.708,0.877,623
tolerate,0.703,92,661,1,1,0.724,0.43,0.588,753
accomplish,0.703,49,355,1,1,0.929,0.673,0.816,404
beware,0.703,57,412,1,1,0.151,0.596,0.518,469
qualities,0.703,48,348,1,1,0.844,0.51,0.731,396
provoked,0.702,7,56,1,1,0.271,0.676,0.528,63
warrant,0.702,7,56,1,1,0.653,0.398,0.802,63
shimmering,0.702,7,56,1,1,0.844,0.648,0.904,63
railroad,0.702,7,56,1,1,0.591,0.592,0.5,63
provocative,0.702,7,56,1,1,0.438,0.814,0.684,63
midway,0.702,7,56,1,1,0.459,0.316,0.304,63
neglect,0.702,86,619,1,1,0.045,0.55,0.163,705
outweigh,0.701,14,106,1,1,0.486,0.6,0.682,120
lock,0.701,141,1012,1,1,0.271,0.585,0.6,1153
liquid,0.701,21,156,1,1,0.562,0.235,0.307,177
self,0.7,3593,25650,1,1,0.704,0.37,0.5,29243
silently,0.7,121,870,1,1,0.448,0.185,0.306,991
anguished,0.7,6,49,1,1,0.135,0.72,0.307,55
enclosure,0.7,6,49,1,1,0.417,0.375,0.49,55
inviting,0.7,97,699,1,1,0.938,0.571,0.538,796
flowery,0.7,6,49,1,1,0.792,0.332,0.446,55
gourmet,0.7,6,49,1,1,0.911,0.387,0.562,55
spear,0.7,6,49,1,1,0.51,0.601,0.5,55
attest,0.7,13,99,1,1,0.439,0.71,0.685,112
agonizing,0.699,33,242,1,1,0.083,0.8,0.34,275
civil,0.698,58,421,1,1,0.521,0.281,0.517,479
knowingly,0.698,12,92,1,1,0.5,0.459,0.481,104
saturated,0.698,12,92,1,1,0.474,0.7,0.442,104
dungeon,0.697,36,264,1,1,0.276,0.608,0.44,300
dawn,0.696,192,1382,1,1,0.827,0.235,0.519,1574
incarnate,0.696,5,42,1,1,0.552,0.651,0.593,47
earthquake,0.696,11,85,1,1,0.073,0.93,0.812,96
fang,0.696,5,42,1,1,0.175,0.491,0.455,47
perished,0.696,5,42,1,1,0.135,0.596,0.225,47
expiration,0.696,5,42,1,1,0.265,0.539,0.463,47
documents,0.696,11,85,1,1,0.53,0.25,0.587,96
hydra,0.696,5,42,1,1,0.406,0.598,0.534,47
nightstand,0.696,5,42,1,1,0.49,0.13,0.327,47
impossibility,0.696,5,42,1,1,0.17,0.625,0.306,47
equally,0.695,109,788,1,1,0.625,0.264,0.436,897
notion,0.695,50,365,1,1,0.612,0.284,0.667,415
medium,0.694,49,358,1,1,0.559,0.356,0.358,407
equivalent,0.694,71,516,1,1,0.646,0.347,0.5,587
sterile,0.694,10,78,1,1,0.302,0.471,0.291,88
empower,0.694,21,157,1,1,0.694,0.779,0.891,178
equation,0.694,21,157,1,1,0.479,0.384,0.608,178
unnatural,0.693,15,114,1,1,0.153,0.587,0.434,129
parallel,0.692,35,258,1,1,0.568,0.284,0.465,293
imagination,0.692,221,1597,1,1,0.802,0.491,0.547,1818
earth,0.692,932,6715,1,1,0.75,0.225,0.614,7647
crabby,0.692,4,35,1,1,0.198,0.812,0.37,39
converted,0.692,14,107,1,1,0.663,0.418,0.686,121
continuous,0.692,29,215,1,1,0.625,0.509,0.58,244
credited,0.692,4,35,1,1,0.781,0.39,0.691,39
hemisphere,0.692,4,35,1,1,0.531,0.367,0.598,39
narrate,0.692,4,35,1,1,0.541,0.48,0.473,39
conductor,0.692,4,35,1,1,0.677,0.663,0.621,39
adventurous,0.692,19,143,1,1,0.969,0.898,0.722,162
sanctimonious,0.692,4,35,1,1,0.24,0.365,0.327,39
dismissal,0.692,4,35,1,1,0.153,0.723,0.271,39
overt,0.692,4,35,1,1,0.708,0.326,0.607,39
peripheral,0.692,4,35,1,1,0.406,0.406,0.549,39
seedy,0.692,4,35,1,1,0.229,0.39,0.325,39
virtuous,0.692,9,71,1,1,0.89,0.53,0.822,80
vendetta,0.692,4,35,1,1,0.198,0.784,0.583,39
premiere,0.692,19,143,1,1,0.776,0.596,0.573,162
fortnight,0.692,9,71,1,1,0.77,0.65,0.397,80
jot,0.692,4,35,1,1,0.406,0.323,0.35,39
fiesta,0.692,4,35,1,1,0.927,0.779,0.655,39
gloom,0.691,43,316,1,1,0.135,0.404,0.196,359
intimidated,0.691,33,244,1,1,0.177,0.663,0.208,277
atmosphere,0.69,136,987,1,1,0.604,0.3,0.56,1123
claustrophobic,0.69,13,100,1,1,0.092,0.755,0.4,113
developing,0.69,69,504,1,1,0.833,0.587,0.714,573
unsolicited,0.689,22,165,1,1,0.094,0.339,0.28,187
obscene,0.689,8,64,1,1,0.05,0.745,0.348,72
violate,0.689,8,64,1,1,0.061,0.97,0.519,72
slippers,0.689,8,64,1,1,0.573,0.413,0.236,72
province,0.689,17,129,1,1,0.714,0.255,0.471,146
stem,0.688,39,288,1,1,0.615,0.191,0.336,327
reader,0.688,56,411,1,1,0.776,0.224,0.602,467
wealth,0.688,108,787,1,1,0.857,0.637,0.858,895
secretive,0.687,12,93,1,1,0.39,0.25,0.538,105
endless,0.687,332,2407,1,1,0.347,0.462,0.472,2739
dedication,0.686,41,303,1,1,0.867,0.471,0.682,344
scattered,0.685,52,383,1,1,0.208,0.38,0.238,435
gain,0.685,243,1767,1,1,0.917,0.64,0.822,2010
original,0.685,328,2383,1,1,0.765,0.48,0.746,2711
rhythm,0.685,72,528,1,1,0.771,0.759,0.573,600
estrogen,0.685,3,28,1,1,0.58,0.5,0.425,31
cluster,0.685,15,115,1,1,0.49,0.458,0.446,130
propel,0.685,3,28,1,1,0.75,0.786,0.804,31
propagate,0.685,3,28,1,1,0.561,0.609,0.63,31
elevate,0.685,23,173,1,1,0.812,0.5,0.804,196
relocate,0.685,7,57,1,1,0.5,0.594,0.64,64
molester,0.685,3,28,1,1,0.143,0.811,0.478,31
carelessness,0.685,3,28,1,1,0.245,0.482,0.33,31
outback,0.685,7,57,1,1,0.5,0.324,0.43,64
glutton,0.685,3,28,1,1,0.438,0.519,0.384,31
spaz,0.685,3,28,1,1,0.443,0.5,0.268,31
coral,0.685,7,57,1,1,0.802,0.231,0.425,64
briar,0.685,3,28,1,1,0.493,0.375,0.407,31
boarder,0.685,3,28,1,1,0.604,0.44,0.475,31
cockpit,0.685,3,28,1,1,0.52,0.424,0.343,31
epitaph,0.685,3,28,1,1,0.276,0.323,0.442,31
hymn,0.685,11,86,1,1,0.735,0.292,0.634,97
truthfulness,0.685,3,28,1,1,0.92,0.549,0.808,31
quake,0.685,3,28,1,1,0.11,0.824,0.672,31
attic,0.685,27,202,1,1,0.521,0.259,0.377,229
discrete,0.685,3,28,1,1,0.585,0.231,0.429,31
flute,0.685,11,86,1,1,0.635,0.33,0.363,97
clergy,0.685,7,57,1,1,0.531,0.312,0.575,64
ley,0.685,3,28,1,1,0.604,0.389,0.764,31
unequivocally,0.685,3,28,1,1,0.521,0.668,0.554,31
disapproval,0.685,3,28,1,1,0.085,0.551,0.367,31
conspire,0.685,3,28,1,1,0.206,0.74,0.52,31
finch,0.685,3,28,1,1,0.438,0.444,0.358,31
rainy,0.684,241,1754,1,1,0.61,0.451,0.433,1995
acceptance,0.683,176,1284,1,1,0.833,0.287,0.755,1460
unforgettable,0.683,22,166,1,1,0.833,0.561,0.66,188
morn,0.683,18,137,1,1,0.542,0.284,0.345,155
wary,0.683,18,137,1,1,0.51,0.343,0.535,155
pathway,0.683,18,137,1,1,0.646,0.41,0.519,155
howl,0.683,37,275,1,1,0.357,0.646,0.407,312
needed,0.683,1573,11434,1,1,0.677,0.342,0.679,13007
hawk,0.682,14,108,1,1,0.583,0.53,0.631,122
unlimited,0.682,29,217,1,1,0.75,0.623,0.679,246
rest,0.682,2083,15151,1,1,0.907,0.167,0.3,17234
prosperity,0.682,32,239,1,1,0.917,0.6,0.86,271
ought,0.681,39,290,1,1,0.438,0.511,0.434,329
progress,0.681,158,1156,1,1,0.88,0.642,0.877,1314
maintenance,0.681,35,261,1,1,0.592,0.41,0.545,296
mysterious,0.68,95,698,1,1,0.448,0.699,0.455,793
capable,0.68,144,1055,1,1,0.765,0.587,0.547,1199
carry,0.68,403,2942,1,1,0.635,0.38,0.5,3345
historic,0.68,13,101,1,1,0.816,0.473,0.784,114
traitorous,0.68,6,50,1,1,0.073,0.745,0.412,56
flair,0.68,6,50,1,1,0.775,0.471,0.676,56
petrol,0.68,6,50,1,1,0.418,0.519,0.577,56
wooden,0.679,30,225,1,1,0.5,0.196,0.318,255
rethink,0.679,23,174,1,1,0.48,0.423,0.583,197
impossible,0.678,276,2020,1,1,0.153,0.51,0.407,2296
enormous,0.678,36,269,1,1,0.677,0.665,0.886,305
despise,0.678,56,415,1,1,0.167,0.745,0.296,471
scorpion,0.678,9,72,1,1,0.198,0.745,0.6,81
refrigerator,0.678,9,72,1,1,0.677,0.26,0.391,81
composed,0.677,32,240,1,1,0.684,0.385,0.682,272
dunk,0.677,12,94,1,1,0.406,0.333,0.475,106
hippie,0.677,12,94,1,1,0.551,0.4,0.396,106
century,0.676,124,913,1,1,0.407,0.347,0.735,1037
afternoon,0.676,352,2582,1,1,0.533,0.388,0.339,2934
burnout,0.675,24,182,1,1,0.219,0.445,0.24,206
villa,0.675,24,182,1,1,0.698,0.29,0.345,206
water,0.675,808,5923,1,1,0.812,0.123,0.429,6731
tiger,0.675,73,541,1,1,0.479,0.765,0.664,614
write,0.674,1033,7573,1,1,0.612,0.387,0.534,8606
dominating,0.673,5,43,1,1,0.427,0.769,0.902,48
quicksand,0.673,5,43,1,1,0.219,0.74,0.508,48
eraser,0.673,5,43,1,1,0.458,0.209,0.311,48
chow,0.673,5,43,1,1,0.573,0.49,0.39,48
invariably,0.673,8,65,1,1,0.458,0.365,0.55,73
stifle,0.673,5,43,1,1,0.24,0.764,0.427,48
plaything,0.673,5,43,1,1,0.708,0.602,0.277,48
butcher,0.673,8,65,1,1,0.5,0.575,0.608,73
coldly,0.673,5,43,1,1,0.365,0.358,0.407,48
fitted,0.673,8,65,1,1,0.507,0.404,0.673,73
undesired,0.673,5,43,1,1,0.156,0.441,0.235,48
ballot,0.673,8,65,1,1,0.521,0.361,0.358,73
enemy,0.672,230,1695,1,1,0.135,0.794,0.591,1925
peacefully,0.672,83,616,1,1,0.901,0.19,0.639,699
thoughtful,0.672,77,572,1,1,0.667,0.29,0.527,649
fare,0.671,19,146,1,1,0.49,0.425,0.645,165
sane,0.671,135,999,1,1,0.76,0.235,0.67,1134
coyote,0.671,16,124,1,1,0.459,0.471,0.387,140
lament,0.67,27,205,1,1,0.198,0.398,0.352,232
riddance,0.669,10,80,1,1,0.323,0.562,0.472,90
cannabis,0.669,10,80,1,1,0.271,0.5,0.564,90
frantically,0.669,10,80,1,1,0.375,0.898,0.735,90
sneakers,0.668,7,58,1,1,0.604,0.548,0.349,65
boulder,0.668,7,58,1,1,0.461,0.309,0.531,65
groovy,0.668,7,58,1,1,0.615,0.538,0.464,65
publish,0.667,20,154,1,1,0.714,0.547,0.603,174
celebration,0.666,85,634,1,1,0.939,0.824,0.88,719
form,0.666,585,4326,1,1,0.51,0.302,0.436,4911
ominous,0.666,12,95,1,1,0.255,0.73,0.51,107
constitution,0.665,22,169,1,1,0.59,0.38,0.889,191
pursue,0.665,88,657,1,1,0.417,0.783,0.536,745
teach,0.665,332,2461,1,1,0.84,0.51,0.852,2793
restrain,0.664,4,36,1,1,0.134,0.696,0.434,40
calculator,0.664,4,36,1,1,0.513,0.283,0.588,40
plaque,0.664,4,36,1,1,0.52,0.333,0.42,40
challenger,0.664,4,36,1,1,0.417,0.755,0.652,40
conversationalist,0.664,4,36,1,1,0.719,0.467,0.667,40
jaws,0.664,9,73,1,1,0.385,0.528,0.455,82
semblance,0.664,14,110,1,1,0.5,0.471,0.442,124
sacrificial,0.664,4,36,1,1,0.198,0.755,0.452,40
tingling,0.664,4,36,1,1,0.427,0.615,0.34,40
saloon,0.664,4,36,1,1,0.63,0.3,0.364,40
peninsula,0.664,4,36,1,1,0.551,0.384,0.627,40
mathematics,0.664,4,36,1,1,0.438,0.435,0.664,40
surgical,0.664,4,36,1,1,0.327,0.696,0.723,40
bridal,0.664,4,36,1,1,0.823,0.655,0.596,40
grievance,0.664,4,36,1,1,0.092,0.635,0.364,40
stepfather,0.664,4,36,1,1,0.396,0.491,0.611,40
redeemed,0.664,9,73,1,1,0.625,0.378,0.434,82
windowsill,0.664,4,36,1,1,0.429,0.274,0.433,40
designated,0.664,14,110,1,1,0.5,0.412,0.616,124
porch,0.663,53,399,1,1,0.535,0.324,0.388,452
gypsy,0.663,16,125,1,1,0.375,0.665,0.396,141
goals,0.663,307,2282,1,1,0.719,0.49,0.795,2589
ego,0.662,249,1853,1,1,0.328,0.576,0.593,2102
uninterested,0.661,18,140,1,1,0.365,0.24,0.328,158
contend,0.66,6,51,1,1,0.51,0.657,0.731,57
merciless,0.66,6,51,1,1,0.062,0.88,0.634,57
cohesive,0.66,6,51,1,1,0.531,0.47,0.603,57
pushy,0.66,6,51,1,1,0.08,0.906,0.741,57
groan,0.66,6,51,1,1,0.396,0.75,0.351,57
hurl,0.66,6,51,1,1,0.316,0.745,0.574,57
gateway,0.66,20,155,1,1,0.592,0.376,0.529,175
remains,0.66,157,1173,1,1,0.61,0.24,0.565,1330
dynamic,0.66,43,326,1,1,0.724,0.75,0.836,369
weeds,0.659,15,118,1,1,0.32,0.551,0.315,133
ringing,0.659,42,319,1,1,0.724,0.598,0.693,361
pilgrim,0.658,17,133,1,1,0.531,0.404,0.569,150
bulb,0.658,8,66,1,1,0.562,0.208,0.3,74
overlook,0.658,17,133,1,1,0.292,0.418,0.415,150
notable,0.658,8,66,1,1,0.76,0.45,0.696,74
obscurity,0.658,26,200,1,1,0.208,0.392,0.38,226
overhead,0.658,17,133,1,1,0.344,0.7,0.538,150
hut,0.658,35,267,1,1,0.633,0.27,0.375,302
overtake,0.658,8,66,1,1,0.573,0.62,0.718,74
heading,0.658,136,1019,1,1,0.551,0.292,0.642,1155
length,0.658,46,349,1,1,0.479,0.308,0.533,395
phantom,0.657,41,312,1,1,0.26,0.759,0.448,353
migration,0.657,10,81,1,1,0.492,0.731,0.566,91
partake,0.657,10,81,1,1,0.755,0.656,0.629,91
ordeal,0.657,10,81,1,1,0.344,0.539,0.529,91
manhood,0.657,10,81,1,1,0.625,0.735,0.858,91
preparing,0.657,82,618,1,1,0.735,0.538,0.585,700
advanced,0.656,36,275,1,1,0.844,0.623,0.797,311
improvement,0.656,38,290,1,1,0.786,0.5,0.611,328
nutrition,0.656,12,96,1,1,0.885,0.42,0.579,108
flickering,0.656,12,96,1,1,0.49,0.444,0.289,108
visionary,0.655,14,111,1,1,0.823,0.565,0.791,125
almighty,0.655,54,410,1,1,0.938,0.874,0.958,464
reveal,0.654,92,694,1,1,0.493,0.637,0.526,786
flowers,0.654,373,2795,1,1,0.875,0.324,0.33,3168
admired,0.653,28,216,1,1,0.917,0.56,0.815,244
priest,0.652,48,366,1,1,0.561,0.324,0.648,414
dishwasher,0.651,5,44,1,1,0.48,0.296,0.324,49
protest,0.651,45,344,1,1,0.14,0.889,0.596,389
thorny,0.651,3,29,1,1,0.177,0.69,0.5,32
crouching,0.651,3,29,1,1,0.261,0.429,0.345,32
modest,0.651,13,104,1,1,0.76,0.13,0.412,117
rekindle,0.651,9,74,1,1,0.656,0.52,0.788,83
oblige,0.651,5,44,1,1,0.281,0.77,0.614,49
morality,0.651,25,194,1,1,0.75,0.408,0.759,219
brash,0.651,3,29,1,1,0.36,0.814,0.552,32
undead,0.651,13,104,1,1,0.367,0.635,0.406,117
tinnitus,0.651,5,44,1,1,0.384,0.536,0.411,49
restricted,0.651,17,134,1,1,0.276,0.5,0.407,151
measuring,0.651,9,74,1,1,0.448,0.337,0.529,83
module,0.651,5,44,1,1,0.582,0.388,0.571,49
lynching,0.651,3,29,1,1,0.135,0.92,0.548,32
assortment,0.651,3,29,1,1,0.694,0.36,0.526,32
marooned,0.651,5,44,1,1,0.229,0.48,0.16,49
standpoint,0.651,7,59,1,1,0.585,0.388,0.652,66
mediterranean,0.651,3,29,1,1,0.663,0.454,0.545,32
periphery,0.651,3,29,1,1,0.469,0.36,0.366,32
perfume,0.651,33,254,1,1,0.74,0.472,0.463,287
tightrope,0.651,3,29,1,1,0.354,0.653,0.279,32
concede,0.651,5,44,1,1,0.67,0.324,0.473,49
unmarked,0.651,3,29,1,1,0.416,0.294,0.433,32
extraterrestrial,0.651,3,29,1,1,0.51,0.833,0.792,32
rung,0.651,5,44,1,1,0.51,0.355,0.368,49
procreation,0.651,3,29,1,1,0.792,0.714,0.787,32
perplexed,0.651,5,44,1,1,0.312,0.705,0.318,49
calculating,0.651,5,44,1,1,0.458,0.43,0.625,49
crass,0.651,7,59,1,1,0.223,0.49,0.466,66
feisty,0.651,5,44,1,1,0.592,0.853,0.789,49
peering,0.651,7,59,1,1,0.514,0.409,0.451,66
breakthrough,0.651,13,104,1,1,0.68,0.525,0.718,117
woeful,0.651,3,29,1,1,0.135,0.555,0.255,32
punish,0.651,27,209,1,1,0.061,0.808,0.61,236
comprehensive,0.651,7,59,1,1,0.796,0.385,0.644,66
buster,0.651,11,89,1,1,0.469,0.491,0.483,100
motto,0.651,23,179,1,1,0.688,0.317,0.439,202
hefty,0.651,7,59,1,1,0.55,0.654,0.745,66
ravenous,0.651,3,29,1,1,0.406,0.7,0.509,32
trained,0.65,60,457,1,1,0.771,0.538,0.645,517
idle,0.65,52,397,1,1,0.179,0.167,0.112,449
spend,0.649,2171,16316,1,1,0.672,0.745,0.429,18487
companionship,0.649,422,3177,1,1,0.833,0.438,0.792,3599
noted,0.649,30,232,1,1,0.615,0.382,0.464,262
destiny,0.648,238,1796,1,1,0.781,0.413,0.611,2034
pole,0.648,49,375,1,1,0.418,0.398,0.368,424
swamp,0.648,47,360,1,1,0.245,0.425,0.235,407
feline,0.647,18,142,1,1,0.615,0.745,0.509,160
meek,0.647,16,127,1,1,0.531,0.15,0.198,143
reminisce,0.646,25,195,1,1,0.903,0.49,0.363,220
charisma,0.646,12,97,1,1,0.938,0.591,0.759,109
protecting,0.646,90,685,1,1,0.878,0.558,0.832,775
overwhelm,0.645,23,180,1,1,0.25,0.823,0.462,203
invitation,0.645,58,444,1,1,0.802,0.549,0.647,502
demand,0.645,93,708,1,1,0.292,0.673,0.5,801
interaction,0.645,520,3930,1,1,0.646,0.735,0.75,4450
ruth,0.645,32,248,1,1,0.469,0.427,0.444,280
perception,0.644,72,550,1,1,0.653,0.481,0.655,622
unknown,0.644,223,1690,1,1,0.357,0.45,0.204,1913
quality,0.644,303,2294,1,1,0.896,0.443,0.852,2597
print,0.644,46,354,1,1,0.521,0.384,0.482,400
lingering,0.644,55,422,1,1,0.63,0.643,0.667,477
gauge,0.643,8,67,1,1,0.438,0.646,0.518,75
talker,0.643,8,67,1,1,0.5,0.604,0.552,75
fisherman,0.643,17,135,1,1,0.656,0.461,0.546,152
freeze,0.643,42,324,1,1,0.191,0.406,0.481,366
respective,0.643,15,120,1,1,0.625,0.413,0.721,135
survival,0.642,93,710,1,1,0.541,0.798,0.879,803
underworld,0.642,22,173,1,1,0.177,0.676,0.613,195
punishing,0.641,13,105,1,1,0.094,0.898,0.471,118
sustained,0.641,13,105,1,1,0.649,0.34,0.58,118
telepathy,0.641,6,52,1,1,0.594,0.51,0.588,58
plead,0.641,13,105,1,1,0.177,0.596,0.195,118
forcibly,0.641,6,52,1,1,0.365,0.704,0.647,58
judiciary,0.641,6,52,1,1,0.439,0.74,0.897,58
chimney,0.641,6,52,1,1,0.583,0.286,0.225,58
viewing,0.641,39,302,1,1,0.69,0.394,0.598,341
resistance,0.64,42,325,1,1,0.427,0.694,0.796,367
leopard,0.64,11,90,1,1,0.542,0.755,0.611,101
hearth,0.64,11,90,1,1,0.76,0.275,0.536,101
dissonance,0.64,11,90,1,1,0.173,0.471,0.336,101
trunk,0.64,11,90,1,1,0.271,0.167,0.404,101
oppressive,0.639,21,166,1,1,0.276,0.59,0.667,187
rogue,0.639,21,166,1,1,0.334,0.713,0.636,187
instance,0.638,41,318,1,1,0.547,0.45,0.558,359
claustrophobia,0.638,4,37,1,1,0.125,0.84,0.333,41
generosity,0.638,19,151,1,1,0.958,0.443,0.692,170
altogether,0.638,34,265,1,1,0.833,0.324,0.644,299
presumptuous,0.638,4,37,1,1,0.265,0.596,0.616,41
reactive,0.638,4,37,1,1,0.434,0.817,0.721,41
gluten,0.638,4,37,1,1,0.385,0.308,0.388,41
turquoise,0.638,4,37,1,1,0.786,0.226,0.357,41
seamless,0.638,4,37,1,1,0.459,0.14,0.302,41
flannel,0.638,4,37,1,1,0.49,0.25,0.327,41
blip,0.638,4,37,1,1,0.529,0.461,0.418,41
inadvertently,0.638,9,75,1,1,0.302,0.541,0.549,84
chainsaw,0.638,4,37,1,1,0.367,0.804,0.636,41
rendezvous,0.638,9,75,1,1,0.75,0.49,0.658,84
restrict,0.638,4,37,1,1,0.115,0.539,0.577,41
twig,0.638,4,37,1,1,0.378,0.288,0.236,41
competitor,0.638,4,37,1,1,0.612,0.959,0.861,41
prosecutor,0.638,4,37,1,1,0.45,0.491,0.796,41
atom,0.638,9,75,1,1,0.51,0.5,0.433,84
needles,0.638,14,113,1,1,0.25,0.602,0.348,127
momentum,0.638,14,113,1,1,0.663,0.75,0.688,127
cordial,0.638,4,37,1,1,0.823,0.312,0.482,41
principles,0.637,37,288,1,1,0.698,0.286,0.84,325
mellow,0.636,22,174,1,1,0.633,0.069,0.265,196
written,0.636,358,2731,1,1,0.6,0.231,0.52,3089
rooftop,0.636,35,273,1,1,0.571,0.471,0.461,308
wholesome,0.636,97,745,1,1,0.888,0.423,0.754,842
photograph,0.636,30,235,1,1,0.677,0.353,0.358,265
bowls,0.636,12,98,1,1,0.551,0.28,0.277,110
forecast,0.636,12,98,1,1,0.783,0.419,0.698,110
collapse,0.636,38,296,1,1,0.208,0.689,0.342,334
intent,0.636,38,296,1,1,0.55,0.481,0.5,334
flexibility,0.636,12,98,1,1,0.867,0.402,0.472,110
haunt,0.635,85,654,1,1,0.288,0.676,0.576,739
simply,0.635,640,4884,1,1,0.535,0.148,0.393,5524
solar,0.634,31,243,1,1,0.622,0.452,0.645,274
vouch,0.634,7,60,1,1,0.625,0.417,0.746,67
definitive,0.634,7,60,1,1,0.583,0.479,0.787,67
rightful,0.634,7,60,1,1,0.837,0.358,0.821,67
chameleon,0.634,7,60,1,1,0.49,0.58,0.345,67
ore,0.634,7,60,1,1,0.5,0.333,0.356,67
certain,0.634,642,4902,1,1,0.76,0.358,0.673,5544
destination,0.634,96,739,1,1,0.708,0.471,0.637,835
hesitant,0.633,18,144,1,1,0.333,0.542,0.321,162
takeout,0.633,10,83,1,1,0.736,0.392,0.368,93
digress,0.633,10,83,1,1,0.271,0.625,0.411,93
various,0.633,126,969,1,1,0.5,0.296,0.342,1095
orchestra,0.632,24,190,1,1,0.708,0.5,0.664,214
aloof,0.632,24,190,1,1,0.189,0.423,0.302,214
herd,0.632,63,488,1,1,0.592,0.5,0.474,551
involve,0.632,52,404,1,1,0.694,0.49,0.728,456
tale,0.632,122,939,1,1,0.663,0.3,0.336,1061
anticipate,0.632,13,106,1,1,0.622,0.469,0.667,119
cynicism,0.632,13,106,1,1,0.104,0.78,0.454,119
irritate,0.632,13,106,1,1,0.167,0.89,0.368,119
compelling,0.632,27,213,1,1,0.698,0.57,0.87,240
poem,0.632,229,1757,1,1,0.81,0.27,0.571,1986
district,0.631,39,305,1,1,0.438,0.327,0.66,344
safe,0.631,784,6005,1,1,0.898,0.306,0.759,6789
resolved,0.631,22,175,1,1,0.735,0.357,0.683,197
welcoming,0.631,74,573,1,1,0.905,0.527,0.636,647
tenderness,0.63,28,221,1,1,0.949,0.276,0.367,249
iron,0.63,92,711,1,1,0.448,0.351,0.679,803
allow,0.63,624,4786,1,1,0.698,0.429,0.538,5410
build,0.629,586,4499,1,1,0.771,0.546,0.806,5085
stealth,0.629,5,45,1,1,0.52,0.27,0.452,50
ram,0.629,26,206,1,1,0.406,0.452,0.388,232
frighten,0.629,8,68,1,1,0.255,0.843,0.5,76
postpone,0.629,5,45,1,1,0.316,0.408,0.451,50
hurdle,0.629,5,45,1,1,0.198,0.682,0.434,50
occupying,0.629,11,91,1,1,0.573,0.462,0.519,102
investor,0.629,5,45,1,1,0.794,0.655,0.791,50
producing,0.629,26,206,1,1,0.632,0.616,0.7,232
tablet,0.629,14,114,1,1,0.562,0.33,0.438,128
jarring,0.629,8,68,1,1,0.21,0.673,0.309,76
vinegar,0.629,5,45,1,1,0.276,0.37,0.356,50
fret,0.629,20,160,1,1,0.289,0.46,0.231,180
jugular,0.629,5,45,1,1,0.271,0.573,0.426,50
sect,0.629,5,45,1,1,0.265,0.667,0.526,50
blackbird,0.629,11,91,1,1,0.52,0.34,0.405,102
aiding,0.629,5,45,1,1,0.643,0.533,0.569,50
azure,0.629,14,114,1,1,0.62,0.256,0.339,128
unprecedented,0.629,8,68,1,1,0.5,0.491,0.658,76
necessarily,0.628,221,1703,1,1,0.667,0.423,0.598,1924
bravery,0.627,27,214,1,1,0.898,0.745,0.868,241
dining,0.627,52,406,1,1,0.724,0.35,0.459,458
dependency,0.627,21,168,1,1,0.429,0.365,0.356,189
alluring,0.627,21,168,1,1,0.837,0.745,0.843,189
key,0.627,569,4379,1,1,0.615,0.275,0.519,4948
horoscope,0.627,18,145,1,1,0.5,0.36,0.49,163
fitness,0.626,34,268,1,1,0.875,0.529,0.81,302
devoid,0.626,44,345,1,1,0.219,0.436,0.3,389
fulfilling,0.626,103,799,1,1,0.823,0.417,0.755,902
harrowing,0.626,12,99,1,1,0.209,0.81,0.474,111
catastrophe,0.626,12,99,1,1,0.146,0.952,0.67,111
supremacy,0.626,12,99,1,1,0.794,0.706,0.943,111
planning,0.625,192,1484,1,1,0.894,0.462,0.705,1676
retrospect,0.625,9,76,1,1,0.406,0.5,0.538,85
sprint,0.625,9,76,1,1,0.549,0.649,0.528,85
retirement,0.625,79,615,1,1,0.25,0.324,0.255,694
plaza,0.625,9,76,1,1,0.69,0.346,0.529,85
summit,0.625,29,230,1,1,0.625,0.618,0.764,259
joyous,0.624,36,284,1,1,0.958,0.58,0.728,320
sail,0.623,37,292,1,1,0.615,0.22,0.325,329
unending,0.623,34,269,1,1,0.385,0.519,0.454,303
varsity,0.623,6,53,1,1,0.71,0.594,0.67,59
unwarranted,0.623,6,53,1,1,0.091,0.5,0.345,59
conservation,0.623,6,53,1,1,0.832,0.401,0.606,59
poison,0.623,97,755,1,1,0.083,0.76,0.573,852
policeman,0.623,6,53,1,1,0.542,0.708,0.898,59
trousers,0.623,6,53,1,1,0.625,0.314,0.442,59
respect,0.622,683,5280,1,1,0.927,0.344,0.758,5963
alike,0.622,53,416,1,1,0.653,0.173,0.444,469
influence,0.622,100,779,1,1,0.622,0.663,0.824,879
accessible,0.621,32,254,1,1,0.796,0.41,0.645,286
gush,0.621,10,84,1,1,0.51,0.49,0.381,94
intention,0.621,69,540,1,1,0.531,0.48,0.636,609
alter,0.621,47,370,1,1,0.333,0.694,0.654,417
exhaust,0.621,25,200,1,1,0.546,0.71,0.337,225
insatiable,0.62,14,115,1,1,0.375,0.656,0.558,129
draft,0.62,44,347,1,1,0.438,0.36,0.351,391
accidental,0.62,14,115,1,1,0.319,0.784,0.307,129
create,0.62,646,5004,1,1,0.786,0.588,0.789,5650
oven,0.62,18,146,1,1,0.583,0.425,0.606,164
rival,0.62,18,146,1,1,0.286,0.605,0.574,164
public,0.62,629,4874,1,1,0.592,0.51,0.664,5503
fearing,0.62,41,324,1,1,0.125,0.566,0.256,365
untitled,0.619,22,177,1,1,0.213,0.24,0.24,199
pen,0.619,112,874,1,1,0.622,0.194,0.25,986
circumstances,0.619,121,944,1,1,0.562,0.527,0.464,1065
orb,0.618,7,61,1,1,0.463,0.37,0.444,68
martyr,0.618,11,92,1,1,0.281,0.708,0.509,103
modified,0.618,3,30,1,1,0.561,0.458,0.693,33
externally,0.618,7,61,1,1,0.643,0.521,0.568,68
bran,0.618,7,61,1,1,0.688,0.433,0.483,68
hellfire,0.618,3,30,1,1,0.143,0.89,0.618,33
corrupting,0.618,3,30,1,1,0.062,0.804,0.38,33
thrash,0.618,3,30,1,1,0.26,0.51,0.472,33
installment,0.618,3,30,1,1,0.619,0.396,0.483,33
hamper,0.618,3,30,1,1,0.204,0.711,0.473,33
coordinate,0.618,3,30,1,1,0.698,0.429,0.694,33
levitate,0.618,3,30,1,1,0.561,0.598,0.551,33
conditioner,0.618,3,30,1,1,0.781,0.36,0.538,33
whimper,0.618,7,61,1,1,0.271,0.545,0.308,68
symbiotic,0.618,3,30,1,1,0.832,0.425,0.406,33
hovel,0.618,3,30,1,1,0.333,0.296,0.322,33
monetary,0.618,7,61,1,1,0.583,0.494,0.716,68
ultimate,0.617,171,1334,1,1,0.648,0.645,0.544,1505
obey,0.616,16,131,1,1,0.677,0.433,0.533,147
seize,0.616,12,100,1,1,0.656,0.644,0.673,112
pacing,0.616,12,100,1,1,0.583,0.551,0.491,112
tolerant,0.616,12,100,1,1,0.765,0.192,0.618,112
seemingly,0.615,79,621,1,1,0.49,0.41,0.356,700
completing,0.615,17,139,1,1,0.614,0.5,0.769,156
copper,0.615,8,69,1,1,0.58,0.26,0.5,77
viva,0.615,8,69,1,1,0.84,0.567,0.644,77
prodigy,0.615,8,69,1,1,0.812,0.704,0.824,77
slippery,0.613,13,108,1,1,0.219,0.74,0.343,121
psychic,0.613,32,256,1,1,0.49,0.559,0.726,288
product,0.613,84,661,1,1,0.646,0.417,0.648,745
resign,0.613,51,404,1,1,0.25,0.543,0.273,455
coldness,0.613,37,295,1,1,0.093,0.47,0.427,332
undo,0.613,18,147,1,1,0.365,0.444,0.349,165
converse,0.613,47,373,1,1,0.594,0.406,0.598,420
frame,0.612,82,646,1,1,0.469,0.333,0.42,728
state,0.612,1165,9089,1,1,0.562,0.32,0.604,10254
equate,0.612,63,498,1,1,0.724,0.382,0.624,561
copy,0.612,153,1200,1,1,0.46,0.24,0.263,1353
gripe,0.612,4,38,1,1,0.184,0.526,0.241,42
milestone,0.612,9,77,1,1,0.719,0.373,0.558,86
deterioration,0.612,4,38,1,1,0.13,0.512,0.283,42
cyberspace,0.612,4,38,1,1,0.677,0.594,0.611,42
crummy,0.612,4,38,1,1,0.125,0.531,0.224,42
indoctrination,0.612,4,38,1,1,0.327,0.657,0.698,42
clench,0.612,4,38,1,1,0.438,0.618,0.58,42
abolish,0.612,4,38,1,1,0.448,0.615,0.529,42
bladder,0.612,4,38,1,1,0.406,0.412,0.33,42
prima,0.612,4,38,1,1,0.633,0.406,0.427,42
sincerity,0.612,29,233,1,1,0.908,0.351,0.686,262
interviewer,0.612,9,77,1,1,0.552,0.736,0.816,86
steaming,0.612,9,77,1,1,0.592,0.553,0.402,86
security,0.611,170,1333,1,1,0.837,0.36,0.821,1503
elite,0.611,51,405,1,1,0.688,0.704,0.737,456
chilly,0.61,31,249,1,1,0.329,0.459,0.408,280
warmth,0.609,307,2407,1,1,0.878,0.307,0.602,2714
nuance,0.609,10,85,1,1,0.408,0.282,0.411,95
hunt,0.609,89,703,1,1,0.327,0.806,0.588,792
prevail,0.609,16,132,1,1,0.724,0.557,0.75,148
tension,0.608,51,406,1,1,0.304,0.81,0.529,457
intimacy,0.608,209,1643,1,1,0.857,0.802,0.558,1852
lean,0.608,255,2004,1,1,0.734,0.353,0.438,2259
softball,0.607,5,46,1,1,0.735,0.63,0.518,51
quill,0.607,5,46,1,1,0.521,0.216,0.263,51
lawsuit,0.607,5,46,1,1,0.219,0.794,0.611,51
cracking,0.607,41,328,1,1,0.327,0.557,0.286,369
bugged,0.607,5,46,1,1,0.561,0.439,0.5,51
techno,0.607,5,46,1,1,0.561,0.539,0.5,51
pounce,0.607,5,46,1,1,0.49,0.657,0.518,51
chapman,0.607,5,46,1,1,0.562,0.529,0.465,51
capsule,0.607,5,46,1,1,0.583,0.29,0.57,51
sorrowful,0.607,29,234,1,1,0.049,0.422,0.163,263
assist,0.607,30,242,1,1,0.833,0.435,0.629,272
newspaper,0.607,30,242,1,1,0.602,0.283,0.444,272
retrograde,0.606,18,148,1,1,0.208,0.464,0.415,166
source,0.606,219,1725,1,1,0.74,0.318,0.684,1944
mare,0.606,12,101,1,1,0.541,0.32,0.417,113
expenses,0.606,12,101,1,1,0.24,0.633,0.396,113
undeniable,0.606,12,101,1,1,0.552,0.473,0.778,113
editing,0.605,53,423,1,1,0.604,0.404,0.493,476
profess,0.604,6,54,1,1,0.633,0.42,0.643,60
defiance,0.604,6,54,1,1,0.333,0.78,0.76,60
yarn,0.604,6,54,1,1,0.51,0.265,0.233,60
manual,0.604,13,109,1,1,0.635,0.245,0.449,122
steps,0.604,188,1484,1,1,0.511,0.349,0.373,1672
shyness,0.604,27,219,1,1,0.312,0.265,0.246,246
epilepsy,0.604,6,54,1,1,0.061,0.854,0.25,60
ordinary,0.604,85,675,1,1,0.375,0.312,0.286,760
decorating,0.603,14,117,1,1,0.863,0.548,0.462,131
colony,0.603,14,117,1,1,0.716,0.353,0.593,131
internally,0.603,45,361,1,1,0.615,0.4,0.616,406
surprises,0.603,30,243,1,1,0.875,0.769,0.632,273
clutches,0.602,7,62,1,1,0.542,0.373,0.528,69
irrespective,0.602,7,62,1,1,0.497,0.538,0.745,69
verdict,0.602,7,62,1,1,0.325,0.689,0.8,69
womb,0.601,33,267,1,1,0.375,0.385,0.591,300
talkative,0.601,42,338,1,1,0.562,0.673,0.535,380
rot,0.601,77,614,1,1,0.031,0.558,0.301,691
imply,0.601,25,204,1,1,0.542,0.67,0.533,229
expanded,0.6,8,70,1,1,0.76,0.406,0.689,78
catalog,0.6,8,70,1,1,0.561,0.221,0.573,78
represent,0.6,80,638,1,1,0.781,0.433,0.861,718
anchor,0.6,26,212,1,1,0.52,0.284,0.564,238
vanish,0.6,26,212,1,1,0.236,0.48,0.347,238
peculiar,0.6,26,212,1,1,0.6,0.491,0.564,238
experimental,0.6,8,70,1,1,0.417,0.764,0.396,78
wiki,0.6,8,70,1,1,0.53,0.39,0.455,78
hum,0.6,44,354,1,1,0.49,0.296,0.276,398
wasteland,0.6,36,291,1,1,0.365,0.308,0.391,327
programming,0.599,28,228,1,1,0.6,0.435,0.732,256
galactic,0.599,9,78,1,1,0.656,0.67,0.776,87
ragged,0.599,9,78,1,1,0.198,0.519,0.226,87
undefeated,0.599,9,78,1,1,0.833,0.752,0.825,87
condition,0.598,207,1643,1,1,0.5,0.469,0.519,1850
glass,0.598,269,2134,1,1,0.49,0.404,0.322,2403
spoils,0.598,10,86,1,1,0.388,0.76,0.481,96
pumped,0.597,22,181,1,1,0.615,0.7,0.528,203
comforting,0.597,269,2136,1,1,0.906,0.337,0.62,2405
charm,0.597,70,561,1,1,0.833,0.363,0.649,631
admirable,0.597,11,94,1,1,0.929,0.6,0.87,105
mining,0.597,11,94,1,1,0.633,0.598,0.554,105
hail,0.597,23,189,1,1,0.459,0.627,0.411,212
sorrow,0.597,376,2984,1,1,0.052,0.235,0.164,3360
sassy,0.596,24,197,1,1,0.271,0.704,0.32,221
loud,0.596,547,4340,1,1,0.573,0.65,0.87,4887
ungodly,0.596,12,102,1,1,0.296,0.423,0.388,114
salmon,0.596,12,102,1,1,0.76,0.25,0.444,114
series,0.595,452,3590,1,1,0.622,0.431,0.42,4042
justice,0.595,167,1331,1,1,0.76,0.538,0.787,1498
preacher,0.595,13,110,1,1,0.551,0.388,0.741,123
dominant,0.595,28,229,1,1,0.406,0.854,0.893,257
optimism,0.595,28,229,1,1,0.949,0.565,0.814,257
studied,0.595,28,229,1,1,0.786,0.306,0.806,257
aspect,0.595,116,927,1,1,0.479,0.469,0.588,1043
weary,0.595,91,729,1,1,0.194,0.281,0.202,820
native,0.594,47,380,1,1,0.635,0.422,0.71,427
clash,0.594,15,126,1,1,0.293,0.918,0.453,141
force,0.594,415,3303,1,1,0.612,0.75,0.905,3718
twilight,0.593,88,706,1,1,0.622,0.341,0.633,794
gab,0.593,17,142,1,1,0.5,0.471,0.375,159
briefly,0.593,35,285,1,1,0.686,0.314,0.33,320
avoiding,0.593,115,921,1,1,0.457,0.433,0.309,1036
battlefield,0.592,20,166,1,1,0.133,0.918,0.781,186
sequence,0.592,20,166,1,1,0.543,0.35,0.529,186
suburbs,0.592,22,182,1,1,0.51,0.571,0.286,204
armed,0.591,26,214,1,1,0.188,0.75,0.808,240
positively,0.59,30,246,1,1,0.969,0.645,0.795,276
preaching,0.59,32,262,1,1,0.646,0.604,0.795,294
opera,0.59,36,294,1,1,0.714,0.5,0.483,330
established,0.59,36,294,1,1,0.796,0.394,0.694,330
photographer,0.589,43,350,1,1,0.714,0.481,0.562,393
hunting,0.588,76,614,1,1,0.448,0.713,0.714,690
responsibility,0.588,156,1253,1,1,0.76,0.5,0.852,1409
action,0.588,270,2164,1,1,0.76,0.898,0.802,2434
soul,0.587,2952,23611,1,1,0.77,0.22,0.51,26563
septum,0.586,2,23,1,1,0.276,0.423,0.41,25
boogeyman,0.586,2,23,1,1,0.292,0.559,0.567,25
concord,0.586,2,23,1,1,0.677,0.32,0.586,25
loopy,0.586,3,31,1,1,0.438,0.52,0.195,34
ignorance,0.586,123,991,1,1,0.153,0.417,0.209,1114
zillion,0.586,3,31,1,1,0.612,0.559,0.63,34
arbitrary,0.586,8,71,1,1,0.281,0.702,0.686,79
ceaseless,0.586,5,47,1,1,0.378,0.704,0.658,52
apologetic,0.586,3,31,1,1,0.479,0.461,0.571,34
sensational,0.586,6,55,1,1,0.938,0.827,0.858,61
begrudge,0.586,2,23,1,1,0.177,0.731,0.377,25
chauffeur,0.586,3,31,1,1,0.5,0.353,0.471,34
exhibit,0.586,23,191,1,1,0.688,0.633,0.708,214
relocation,0.586,2,23,1,1,0.396,0.5,0.475,25
rehearsal,0.586,13,111,1,1,0.667,0.47,0.5,124
counterpoint,0.586,4,39,1,1,0.438,0.509,0.538,43
prosperous,0.586,10,87,1,1,0.948,0.627,0.89,97
tubby,0.586,2,23,1,1,0.427,0.423,0.353,25
candor,0.586,2,23,1,1,0.74,0.389,0.607,25
arrive,0.586,82,663,1,1,0.837,0.406,0.585,745
strive,0.586,64,519,1,1,0.582,0.837,0.769,583
concise,0.586,2,23,1,1,0.583,0.298,0.62,25
salvage,0.586,6,55,1,1,0.622,0.51,0.832,61
faulty,0.586,5,47,1,1,0.184,0.52,0.378,52
genital,0.586,2,23,1,1,0.385,0.694,0.453,25
trite,0.586,4,39,1,1,0.458,0.418,0.29,43
expressive,0.586,15,127,1,1,0.755,0.724,0.685,142
buyer,0.586,3,31,1,1,0.613,0.519,0.649,34
infectious,0.586,9,79,1,1,0.142,0.76,0.422,88
feminine,0.586,26,215,1,1,0.802,0.52,0.394,241
outwards,0.586,2,23,1,1,0.44,0.472,0.4,25
temper,0.586,29,239,1,1,0.633,0.623,0.818,268
taint,0.586,4,39,1,1,0.141,0.425,0.226,43
belligerent,0.586,3,31,1,1,0.344,0.68,0.594,34
disparate,0.586,3,31,1,1,0.438,0.5,0.368,34
provoking,0.586,19,159,1,1,0.338,0.92,0.717,178
modify,0.586,2,23,1,1,0.458,0.584,0.625,25
eliminate,0.586,38,311,1,1,0.265,0.67,0.324,349
junkyard,0.586,2,23,1,1,0.177,0.398,0.302,25
electrical,0.586,5,47,1,1,0.531,0.62,0.688,52
accumulation,0.586,3,31,1,1,0.479,0.527,0.6,34
introduction,0.586,22,183,1,1,0.612,0.413,0.64,205
tights,0.586,5,47,1,1,0.583,0.343,0.269,52
throes,0.586,5,47,1,1,0.146,0.76,0.235,52
idealist,0.586,2,23,1,1,0.816,0.51,0.802,25
baton,0.586,4,39,1,1,0.272,0.235,0.519,43
fusion,0.586,11,95,1,1,0.635,0.561,0.741,106
rue,0.586,7,63,1,1,0.323,0.394,0.246,70
mambo,0.586,2,23,1,1,0.808,0.622,0.445,25
erroneous,0.586,2,23,1,1,0.057,0.561,0.245,25
trajectory,0.586,6,55,1,1,0.653,0.558,0.779,61
vapor,0.586,2,23,1,1,0.51,0.358,0.318,25
arson,0.586,2,23,1,1,0.133,0.904,0.567,25
germ,0.586,3,31,1,1,0.265,0.421,0.302,34
pita,0.586,2,23,1,1,0.551,0.279,0.255,25
chipper,0.586,3,31,1,1,0.418,0.588,0.5,34
knowledgeable,0.586,8,71,1,1,0.865,0.455,0.971,79
egregious,0.586,2,23,1,1,0.15,0.716,0.442,25
gloss,0.586,4,39,1,1,0.757,0.466,0.625,43
golfer,0.586,3,31,1,1,0.602,0.402,0.578,34
leafy,0.586,3,31,1,1,0.653,0.53,0.7,34
beetle,0.586,5,47,1,1,0.323,0.356,0.295,52
terrestrial,0.586,4,39,1,1,0.542,0.413,0.582,43
morose,0.586,5,47,1,1,0.24,0.663,0.264,52
incessantly,0.586,8,71,1,1,0.417,0.765,0.606,79
cutthroat,0.586,2,23,1,1,0.11,0.823,0.663,25
discernible,0.586,2,23,1,1,0.427,0.441,0.481,25
mule,0.586,4,39,1,1,0.32,0.337,0.254,43
regression,0.586,3,31,1,1,0.312,0.5,0.324,34
dosage,0.586,3,31,1,1,0.344,0.45,0.49,34
painless,0.586,5,47,1,1,0.785,0.173,0.491,52
climb,0.586,110,887,1,1,0.615,0.66,0.604,997
aqua,0.586,23,191,1,1,0.656,0.292,0.359,214
noose,0.586,10,87,1,1,0.356,0.3,0.33,97
nip,0.586,9,79,1,1,0.281,0.7,0.264,88
unfinished,0.586,18,151,1,1,0.188,0.368,0.264,169
unrelenting,0.586,9,79,1,1,0.5,0.79,0.875,88
rattled,0.586,5,47,1,1,0.354,0.641,0.33,52
lucrative,0.586,4,39,1,1,0.729,0.519,0.798,43
quickness,0.586,2,23,1,1,0.774,0.635,0.74,25
rumored,0.586,2,23,1,1,0.427,0.604,0.318,25
hoard,0.586,8,71,1,1,0.506,0.412,0.518,79
resonant,0.586,4,39,1,1,0.542,0.633,0.663,43
disconnects,0.586,2,23,1,1,0.256,0.357,0.241,25
justification,0.586,13,111,1,1,0.622,0.444,0.661,124
found,0.586,2959,23692,1,1,0.833,0.446,0.49,26651
mission,0.585,156,1257,1,1,0.765,0.633,0.87,1413
indie,0.584,59,480,1,1,0.479,0.368,0.43,539
core,0.584,151,1218,1,1,0.721,0.378,0.54,1369
recipe,0.584,44,360,1,1,0.698,0.271,0.415,404
exodus,0.581,23,192,1,1,0.286,0.663,0.567,215
awareness,0.581,225,1817,1,1,0.684,0.422,0.81,2042
spawn,0.581,21,176,1,1,0.542,0.586,0.709,197
silk,0.58,19,160,1,1,0.76,0.115,0.3,179
asset,0.579,17,144,1,1,0.797,0.765,0.788,161
tide,0.579,50,410,1,1,0.541,0.556,0.42,460
joyful,0.579,65,531,1,1,0.99,0.74,0.667,596
frequently,0.579,81,660,1,1,0.596,0.423,0.634,741
dismal,0.578,14,120,1,1,0.194,0.45,0.192,134
brightness,0.578,14,120,1,1,0.938,0.623,0.66,134
yen,0.578,14,120,1,1,0.51,0.435,0.508,134
wine,0.577,497,4021,1,1,0.792,0.417,0.457,4518
passion,0.576,245,1987,1,1,0.854,0.865,0.728,2232
wrongly,0.576,11,96,1,1,0.054,0.55,0.202,107
fifteen,0.576,23,193,1,1,0.49,0.29,0.443,216
conscience,0.576,71,581,1,1,0.663,0.375,0.721,652
trumpet,0.576,11,96,1,1,0.573,0.57,0.393,107
sin,0.576,154,1252,1,1,0.177,0.712,0.449,1406
television,0.575,66,541,1,1,0.633,0.391,0.547,607
scarce,0.575,10,88,1,1,0.292,0.324,0.218,98
folly,0.575,10,88,1,1,0.184,0.833,0.363,98
attentive,0.575,10,88,1,1,0.812,0.52,0.724,98
eye,0.575,527,4273,1,1,0.531,0.265,0.425,4800
myth,0.574,51,420,1,1,0.458,0.432,0.338,471
intense,0.574,234,1902,1,1,0.592,0.774,0.679,2136
remarkably,0.574,9,80,1,1,0.688,0.618,0.868,89
notebook,0.574,39,323,1,1,0.449,0.167,0.442,362
opposition,0.574,39,323,1,1,0.135,0.729,0.592,362
cassette,0.574,9,80,1,1,0.49,0.334,0.355,89
powerful,0.574,395,3207,1,1,0.865,0.83,0.991,3602
obscure,0.574,38,315,1,1,0.37,0.551,0.278,353
bath,0.573,134,1093,1,1,0.725,0.26,0.263,1227
eccentric,0.573,18,153,1,1,0.531,0.806,0.721,171
content,0.573,905,7344,1,1,0.764,0.296,0.559,8249
muscular,0.573,8,72,1,1,0.531,0.434,0.577,80
expertise,0.573,8,72,1,1,0.792,0.589,0.925,80
rearrange,0.573,8,72,1,1,0.656,0.51,0.729,80
springtime,0.573,8,72,1,1,0.837,0.439,0.722,80
shamed,0.573,26,218,1,1,0.135,0.567,0.218,244
declare,0.572,25,210,1,1,0.677,0.623,0.668,235
collect,0.572,76,624,1,1,0.635,0.481,0.491,700
technical,0.572,16,137,1,1,0.51,0.49,0.736,153
betterment,0.572,16,137,1,1,0.898,0.536,0.769,153
daydream,0.571,24,202,1,1,0.75,0.337,0.456,226
bound,0.571,122,998,1,1,0.417,0.667,0.31,1120
concrete,0.571,56,462,1,1,0.633,0.42,0.547,518
dissipate,0.571,7,64,1,1,0.385,0.368,0.355,71
steep,0.571,15,129,1,1,0.312,0.612,0.321,144
strained,0.571,7,64,1,1,0.122,0.656,0.58,71
redo,0.571,7,64,1,1,0.481,0.5,0.535,71
trial,0.571,54,446,1,1,0.438,0.663,0.612,500
glowing,0.57,45,373,1,1,0.94,0.62,0.737,418
refused,0.57,58,479,1,1,0.163,0.475,0.188,537
sic,0.569,6,56,1,1,0.37,0.459,0.38,62
weaken,0.569,6,56,1,1,0.112,0.25,0.223,62
kettle,0.569,13,113,1,1,0.357,0.497,0.333,126
swarm,0.569,6,56,1,1,0.302,0.735,0.458,62
smite,0.569,6,56,1,1,0.303,0.846,0.682,62
jigsaw,0.569,6,56,1,1,0.594,0.582,0.519,62
loon,0.569,13,113,1,1,0.429,0.392,0.325,126
stump,0.569,6,56,1,1,0.449,0.51,0.34,62
entourage,0.569,6,56,1,1,0.491,0.567,0.467,62
tram,0.569,6,56,1,1,0.667,0.628,0.492,62
strict,0.569,27,227,1,1,0.5,0.646,0.878,254
smother,0.569,13,113,1,1,0.292,0.685,0.42,126
southern,0.569,55,455,1,1,0.552,0.269,0.37,510
talent,0.568,137,1123,1,1,0.959,0.607,0.811,1260
modern,0.568,233,1905,1,1,0.855,0.423,0.691,2138
elevator,0.568,33,276,1,1,0.562,0.604,0.676,309
strengthen,0.568,33,276,1,1,0.802,0.796,0.971,309
torn,0.568,100,822,1,1,0.153,0.51,0.283,922
unwilling,0.568,19,162,1,1,0.302,0.316,0.179,181
approximately,0.568,19,162,1,1,0.622,0.396,0.538,181
shape,0.567,122,1002,1,1,0.592,0.24,0.422,1124
networking,0.567,37,309,1,1,0.625,0.482,0.545,346
immortal,0.567,56,464,1,1,0.812,0.75,0.795,520
heavily,0.567,81,668,1,1,0.542,0.679,0.814,749
synonymous,0.566,30,252,1,1,0.48,0.323,0.4,282
dangerously,0.566,29,244,1,1,0.082,0.93,0.564,273
personification,0.566,5,48,1,1,0.76,0.471,0.691,53
coup,0.566,11,97,1,1,0.275,0.815,0.607,108
fraternity,0.566,5,48,1,1,0.892,0.536,0.679,53
bible,0.565,140,1151,1,1,0.719,0.225,0.726,1291
privately,0.565,16,138,1,1,0.458,0.562,0.541,154
outlook,0.565,33,277,1,1,0.83,0.525,0.625,310
error,0.564,44,367,1,1,0.094,0.559,0.198,411
blizzard,0.564,10,89,1,1,0.375,0.726,0.417,99
socialize,0.563,161,1325,1,1,0.907,0.683,0.726,1486
choice,0.563,805,6597,1,1,0.745,0.52,0.664,7402
sinking,0.563,101,834,1,1,0.135,0.439,0.342,935
hallelujah,0.563,15,130,1,1,0.77,0.554,0.657,145
occur,0.563,41,343,1,1,0.451,0.561,0.51,384
urgent,0.563,25,212,1,1,0.327,0.918,0.623,237
dessert,0.563,25,212,1,1,0.755,0.491,0.404,237
recommend,0.562,262,2155,1,1,0.812,0.439,0.672,2417
trademark,0.562,4,40,1,1,0.667,0.344,0.75,44
pessimism,0.562,9,81,1,1,0.083,0.484,0.264,90
buggy,0.562,4,40,1,1,0.5,0.509,0.327,44
gator,0.562,4,40,1,1,0.418,0.52,0.547,44
baseline,0.562,4,40,1,1,0.483,0.367,0.509,44
unaccompanied,0.562,4,40,1,1,0.292,0.376,0.297,44
pamper,0.562,14,122,1,1,0.792,0.321,0.348,136
railing,0.562,4,40,1,1,0.551,0.298,0.44,44
morbid,0.562,14,122,1,1,0.09,0.833,0.395,136
jagged,0.562,9,81,1,1,0.082,0.462,0.213,90
agnostic,0.562,4,40,1,1,0.306,0.396,0.574,44
seeds,0.56,37,311,1,1,0.731,0.269,0.418,348
weapon,0.56,51,426,1,1,0.054,0.84,0.831,477
animated,0.56,27,229,1,1,0.823,0.676,0.538,256
radiate,0.56,13,114,1,1,0.719,0.735,0.738,127
melting,0.559,31,262,1,1,0.592,0.47,0.538,293
wise,0.559,229,1890,1,1,0.878,0.25,0.861,2119
unjust,0.559,8,73,1,1,0.115,0.625,0.278,81
mantle,0.559,8,73,1,1,0.51,0.269,0.422,81
alphabet,0.559,8,73,1,1,0.562,0.204,0.672,81
noble,0.559,48,402,1,1,0.906,0.345,0.61,450
shell,0.558,116,962,1,1,0.615,0.408,0.391,1078
recreate,0.558,12,106,1,1,0.724,0.545,0.616,118
inherent,0.558,29,246,1,1,0.562,0.439,0.48,275
pinch,0.557,16,139,1,1,0.34,0.632,0.339,155
extension,0.557,16,139,1,1,0.49,0.51,0.529,155
hound,0.557,16,139,1,1,0.417,0.528,0.582,155
incident,0.556,32,271,1,1,0.084,0.662,0.482,303
comics,0.556,77,642,1,1,0.69,0.556,0.384,719
praying,0.556,245,2027,1,1,0.646,0.235,0.415,2272
heap,0.556,15,131,1,1,0.582,0.51,0.474,146
menstrual,0.556,3,32,1,1,0.408,0.519,0.435,35
repression,0.556,7,65,1,1,0.214,0.764,0.481,72
slash,0.556,11,98,1,1,0.26,0.5,0.509,109
stair,0.556,3,32,1,1,0.375,0.354,0.345,35
meddle,0.556,3,32,1,1,0.302,0.77,0.526,35
tingle,0.556,3,32,1,1,0.46,0.56,0.264,35
conversational,0.556,7,65,1,1,0.719,0.431,0.596,72
wrapper,0.556,3,32,1,1,0.625,0.358,0.391,35
statesman,0.556,3,32,1,1,0.51,0.49,0.736,35
nacho,0.556,3,32,1,1,0.667,0.259,0.333,35
watered,0.556,7,65,1,1,0.615,0.29,0.377,72
bal,0.556,3,32,1,1,0.49,0.412,0.432,35
curate,0.556,3,32,1,1,0.726,0.418,0.526,35
tgif,0.556,3,32,1,1,0.542,0.471,0.436,35
scone,0.556,3,32,1,1,0.418,0.287,0.229,35
supernatural,0.555,30,255,1,1,0.622,0.824,0.733,285
martial,0.553,10,90,1,1,0.48,0.71,0.737,100
spec,0.553,10,90,1,1,0.583,0.426,0.691,100
vagabond,0.553,10,90,1,1,0.384,0.531,0.144,100
secular,0.553,10,90,1,1,0.463,0.461,0.52,100
tiresome,0.553,21,181,1,1,0.24,0.542,0.153,202
gear,0.552,35,297,1,1,0.51,0.577,0.509,332
violently,0.552,17,148,1,1,0.12,0.97,0.527,165
instructions,0.551,13,115,1,1,0.582,0.302,0.556,128
candle,0.551,76,637,1,1,0.602,0.221,0.344,713
supplement,0.551,6,57,1,1,0.745,0.406,0.491,63
oyster,0.551,6,57,1,1,0.5,0.311,0.327,63
inventory,0.551,6,57,1,1,0.594,0.463,0.49,63
vessel,0.551,27,231,1,1,0.49,0.398,0.538,258
organ,0.551,13,115,1,1,0.51,0.469,0.538,128
assignment,0.551,30,256,1,1,0.483,0.398,0.745,286
dine,0.55,16,140,1,1,0.821,0.519,0.478,156
sentence,0.55,124,1036,1,1,0.625,0.265,0.548,1160
static,0.55,26,223,1,1,0.297,0.25,0.366,249
butler,0.55,19,165,1,1,0.469,0.225,0.438,184
purchasing,0.55,9,82,1,1,0.667,0.653,0.661,91
subsequent,0.55,9,82,1,1,0.449,0.385,0.4,91
priority,0.549,87,730,1,1,0.878,0.562,0.864,817
belief,0.549,90,755,1,1,0.896,0.375,0.656,845
genetic,0.549,12,107,1,1,0.562,0.288,0.726,119
meltdown,0.549,25,215,1,1,0.629,0.657,0.602,240
regional,0.549,12,107,1,1,0.62,0.4,0.607,119
degree,0.547,146,1222,1,1,0.724,0.365,0.663,1368
instrumental,0.547,27,232,1,1,0.74,0.472,0.647,259
overrated,0.546,106,890,1,1,0.312,0.63,0.482,996
proposition,0.546,8,74,1,1,0.627,0.75,0.565,82
brew,0.546,23,199,1,1,0.74,0.538,0.758,222
tyranny,0.546,14,124,1,1,0.112,0.792,0.705,138
riches,0.546,26,224,1,1,0.958,0.694,0.88,250
depict,0.546,11,99,1,1,0.663,0.529,0.723,110
straighten,0.546,5,49,1,1,0.677,0.5,0.685,54
stub,0.546,2,24,1,1,0.396,0.32,0.367,26
cremation,0.546,2,24,1,1,0.084,0.62,0.42,26
cunning,0.546,8,74,1,1,0.604,0.685,0.683,82
hypothermia,0.546,2,24,1,1,0.184,0.62,0.301,26
miracles,0.546,23,199,1,1,0.922,0.735,0.692,222
invincible,0.546,20,174,1,1,0.867,0.853,0.914,194
whisk,0.546,2,24,1,1,0.5,0.537,0.412,26
fixation,0.546,8,74,1,1,0.562,0.459,0.655,82
diplomatic,0.546,5,49,1,1,0.653,0.363,0.918,54
shabby,0.546,5,49,1,1,0.235,0.519,0.259,54
holographic,0.546,2,24,1,1,0.51,0.471,0.555,26
promoter,0.546,2,24,1,1,0.646,0.573,0.817,26
digestive,0.546,2,24,1,1,0.542,0.413,0.434,26
omitted,0.546,2,24,1,1,0.26,0.235,0.211,26
misbehave,0.546,2,24,1,1,0.02,0.847,0.304,26
beaming,0.546,8,74,1,1,0.892,0.654,0.587,82
presume,0.546,14,124,1,1,0.448,0.635,0.635,138
revere,0.546,5,49,1,1,0.75,0.562,0.608,54
impart,0.546,2,24,1,1,0.521,0.441,0.694,26
unattached,0.546,8,74,1,1,0.192,0.439,0.283,82
humanoid,0.546,5,49,1,1,0.521,0.462,0.491,54
detail,0.546,47,399,1,1,0.514,0.406,0.528,446
evens,0.546,2,24,1,1,0.592,0.43,0.457,26
leukemia,0.546,2,24,1,1,0.094,0.572,0.351,26
thrust,0.546,14,124,1,1,0.51,0.647,0.663,138
bleed,0.545,58,491,1,1,0.041,0.843,0.346,549
masterpiece,0.545,125,1050,1,1,0.926,0.623,0.847,1175
agony,0.544,86,725,1,1,0.083,0.775,0.393,811
access,0.544,161,1351,1,1,0.714,0.472,0.567,1512
limited,0.544,129,1084,1,1,0.229,0.273,0.38,1213
tedious,0.544,19,166,1,1,0.104,0.406,0.241,185
entirety,0.543,36,308,1,1,0.854,0.46,0.804,344
norm,0.543,50,425,1,1,0.5,0.245,0.527,475
agitated,0.543,13,116,1,1,0.444,0.882,0.491,129
lunchtime,0.543,13,116,1,1,0.896,0.398,0.444,129
actuality,0.542,10,91,1,1,0.75,0.464,0.6,101
vortex,0.542,10,91,1,1,0.408,0.691,0.602,101
midday,0.542,10,91,1,1,0.658,0.25,0.403,101
lagoon,0.541,7,66,1,1,0.66,0.231,0.373,73
guitarist,0.541,7,66,1,1,0.827,0.74,0.549,73
lending,0.541,7,66,1,1,0.51,0.585,0.462,73
inherit,0.541,7,66,1,1,0.745,0.546,0.694,73
barber,0.541,23,200,1,1,0.543,0.459,0.356,223
countless,0.54,84,711,1,1,0.52,0.566,0.534,795
lonesome,0.54,153,1289,1,1,0.281,0.213,0.336,1442
evening,0.54,560,4701,1,1,0.458,0.185,0.318,5261
neat,0.54,33,284,1,1,0.878,0.235,0.491,317
viable,0.539,12,108,1,1,0.656,0.32,0.667,120
compromise,0.539,69,586,1,1,0.677,0.52,0.805,655
havoc,0.539,22,192,1,1,0.163,0.769,0.535,214
reform,0.538,14,125,1,1,0.531,0.49,0.797,139
abruptly,0.538,9,83,1,1,0.25,0.808,0.556,92
throb,0.538,4,41,1,1,0.5,0.673,0.556,45
dissect,0.538,4,41,1,1,0.367,0.75,0.595,45
fable,0.538,4,41,1,1,0.663,0.387,0.389,45
devilish,0.538,4,41,1,1,0.073,0.865,0.49,45
flap,0.538,4,41,1,1,0.275,0.385,0.344,45
twinge,0.538,4,41,1,1,0.316,0.72,0.471,45
twitching,0.538,4,41,1,1,0.292,0.7,0.482,45
admiring,0.538,19,167,1,1,0.867,0.578,0.629,186
waver,0.538,4,41,1,1,0.426,0.63,0.255,45
defeat,0.537,91,772,1,1,0.092,0.5,0.224,863
parting,0.536,21,184,1,1,0.26,0.542,0.353,205
thriving,0.536,65,554,1,1,0.865,0.521,0.779,619
format,0.536,16,142,1,1,0.562,0.308,0.438,158
revisit,0.536,16,142,1,1,0.552,0.53,0.509,158
throne,0.536,84,714,1,1,0.724,0.606,0.887,798
machine,0.536,164,1387,1,1,0.51,0.5,0.707,1551
produce,0.536,71,605,1,1,0.908,0.737,0.836,676
unfit,0.536,11,100,1,1,0.25,0.368,0.185,111
righteousness,0.535,18,159,1,1,0.802,0.66,0.897,177
thanking,0.535,25,218,1,1,0.917,0.538,0.658,243
stripped,0.534,27,235,1,1,0.255,0.615,0.278,262
bookworm,0.534,6,58,1,1,0.563,0.337,0.316,64
tactic,0.534,13,117,1,1,0.531,0.434,0.798,130
blessed,0.534,389,3288,1,1,0.91,0.279,0.696,3677
possessed,0.533,22,193,1,1,0.327,0.884,0.611,215
signature,0.533,15,134,1,1,0.57,0.422,0.657,149
clan,0.533,40,345,1,1,0.562,0.491,0.686,385
oval,0.533,24,210,1,1,0.417,0.28,0.33,234
essentially,0.532,69,590,1,1,0.75,0.373,0.802,659
locate,0.532,8,75,1,1,0.583,0.52,0.786,83
composer,0.532,8,75,1,1,0.822,0.588,0.691,83
adrift,0.532,39,337,1,1,0.398,0.486,0.23,376
supreme,0.532,59,506,1,1,0.812,0.7,0.974,565
couch,0.531,274,2323,1,1,0.594,0.082,0.198,2597
booth,0.531,61,523,1,1,0.531,0.4,0.31,584
terms,0.531,215,1825,1,1,0.49,0.362,0.645,2040
appreciates,0.531,43,371,1,1,0.765,0.5,0.656,414
welcomed,0.531,67,574,1,1,0.927,0.585,0.7,641
finish,0.531,311,2638,1,1,0.471,0.429,0.545,2949
teaching,0.53,136,1158,1,1,0.822,0.444,0.736,1294
ribbon,0.53,12,109,1,1,0.719,0.288,0.357,121
mind,0.53,5001,42333,1,1,0.65,0.388,0.627,47334
recess,0.53,14,126,1,1,0.646,0.51,0.367,140
cleaning,0.53,104,888,1,1,0.595,0.396,0.427,992
unhealthy,0.529,165,1405,1,1,0.115,0.549,0.214,1570
ashes,0.529,71,609,1,1,0.327,0.279,0.142,680
publishing,0.529,18,160,1,1,0.708,0.615,0.66,178
universe,0.529,654,5550,1,1,0.694,0.454,0.839,6204
collectively,0.529,20,177,1,1,0.817,0.573,0.533,197
unique,0.528,198,1686,1,1,0.823,0.347,0.661,1884
glance,0.528,47,406,1,1,0.625,0.357,0.454,453
emphasis,0.528,24,211,1,1,0.653,0.745,0.816,235
threaten,0.528,28,245,1,1,0.104,0.958,0.59,273
productive,0.528,237,2018,1,1,0.847,0.677,0.773,2255
challenge,0.527,266,2265,1,1,0.469,0.922,0.713,2531
war,0.526,398,3389,1,1,0.022,0.892,0.727,3787
benefit,0.526,144,1231,1,1,0.906,0.422,0.806,1375
anchorage,0.526,3,33,1,1,0.5,0.325,0.639,36
awesomeness,0.526,5,50,1,1,0.917,0.647,0.927,55
unprovoked,0.526,3,33,1,1,0.565,0.327,0.385,36
disk,0.526,3,33,1,1,0.573,0.423,0.412,36
regretted,0.526,15,135,1,1,0.352,0.54,0.368,150
asinine,0.526,3,33,1,1,0.429,0.472,0.433,36
unresolved,0.526,9,84,1,1,0.135,0.441,0.173,93
frigid,0.526,13,118,1,1,0.219,0.481,0.395,131
porcelain,0.526,7,67,1,1,0.562,0.31,0.349,74
restraining,0.526,7,67,1,1,0.296,0.702,0.672,74
troop,0.526,5,50,1,1,0.375,0.696,0.75,55
ambivalent,0.526,5,50,1,1,0.51,0.404,0.482,55
identical,0.526,11,101,1,1,0.635,0.38,0.527,112
bicker,0.526,3,33,1,1,0.143,0.643,0.552,36
heaving,0.526,5,50,1,1,0.201,0.843,0.491,55
colossal,0.526,5,50,1,1,0.698,0.692,0.9,55
aloha,0.526,3,33,1,1,0.698,0.44,0.441,36
assassination,0.526,5,50,1,1,0.083,0.941,0.525,55
earnestly,0.526,3,33,1,1,0.847,0.49,0.717,36
makeover,0.526,3,33,1,1,0.771,0.51,0.596,36
churn,0.526,3,33,1,1,0.316,0.491,0.407,36
germs,0.526,7,67,1,1,0.135,0.51,0.38,74
sigma,0.526,3,33,1,1,0.49,0.472,0.535,36
petal,0.526,7,67,1,1,0.81,0.194,0.211,74
chew,0.526,21,186,1,1,0.52,0.49,0.404,207
justifiable,0.526,3,33,1,1,0.786,0.413,0.821,36
wavelength,0.526,11,101,1,1,0.604,0.442,0.516,112
unsustainable,0.526,3,33,1,1,0.255,0.65,0.406,36
appliances,0.526,3,33,1,1,0.594,0.394,0.567,36
authority,0.526,35,305,1,1,0.592,0.592,0.934,340
cabaret,0.526,3,33,1,1,0.677,0.656,0.482,36
offing,0.526,3,33,1,1,0.49,0.412,0.447,36
misuse,0.526,5,50,1,1,0.083,0.56,0.196,55
porcupine,0.526,3,33,1,1,0.388,0.421,0.367,36
sly,0.526,11,101,1,1,0.573,0.69,0.75,112
lawn,0.526,31,271,1,1,0.686,0.153,0.192,302
paradise,0.525,188,1606,1,1,0.875,0.54,0.796,1794
denied,0.524,40,348,1,1,0.188,0.604,0.333,388
search,0.524,342,2920,1,1,0.635,0.58,0.462,3262
float,0.523,51,442,1,1,0.688,0.394,0.344,493
foul,0.523,24,212,1,1,0.224,0.46,0.355,236
effective,0.523,74,638,1,1,0.844,0.632,0.891,712
chunk,0.523,22,195,1,1,0.365,0.287,0.214,217
grove,0.523,22,195,1,1,0.604,0.245,0.417,217
dynamics,0.523,18,161,1,1,0.745,0.682,0.774,179
calendar,0.522,35,306,1,1,0.48,0.212,0.473,341
tap,0.522,65,562,1,1,0.461,0.37,0.349,627
routine,0.522,140,1202,1,1,0.365,0.219,0.333,1342
whim,0.522,14,127,1,1,0.378,0.68,0.467,141
grasp,0.522,87,750,1,1,0.56,0.623,0.57,837
dodging,0.521,12,110,1,1,0.396,0.654,0.382,122
hysteria,0.521,12,110,1,1,0.224,0.906,0.482,122
inspired,0.521,203,1741,1,1,0.967,0.702,0.736,1944
starry,0.521,49,426,1,1,0.438,0.643,0.434,475
reconsider,0.52,10,93,1,1,0.448,0.442,0.582,103
manifesto,0.52,10,93,1,1,0.646,0.519,0.676,103
tender,0.52,74,640,1,1,0.63,0.52,0.509,714
guild,0.52,28,247,1,1,0.58,0.459,0.729,275
transparency,0.519,8,76,1,1,0.847,0.26,0.587,84
wool,0.519,8,76,1,1,0.583,0.132,0.345,84
receive,0.519,197,1693,1,1,0.74,0.462,0.551,1890
salute,0.519,35,307,1,1,0.833,0.542,0.681,342
plural,0.519,8,76,1,1,0.56,0.432,0.564,84
savannah,0.519,8,76,1,1,0.729,0.212,0.309,84
greatness,0.519,87,752,1,1,0.99,0.75,0.943,839
live,0.519,5831,49913,1,1,0.88,0.673,0.676,55744
beneath,0.518,177,1523,1,1,0.354,0.173,0.233,1700
swell,0.518,15,136,1,1,0.36,0.679,0.348,151
parish,0.518,15,136,1,1,0.698,0.354,0.582,151
ruling,0.518,15,136,1,1,0.177,0.566,0.41,151
fate,0.518,182,1566,1,1,0.571,0.479,0.712,1748
unexpected,0.518,70,607,1,1,0.5,0.72,0.333,677
foreword,0.517,6,59,1,1,0.59,0.314,0.551,65
soviet,0.517,6,59,1,1,0.347,0.58,0.536,65
migrate,0.517,6,59,1,1,0.415,0.58,0.454,65
hostility,0.517,13,119,1,1,0.122,0.775,0.465,132
alliance,0.517,20,179,1,1,0.696,0.473,0.769,199
stresses,0.517,25,222,1,1,0.115,0.817,0.396,247
labor,0.517,51,445,1,1,0.594,0.639,0.754,496
objective,0.516,23,205,1,1,0.724,0.337,0.736,228
sensual,0.515,16,145,1,1,0.73,0.79,0.642,161
wax,0.515,16,145,1,1,0.436,0.245,0.309,161
critical,0.515,77,669,1,1,0.312,0.802,0.545,746
bookstore,0.515,21,188,1,1,0.771,0.18,0.503,209
structure,0.515,53,463,1,1,0.562,0.356,0.712,516
clay,0.515,26,231,1,1,0.542,0.25,0.267,257
early,0.514,866,7454,1,1,0.633,0.373,0.426,8320
scope,0.514,14,128,1,1,0.656,0.386,0.718,142
sling,0.514,4,42,1,1,0.417,0.423,0.404,46
err,0.514,14,128,1,1,0.146,0.66,0.236,142
center,0.514,164,1418,1,1,0.643,0.231,0.431,1582
investigate,0.514,14,128,1,1,0.64,0.5,0.781,142
diabetic,0.514,4,42,1,1,0.125,0.269,0.237,46
lax,0.514,4,42,1,1,0.43,0.401,0.3,46
blindfold,0.514,4,42,1,1,0.448,0.684,0.337,46
simmer,0.514,4,42,1,1,0.65,0.293,0.393,46
succession,0.514,4,42,1,1,0.698,0.481,0.587,46
octopus,0.514,9,85,1,1,0.713,0.378,0.411,94
influx,0.514,4,42,1,1,0.622,0.635,0.575,46
levy,0.514,4,42,1,1,0.438,0.42,0.491,46
scapegoat,0.514,4,42,1,1,0.184,0.685,0.481,46
feces,0.514,4,42,1,1,0.24,0.407,0.307,46
pertinent,0.514,4,42,1,1,0.58,0.333,0.723,46
barrage,0.514,4,42,1,1,0.388,0.871,0.627,46
ineffectual,0.514,4,42,1,1,0.163,0.412,0.2,46
sponge,0.514,9,85,1,1,0.551,0.192,0.219,94
strongly,0.514,67,584,1,1,0.63,0.817,0.885,651
glimpse,0.514,47,412,1,1,0.646,0.48,0.455,459
offered,0.513,116,1006,1,1,0.582,0.49,0.544,1122
testimony,0.513,17,154,1,1,0.615,0.578,0.643,171
recognized,0.513,48,421,1,1,0.875,0.458,0.786,469
capital,0.512,51,447,1,1,0.52,0.5,0.798,498
inhabit,0.512,12,111,1,1,0.656,0.378,0.556,123
company,0.512,3875,33403,1,1,0.906,0.425,0.798,37278
intellectual,0.512,78,680,1,1,0.906,0.455,0.845,758
persistent,0.511,31,275,1,1,0.646,0.667,0.815,306
catalogue,0.511,7,68,1,1,0.647,0.327,0.533,75
nay,0.511,15,137,1,1,0.344,0.29,0.325,152
miraculous,0.511,7,68,1,1,0.875,0.706,0.812,75
suspension,0.511,7,68,1,1,0.288,0.53,0.426,75
pebble,0.511,7,68,1,1,0.354,0.353,0.287,75
melancholic,0.511,50,439,1,1,0.181,0.306,0.277,489
uplift,0.51,18,163,1,1,0.656,0.779,0.771,181
competition,0.51,78,681,1,1,0.58,0.79,0.798,759
napping,0.51,21,189,1,1,0.765,0.046,0.306,210
shortage,0.51,10,94,1,1,0.094,0.455,0.198,104
misconception,0.51,10,94,1,1,0.21,0.557,0.291,104
comprehension,0.509,13,120,1,1,0.908,0.387,0.688,133
creed,0.509,13,120,1,1,0.573,0.245,0.544,133
unanswered,0.509,13,120,1,1,0.276,0.361,0.219,133
annoys,0.509,30,267,1,1,0.146,0.778,0.435,297
shades,0.508,48,423,1,1,0.49,0.3,0.38,471
choosing,0.508,224,1946,1,1,0.719,0.529,0.689,2170
kink,0.507,31,276,1,1,0.337,0.634,0.321,307
lamp,0.507,46,406,1,1,0.51,0.26,0.309,452
experiences,0.506,283,2460,1,1,0.793,0.647,0.795,2743
deteriorate,0.506,5,51,1,1,0.083,0.471,0.202,56
imperfection,0.506,8,77,1,1,0.19,0.567,0.321,85
duplicate,0.506,2,25,1,1,0.521,0.49,0.338,27
falcon,0.506,11,103,1,1,0.557,0.58,0.678,114
insistent,0.506,5,51,1,1,0.552,0.635,0.701,56
lopsided,0.506,2,25,1,1,0.125,0.5,0.272,27
foaming,0.506,2,25,1,1,0.643,0.24,0.198,27
apron,0.506,2,25,1,1,0.582,0.208,0.245,27
blur,0.506,23,207,1,1,0.268,0.471,0.205,230
conjecture,0.506,2,25,1,1,0.396,0.398,0.534,27
unload,0.506,5,51,1,1,0.656,0.639,0.573,56
delayed,0.506,20,181,1,1,0.188,0.49,0.216,201
uncommon,0.506,14,129,1,1,0.459,0.429,0.373,143
nil,0.506,2,25,1,1,0.286,0.143,0.157,27
confessions,0.506,14,129,1,1,0.325,0.538,0.658,143
gooey,0.506,2,25,1,1,0.392,0.48,0.445,27
inexperience,0.506,2,25,1,1,0.208,0.614,0.151,27
misunderstand,0.506,14,129,1,1,0.177,0.548,0.382,143
allegation,0.506,2,25,1,1,0.578,0.578,0.608,27
tirade,0.506,2,25,1,1,0.378,0.587,0.532,27
accelerate,0.506,2,25,1,1,0.615,0.902,0.759,27
underwood,0.506,2,25,1,1,0.51,0.453,0.51,27
luncheon,0.506,2,25,1,1,0.837,0.24,0.441,27
garnet,0.506,2,25,1,1,0.643,0.418,0.368,27
lifeguard,0.506,2,25,1,1,0.87,0.606,0.786,27
vindication,0.506,2,25,1,1,0.531,0.632,0.764,27
dissenting,0.506,2,25,1,1,0.208,0.552,0.366,27
enroll,0.506,2,25,1,1,0.696,0.53,0.611,27
courier,0.506,2,25,1,1,0.551,0.383,0.441,27
scribe,0.506,2,25,1,1,0.541,0.264,0.491,27
malarkey,0.506,2,25,1,1,0.396,0.5,0.465,27
dainty,0.506,2,25,1,1,0.604,0.284,0.424,27
adherence,0.506,2,25,1,1,0.76,0.307,0.63,27
flirtation,0.506,2,25,1,1,0.653,0.719,0.482,27
surrounding,0.506,147,1282,1,1,0.531,0.422,0.669,1429
expression,0.506,127,1109,1,1,0.79,0.65,0.721,1236
duty,0.505,95,832,1,1,0.583,0.579,0.651,927
distracted,0.505,99,867,1,1,0.194,0.392,0.213,966
serve,0.505,172,1501,1,1,0.622,0.4,0.384,1673
unnecessary,0.503,80,703,1,1,0.219,0.358,0.19,783
coast,0.503,106,929,1,1,0.719,0.396,0.458,1035
blade,0.503,51,451,1,1,0.378,0.602,0.594,502
petite,0.503,12,112,1,1,0.51,0.354,0.245,124
chords,0.503,12,112,1,1,0.639,0.406,0.388,124
celebrations,0.503,25,225,1,1,0.958,0.794,0.714,250
conquer,0.503,65,573,1,1,0.694,0.873,0.971,638
stingy,0.502,9,86,1,1,0.094,0.548,0.283,95
frontier,0.502,9,86,1,1,0.438,0.55,0.65,95
puzzle,0.502,36,321,1,1,0.537,0.471,0.525,357
translation,0.502,81,713,1,1,0.633,0.435,0.598,794
starlight,0.501,23,208,1,1,0.908,0.368,0.611,231
aspects,0.501,71,626,1,1,0.439,0.48,0.565,697
tend,0.501,362,3162,1,1,0.604,0.398,0.412,3524
plaster,0.501,6,60,1,1,0.438,0.264,0.255,66
radiation,0.501,6,60,1,1,0.167,0.741,0.536,66
obsolete,0.501,6,60,1,1,0.337,0.321,0.25,66
jumpsuit,0.501,6,60,1,1,0.562,0.365,0.361,66
earl,0.501,13,121,1,1,0.582,0.461,0.794,134
inspire,0.501,90,792,1,1,0.918,0.627,0.759,882
printing,0.501,6,60,1,1,0.646,0.654,0.615,66
baseless,0.501,6,60,1,1,0.292,0.382,0.375,66
influential,0.501,13,121,1,1,0.899,0.688,0.944,134
patriotism,0.501,6,60,1,1,0.708,0.635,0.848,66
mow,0.501,6,60,1,1,0.42,0.559,0.393,66
affliction,0.5,17,156,1,1,0.294,0.635,0.392,173
daytime,0.499,21,191,1,1,0.75,0.324,0.454,212
inconvenient,0.499,10,95,1,1,0.224,0.61,0.375,105
excellence,0.499,21,191,1,1,0.958,0.62,0.907,212
bid,0.499,25,226,1,1,0.76,0.53,0.655,251
washing,0.499,44,392,1,1,0.643,0.396,0.402,436
volume,0.499,63,558,1,1,0.552,0.49,0.546,621
mango,0.498,18,165,1,1,0.765,0.327,0.29,183
resolution,0.497,42,375,1,1,0.78,0.55,0.745,417
gardener,0.497,7,69,1,1,0.673,0.346,0.361,76
incognito,0.497,3,34,1,1,0.61,0.49,0.446,37
disjointed,0.497,3,34,1,1,0.323,0.518,0.365,37
wry,0.497,3,34,1,1,0.219,0.548,0.528,37
domination,0.497,11,104,1,1,0.505,0.786,0.959,115
manger,0.497,3,34,1,1,0.656,0.276,0.398,37
arcane,0.497,3,34,1,1,0.5,0.49,0.637,37
receiver,0.497,3,34,1,1,0.583,0.464,0.586,37
forensic,0.497,3,34,1,1,0.439,0.627,0.436,37
rebuttal,0.497,3,34,1,1,0.312,0.69,0.54,37
initiated,0.497,7,69,1,1,0.76,0.49,0.65,76
accomplishment,0.497,23,209,1,1,0.917,0.694,0.888,232
bis,0.497,3,34,1,1,0.44,0.42,0.345,37
crater,0.497,3,34,1,1,0.45,0.647,0.529,37
plaid,0.497,3,34,1,1,0.48,0.33,0.417,37
hypnotic,0.497,3,34,1,1,0.571,0.56,0.569,37
glorify,0.497,11,104,1,1,0.94,0.591,0.661,115
sash,0.497,3,34,1,1,0.48,0.298,0.333,37
revert,0.497,15,139,1,1,0.38,0.451,0.519,154
rodent,0.497,3,34,1,1,0.323,0.577,0.279,37
cutter,0.497,3,34,1,1,0.427,0.731,0.583,37
cancellation,0.497,3,34,1,1,0.224,0.431,0.389,37
descendant,0.497,3,34,1,1,0.684,0.42,0.625,37
agreement,0.497,27,244,1,1,0.76,0.44,0.736,271
ninety,0.497,3,34,1,1,0.479,0.349,0.436,37
glossy,0.497,3,34,1,1,0.802,0.519,0.807,37
undivided,0.497,15,139,1,1,0.51,0.38,0.49,154
countenance,0.497,3,34,1,1,0.635,0.44,0.69,37
disintegration,0.497,3,34,1,1,0.094,0.551,0.381,37
trek,0.496,32,288,1,1,0.469,0.53,0.535,320
insist,0.496,32,288,1,1,0.635,0.651,0.688,320
striking,0.496,28,253,1,1,0.357,0.827,0.657,281
carnival,0.495,16,148,1,1,0.927,0.888,0.555,164
phrase,0.495,63,560,1,1,0.63,0.264,0.314,623
shed,0.494,130,1148,1,1,0.427,0.402,0.47,1278
punished,0.494,26,236,1,1,0.177,0.735,0.481,262
headset,0.494,8,78,1,1,0.602,0.34,0.302,86
recommendation,0.493,22,201,1,1,0.912,0.388,0.664,223
continent,0.492,18,166,1,1,0.551,0.373,0.833,184
bow,0.492,56,500,1,1,0.53,0.306,0.408,556
union,0.492,71,632,1,1,0.854,0.226,0.766,703
plight,0.492,23,210,1,1,0.45,0.52,0.547,233
jean,0.492,47,421,1,1,0.602,0.444,0.364,468
fuel,0.492,57,509,1,1,0.445,0.528,0.644,566
diver,0.491,4,43,1,1,0.594,0.52,0.564,47
deter,0.491,4,43,1,1,0.344,0.537,0.567,47
crafty,0.491,4,43,1,1,0.589,0.679,0.783,47
gooood,0.491,4,43,1,1,0.857,0.652,0.547,47
template,0.491,4,43,1,1,0.479,0.311,0.411,47
languishing,0.491,4,43,1,1,0.308,0.459,0.353,47
ghostly,0.491,14,131,1,1,0.26,0.764,0.43,145
simpleton,0.491,4,43,1,1,0.429,0.144,0.358,47
curtain,0.491,19,175,1,1,0.698,0.278,0.304,194
femininity,0.491,4,43,1,1,0.75,0.479,0.451,47
blight,0.491,4,43,1,1,0.271,0.771,0.429,47
chum,0.491,4,43,1,1,0.911,0.347,0.518,47
incidentally,0.491,4,43,1,1,0.479,0.5,0.5,47
displacement,0.491,4,43,1,1,0.276,0.531,0.481,47
lone,0.49,252,2228,1,1,0.198,0.204,0.367,2480
flock,0.49,31,281,1,1,0.5,0.546,0.543,312
ally,0.489,48,431,1,1,0.792,0.32,0.688,479
upward,0.489,10,96,1,1,0.792,0.481,0.62,106
tie,0.488,63,564,1,1,0.663,0.464,0.431,627
cultural,0.488,63,564,1,1,0.802,0.39,0.623,627
begin,0.488,315,2789,1,1,0.677,0.569,0.763,3104
view,0.488,469,4149,1,1,0.896,0.292,0.555,4618
libido,0.487,5,52,1,1,0.77,0.602,0.571,57
ulterior,0.487,5,52,1,1,0.375,0.509,0.49,57
sitcom,0.487,5,52,1,1,0.562,0.537,0.407,57
lamenting,0.487,11,105,1,1,0.156,0.39,0.254,116
freight,0.487,5,52,1,1,0.411,0.528,0.49,57
upgrade,0.487,23,211,1,1,0.786,0.5,0.67,234
manifested,0.487,11,105,1,1,0.58,0.618,0.667,116
calf,0.487,5,52,1,1,0.531,0.366,0.336,57
hairstyle,0.487,5,52,1,1,0.771,0.38,0.433,57
firmly,0.486,24,220,1,1,0.786,0.51,0.777,244
method,0.486,37,335,1,1,0.64,0.275,0.698,372
gothic,0.486,18,167,1,1,0.197,0.333,0.475,185
washed,0.486,75,671,1,1,0.542,0.314,0.392,746
conceal,0.486,12,114,1,1,0.312,0.436,0.306,126
gore,0.485,19,176,1,1,0.26,0.608,0.518,195
eclipse,0.485,19,176,1,1,0.541,0.469,0.616,195
camp,0.485,121,1079,1,1,0.622,0.617,0.594,1200
distracting,0.485,33,300,1,1,0.445,0.583,0.4,333
explanation,0.485,69,619,1,1,0.615,0.61,0.825,688
incoherent,0.485,6,61,1,1,0.122,0.612,0.25,67
twelve,0.485,27,247,1,1,0.49,0.298,0.412,274
promiscuity,0.485,6,61,1,1,0.219,0.96,0.396,67
stutter,0.485,6,61,1,1,0.25,0.469,0.258,67
mould,0.485,6,61,1,1,0.357,0.176,0.246,67
changer,0.485,6,61,1,1,0.583,0.519,0.567,67
aware,0.484,316,2807,1,1,0.656,0.34,0.77,3123
precious,0.484,315,2799,1,1,0.917,0.5,0.726,3114
previously,0.484,35,318,1,1,0.594,0.337,0.623,353
symphony,0.484,21,194,1,1,0.765,0.49,0.6,215
battled,0.483,14,132,1,1,0.292,0.794,0.575,146
improves,0.483,14,132,1,1,0.929,0.625,0.727,146
tea,0.483,475,4220,1,1,0.698,0.163,0.37,4695
induced,0.483,22,203,1,1,0.397,0.471,0.491,225
conditions,0.483,100,895,1,1,0.551,0.441,0.593,995
threat,0.483,78,700,1,1,0.135,0.865,0.667,778
grueling,0.483,7,70,1,1,0.18,0.763,0.704,77
exit,0.483,47,425,1,1,0.37,0.353,0.399,472
sept,0.482,24,221,1,1,0.521,0.333,0.361,245
earrings,0.481,8,79,1,1,0.676,0.346,0.517,87
dismissive,0.481,8,79,1,1,0.188,0.541,0.43,87
tremendously,0.481,17,159,1,1,0.719,0.722,0.661,176
contain,0.481,45,408,1,1,0.542,0.49,0.658,453
outstanding,0.48,28,257,1,1,0.898,0.76,0.896,285
edge,0.48,183,1636,1,1,0.439,0.47,0.468,1819
description,0.479,61,551,1,1,0.582,0.425,0.596,612
buried,0.479,107,961,1,1,0.133,0.53,0.37,1068
quench,0.479,10,97,1,1,0.385,0.344,0.333,107
outdated,0.478,11,106,1,1,0.167,0.236,0.226,117
weekday,0.478,11,106,1,1,0.49,0.469,0.52,117
isolate,0.478,256,2291,1,1,0.235,0.422,0.336,2547
unspeakable,0.477,12,115,1,1,0.327,0.567,0.393,127
applause,0.477,13,124,1,1,0.953,0.857,0.621,137
clothing,0.477,41,374,1,1,0.75,0.343,0.407,415
exclusion,0.476,29,267,1,1,0.24,0.53,0.389,296
travel,0.476,508,4548,1,1,0.931,0.689,0.535,5056
pinnacle,0.476,15,142,1,1,0.633,0.39,0.508,157
invest,0.475,81,732,1,1,0.65,0.663,0.682,813
butterfly,0.475,82,741,1,1,0.892,0.327,0.314,823
dip,0.474,43,393,1,1,0.516,0.583,0.397,436
jaw,0.473,22,205,1,1,0.5,0.51,0.42,227
custom,0.473,23,214,1,1,0.552,0.382,0.688,237
scientific,0.473,27,250,1,1,0.653,0.51,0.836,277
closure,0.472,31,286,1,1,0.229,0.22,0.412,317
toilet,0.471,92,834,1,1,0.49,0.29,0.233,926
prison,0.471,375,3375,1,1,0.112,0.677,0.491,3750
engage,0.471,148,1337,1,1,0.771,0.796,0.713,1485
heavens,0.471,50,457,1,1,0.806,0.273,0.683,507
grateful,0.47,587,5282,1,1,0.958,0.353,0.56,5869
index,0.469,11,107,1,1,0.448,0.268,0.342,118
valiant,0.469,3,35,1,1,0.88,0.745,0.904,38
indicator,0.469,12,116,1,1,0.573,0.451,0.67,128
suspend,0.469,3,35,1,1,0.24,0.32,0.368,38
redundant,0.469,10,98,1,1,0.21,0.5,0.527,108
ripe,0.469,11,107,1,1,0.671,0.337,0.67,118
withhold,0.469,2,26,1,1,0.32,0.451,0.444,28
explosion,0.469,11,107,1,1,0.167,0.96,0.767,118
swelling,0.469,3,35,1,1,0.323,0.608,0.25,38
burglar,0.469,3,35,1,1,0.05,0.769,0.404,38
bolster,0.469,6,62,1,1,0.708,0.471,0.569,68
layover,0.469,2,26,1,1,0.52,0.355,0.5,28
innumerable,0.469,8,80,1,1,0.667,0.445,0.704,88
algebra,0.469,3,35,1,1,0.44,0.34,0.565,38
mitten,0.469,2,26,1,1,0.531,0.33,0.408,28
snappy,0.469,2,26,1,1,0.573,0.592,0.418,28
dame,0.469,19,179,1,1,0.694,0.48,0.5,198
pave,0.469,5,53,1,1,0.594,0.49,0.509,58
pundit,0.469,2,26,1,1,0.644,0.582,0.833,28
spar,0.469,2,26,1,1,0.417,0.438,0.536,28
intergalactic,0.469,3,35,1,1,0.562,0.661,0.741,38
tote,0.469,3,35,1,1,0.51,0.398,0.625,38
consist,0.469,22,206,1,1,0.823,0.386,0.58,228
rural,0.469,90,818,1,1,0.562,0.245,0.408,908
grime,0.469,3,35,1,1,0.198,0.5,0.225,38
missionary,0.469,6,62,1,1,0.729,0.404,0.596,68
fawn,0.469,4,44,1,1,0.626,0.36,0.284,48
whirlpool,0.469,2,26,1,1,0.71,0.415,0.442,28
pinot,0.469,2,26,1,1,0.365,0.37,0.361,28
suggestive,0.469,3,35,1,1,0.552,0.5,0.555,38
excrement,0.469,2,26,1,1,0.041,0.558,0.221,28
expedition,0.469,6,62,1,1,0.735,0.802,0.62,68
bodega,0.469,2,26,1,1,0.573,0.307,0.398,28
felicity,0.469,7,71,1,1,0.913,0.704,0.793,78
bonsai,0.469,3,35,1,1,0.714,0.235,0.375,38
cache,0.469,3,35,1,1,0.552,0.348,0.389,38
designer,0.469,25,233,1,1,0.875,0.519,0.67,258
lieutenant,0.469,3,35,1,1,0.594,0.612,0.92,38
barbed,0.469,3,35,1,1,0.177,0.594,0.455,38
comprehend,0.469,47,431,1,1,0.875,0.365,0.689,478
leprosy,0.469,6,62,1,1,0.13,0.67,0.349,68
gloat,0.469,3,35,1,1,0.5,0.637,0.603,38
banshee,0.469,3,35,1,1,0.408,0.565,0.481,38
commonly,0.469,12,116,1,1,0.604,0.17,0.574,128
canterbury,0.469,2,26,1,1,0.582,0.438,0.51,28
midsummer,0.469,4,44,1,1,0.781,0.48,0.492,48
defended,0.469,9,89,1,1,0.663,0.451,0.582,98
excessive,0.469,36,332,1,1,0.417,0.731,0.601,368
thirds,0.469,3,35,1,1,0.402,0.327,0.345,38
oak,0.469,32,296,1,1,0.583,0.245,0.536,328
tombstone,0.469,6,62,1,1,0.204,0.441,0.311,68
passivity,0.469,2,26,1,1,0.241,0.115,0.246,28
disastrous,0.469,9,89,1,1,0.071,0.741,0.439,98
astute,0.469,2,26,1,1,0.776,0.658,0.827,28
mascara,0.469,4,44,1,1,0.575,0.45,0.269,48
rounded,0.469,6,62,1,1,0.592,0.391,0.396,68
disloyalty,0.469,3,35,1,1,0.187,0.716,0.267,38
wedge,0.469,5,53,1,1,0.49,0.29,0.278,58
excitable,0.469,2,26,1,1,0.803,0.939,0.629,28
carnage,0.469,2,26,1,1,0.406,0.6,0.558,28
disinformation,0.469,2,26,1,1,0.23,0.577,0.26,28
duress,0.469,2,26,1,1,0.302,0.569,0.612,28
portal,0.469,19,179,1,1,0.583,0.347,0.547,198
palatable,0.469,3,35,1,1,0.823,0.5,0.594,38
tutoring,0.469,3,35,1,1,0.663,0.402,0.702,38
loath,0.469,3,35,1,1,0.135,0.714,0.445,38
adultery,0.469,4,44,1,1,0.12,0.922,0.51,48
creamy,0.469,4,44,1,1,0.823,0.337,0.345,48
doorbell,0.469,5,53,1,1,0.564,0.5,0.307,58
abomination,0.469,7,71,1,1,0.078,0.755,0.518,78
ska,0.469,3,35,1,1,0.458,0.575,0.245,38
turf,0.469,7,71,1,1,0.531,0.192,0.295,78
albatross,0.469,3,35,1,1,0.5,0.445,0.527,38
ashtray,0.469,2,26,1,1,0.406,0.382,0.265,28
character,0.467,674,6083,1,1,0.667,0.373,0.686,6757
bittersweet,0.467,63,576,1,1,0.469,0.569,0.474,639
pearl,0.465,33,306,1,1,0.905,0.425,0.642,339
bike,0.465,83,758,1,1,0.708,0.5,0.333,841
information,0.464,150,1364,1,1,0.765,0.37,0.711,1514
collection,0.464,122,1111,1,1,0.725,0.311,0.588,1233
fears,0.464,259,2350,1,1,0.061,0.821,0.306,2609
tongue,0.464,87,795,1,1,0.542,0.432,0.482,882
hesitation,0.463,20,189,1,1,0.286,0.396,0.217,209
pitch,0.463,61,560,1,1,0.521,0.431,0.465,621
functional,0.463,19,180,1,1,0.75,0.5,0.72,199
lottery,0.463,19,180,1,1,0.771,0.731,0.491,199
tournament,0.463,18,171,1,1,0.694,0.74,0.611,189
begun,0.463,55,506,1,1,0.677,0.5,0.404,561
spot,0.463,334,3032,1,1,0.51,0.18,0.336,3366
minimum,0.462,53,488,1,1,0.38,0.198,0.194,541
finished,0.462,404,3667,1,1,0.51,0.387,0.57,4071
innovative,0.462,16,153,1,1,0.88,0.64,0.83,169
rarely,0.462,234,2128,1,1,0.408,0.367,0.366,2362
territory,0.461,28,262,1,1,0.625,0.469,0.676,290
faraway,0.461,13,126,1,1,0.365,0.356,0.285,139
lesson,0.461,165,1505,1,1,0.704,0.577,0.593,1670
building,0.46,327,2976,1,1,0.705,0.288,0.673,3303
menu,0.46,25,235,1,1,0.633,0.333,0.385,260
image,0.46,228,2078,1,1,0.653,0.241,0.453,2306
essay,0.459,84,771,1,1,0.559,0.411,0.53,855
extent,0.459,83,762,1,1,0.646,0.451,0.602,845
remove,0.459,118,1080,1,1,0.292,0.539,0.472,1198
nighttime,0.459,45,417,1,1,0.735,0.385,0.439,462
scholarship,0.458,10,99,1,1,0.866,0.49,0.625,109
precise,0.458,10,99,1,1,0.833,0.358,0.769,109
borrow,0.458,43,399,1,1,0.398,0.573,0.282,442
intelligence,0.458,85,781,1,1,0.833,0.587,0.885,866
mystery,0.458,117,1072,1,1,0.417,0.667,0.519,1189
radical,0.458,40,372,1,1,0.5,0.792,0.811,412
great,0.458,4131,37593,1,1,0.958,0.665,0.81,41724
fangs,0.457,9,90,1,1,0.286,0.598,0.434,99
boast,0.457,9,90,1,1,0.52,0.586,0.569,99
hale,0.457,9,90,1,1,0.479,0.435,0.5,99
curtains,0.457,29,272,1,1,0.615,0.123,0.342,301
golfing,0.457,9,90,1,1,0.625,0.427,0.455,99
lounge,0.457,28,263,1,1,0.592,0.245,0.466,291
approval,0.456,54,500,1,1,0.854,0.46,0.889,554
rooted,0.456,35,327,1,1,0.51,0.527,0.718,362
characteristic,0.456,8,81,1,1,0.583,0.328,0.538,89
panel,0.456,51,473,1,1,0.469,0.321,0.425,524
genesis,0.456,33,309,1,1,0.612,0.429,0.658,342
oxygen,0.456,33,309,1,1,0.908,0.31,0.575,342
conclude,0.456,16,154,1,1,0.53,0.267,0.679,170
alongside,0.455,57,528,1,1,0.458,0.333,0.347,585
dignity,0.455,64,592,1,1,0.844,0.391,0.873,656
nudge,0.455,7,72,1,1,0.448,0.5,0.509,79
behavioral,0.455,7,72,1,1,0.612,0.44,0.708,79
striped,0.455,7,72,1,1,0.344,0.373,0.385,79
shaving,0.455,7,72,1,1,0.5,0.469,0.353,79
engine,0.454,22,209,1,1,0.615,0.644,0.676,231
suspicion,0.454,14,136,1,1,0.204,0.711,0.377,150
disbelief,0.454,14,136,1,1,0.188,0.409,0.373,150
oatmeal,0.453,6,63,1,1,0.592,0.192,0.241,69
aspiring,0.453,13,127,1,1,0.844,0.582,0.604,140
natal,0.453,6,63,1,1,0.755,0.462,0.481,69
hypocrisy,0.453,27,255,1,1,0.156,0.523,0.37,282
versatile,0.453,6,63,1,1,0.906,0.625,0.714,69
autobiography,0.453,20,191,1,1,0.735,0.284,0.629,211
rotting,0.453,27,255,1,1,0.188,0.462,0.255,282
induce,0.453,6,63,1,1,0.257,0.606,0.684,69
beginning,0.452,368,3375,1,1,0.816,0.528,0.558,3743
herb,0.452,19,182,1,1,0.643,0.418,0.353,201
femme,0.452,12,118,1,1,0.551,0.529,0.398,130
consideration,0.451,30,283,1,1,0.589,0.38,0.687,313
village,0.45,120,1108,1,1,0.684,0.367,0.336,1228
nihilism,0.45,11,109,1,1,0.367,0.51,0.364,120
tray,0.45,11,109,1,1,0.549,0.25,0.345,120
ingrained,0.45,5,54,1,1,0.531,0.49,0.712,59
grapefruit,0.45,5,54,1,1,0.521,0.281,0.282,59
grain,0.45,17,164,1,1,0.39,0.198,0.302,181
barbaric,0.45,5,54,1,1,0.235,0.798,0.738,59
snacks,0.45,83,769,1,1,0.781,0.48,0.306,852
disoriented,0.45,5,54,1,1,0.227,0.643,0.227,59
history,0.45,355,3263,1,1,0.729,0.382,0.754,3618
sweet,0.449,1066,9787,1,1,0.668,0.418,0.382,10853
tormented,0.449,22,210,1,1,0.071,0.855,0.323,232
unbearable,0.449,125,1155,1,1,0.125,0.798,0.447,1280
spite,0.449,61,568,1,1,0.08,0.6,0.317,629
opening,0.449,229,2110,1,1,0.667,0.51,0.62,2339
infinitely,0.449,27,256,1,1,0.688,0.643,0.829,283
gaining,0.449,55,513,1,1,0.837,0.618,0.883,568
garden,0.449,312,2872,1,1,0.77,0.23,0.456,3184
penthouse,0.449,10,100,1,1,0.592,0.43,0.395,110
redeem,0.449,10,100,1,1,0.633,0.469,0.491,110
sisterhood,0.449,10,100,1,1,0.837,0.415,0.696,110
opinion,0.448,387,3563,1,1,0.594,0.482,0.638,3950
farewell,0.447,51,477,1,1,0.13,0.5,0.591,528
elder,0.447,40,376,1,1,0.448,0.153,0.462,416
studio,0.447,165,1526,1,1,0.677,0.265,0.62,1691
minuscule,0.447,4,45,1,1,0.396,0.286,0.214,49
kneeling,0.447,4,45,1,1,0.245,0.435,0.144,49
idiocy,0.447,9,91,1,1,0.112,0.635,0.137,100
telescope,0.447,4,45,1,1,0.531,0.34,0.5,49
tine,0.447,4,45,1,1,0.438,0.373,0.284,49
reciprocal,0.447,4,45,1,1,0.677,0.52,0.66,49
sparse,0.447,9,91,1,1,0.24,0.367,0.209,100
sixty,0.447,9,91,1,1,0.694,0.24,0.433,100
celebratory,0.447,4,45,1,1,0.857,0.653,0.845,49
recap,0.447,9,91,1,1,0.602,0.578,0.667,100
radar,0.446,23,220,1,1,0.521,0.615,0.579,243
interpret,0.445,18,174,1,1,0.646,0.625,0.673,192
mass,0.445,121,1123,1,1,0.458,0.245,0.277,1244
humbled,0.445,13,128,1,1,0.28,0.618,0.198,141
academy,0.445,36,340,1,1,0.704,0.473,0.792,376
provide,0.444,238,2203,1,1,0.833,0.517,0.704,2441
rags,0.444,8,82,1,1,0.434,0.309,0.198,90
dictionary,0.444,17,165,1,1,0.62,0.25,0.598,182
sneer,0.444,8,82,1,1,0.133,0.755,0.345,90
geography,0.444,8,82,1,1,0.719,0.15,0.553,90
camaraderie,0.444,17,165,1,1,0.833,0.51,0.648,182
birch,0.444,8,82,1,1,0.562,0.346,0.382,90
lead,0.444,716,6612,1,1,0.323,0.657,0.455,7328
attempt,0.444,195,1807,1,1,0.625,0.491,0.431,2002
beautiful,0.444,2526,23314,1,1,0.875,0.614,0.648,25840
tribe,0.444,118,1097,1,1,0.664,0.486,0.516,1215
translate,0.443,34,322,1,1,0.604,0.423,0.462,356
memorial,0.443,25,239,1,1,0.602,0.304,0.6,264
hazy,0.443,12,119,1,1,0.45,0.433,0.23,131
easy,0.443,1140,10532,1,1,0.865,0.194,0.373,11672
maker,0.442,45,424,1,1,0.698,0.544,0.706,469
pod,0.442,24,230,1,1,0.48,0.396,0.339,254
replica,0.441,3,36,1,1,0.48,0.52,0.493,39
probation,0.441,3,36,1,1,0.206,0.635,0.44,39
pavilion,0.441,3,36,1,1,0.583,0.5,0.77,39
overthrow,0.441,3,36,1,1,0.26,0.868,0.62,39
booming,0.441,7,73,1,1,0.688,0.554,0.661,80
grotesque,0.441,7,73,1,1,0.135,0.788,0.5,80
marker,0.441,7,73,1,1,0.5,0.333,0.605,80
subliminal,0.441,3,36,1,1,0.41,0.528,0.464,39
horned,0.441,3,36,1,1,0.316,0.61,0.375,39
arty,0.441,3,36,1,1,0.49,0.422,0.388,39
concussion,0.441,3,36,1,1,0.072,0.708,0.482,39
synagogue,0.441,3,36,1,1,0.531,0.3,0.544,39
nameless,0.441,11,110,1,1,0.344,0.28,0.164,121
registration,0.441,7,73,1,1,0.622,0.396,0.574,80
bulge,0.441,3,36,1,1,0.26,0.487,0.4,39
bouncer,0.441,3,36,1,1,0.49,0.653,0.655,39
unavailable,0.441,31,295,1,1,0.323,0.281,0.159,326
cynic,0.441,3,36,1,1,0.135,0.632,0.473,39
livestock,0.441,3,36,1,1,0.729,0.42,0.519,39
ewe,0.441,3,36,1,1,0.429,0.216,0.277,39
advisory,0.441,3,36,1,1,0.656,0.429,0.633,39
workout,0.44,61,573,1,1,0.868,0.827,0.78,634
believer,0.44,33,314,1,1,0.725,0.445,0.564,347
colors,0.439,115,1074,1,1,0.875,0.349,0.34,1189
motorcycle,0.439,25,240,1,1,0.677,0.764,0.713,265
rev,0.439,10,101,1,1,0.367,0.422,0.353,111
tin,0.438,28,268,1,1,0.469,0.37,0.217,296
redemption,0.438,42,398,1,1,0.376,0.408,0.545,440
represented,0.438,24,231,1,1,0.724,0.444,0.688,255
praise,0.438,106,992,1,1,0.776,0.387,0.658,1098
comet,0.437,6,64,1,1,0.704,0.679,0.471,70
discontent,0.437,13,129,1,1,0.24,0.53,0.263,142
fruitless,0.437,6,64,1,1,0.26,0.58,0.311,70
lifted,0.437,48,454,1,1,0.714,0.441,0.657,502
wrap,0.437,100,937,1,1,0.594,0.441,0.275,1037
compatible,0.437,23,222,1,1,0.892,0.387,0.638,245
treacherous,0.436,9,92,1,1,0.112,0.815,0.402,101
bedroom,0.435,199,1860,1,1,0.744,0.296,0.491,2059
unwelcome,0.435,12,120,1,1,0.115,0.48,0.269,132
release,0.435,275,2568,1,1,0.74,0.606,0.741,2843
dank,0.434,15,148,1,1,0.39,0.381,0.383,163
tourism,0.434,15,148,1,1,0.823,0.531,0.545,163
coin,0.434,34,325,1,1,0.677,0.574,0.445,359
mercy,0.434,110,1033,1,1,0.719,0.229,0.5,1143
monitor,0.434,18,176,1,1,0.49,0.298,0.538,194
raw,0.434,90,847,1,1,0.143,0.349,0.342,937
bizarre,0.433,55,521,1,1,0.379,0.62,0.392,576
grow,0.433,850,7933,1,1,0.914,0.615,0.755,8783
range,0.433,76,717,1,1,0.49,0.472,0.615,793
starter,0.433,54,512,1,1,0.667,0.461,0.827,566
destined,0.432,147,1380,1,1,0.698,0.462,0.617,1527
gruff,0.432,2,27,1,1,0.323,0.611,0.472,29
heirs,0.432,2,27,1,1,0.796,0.519,0.698,29
roost,0.432,2,27,1,1,0.5,0.41,0.345,29
quantify,0.432,2,27,1,1,0.719,0.459,0.721,29
weathered,0.432,5,55,1,1,0.422,0.491,0.537,60
neurotic,0.432,14,139,1,1,0.198,0.801,0.387,153
compost,0.432,2,27,1,1,0.48,0.404,0.441,29
timetable,0.432,2,27,1,1,0.561,0.189,0.491,29
innuendo,0.432,2,27,1,1,0.467,0.67,0.463,29
athletic,0.432,8,83,1,1,0.857,0.798,0.708,91
clause,0.432,5,55,1,1,0.48,0.409,0.528,60
immobile,0.432,2,27,1,1,0.225,0.217,0.298,29
cholesterol,0.432,5,55,1,1,0.198,0.583,0.398,60
amendment,0.432,11,111,1,1,0.531,0.459,0.606,122
java,0.432,5,55,1,1,0.459,0.321,0.343,60
argumentative,0.432,2,27,1,1,0.45,0.531,0.679,29
abhorrent,0.432,5,55,1,1,0.229,0.75,0.474,60
semantics,0.432,2,27,1,1,0.698,0.394,0.569,29
mortar,0.432,2,27,1,1,0.333,0.627,0.562,29
biker,0.432,5,55,1,1,0.604,0.71,0.567,60
terminology,0.432,2,27,1,1,0.612,0.284,0.566,29
hundredth,0.432,2,27,1,1,0.427,0.368,0.466,29
exceptional,0.432,23,223,1,1,0.806,0.74,0.933,246
thundering,0.432,2,27,1,1,0.337,0.778,0.7,29
ado,0.432,2,27,1,1,0.52,0.423,0.385,29
recession,0.432,2,27,1,1,0.368,0.398,0.373,29
prefect,0.432,2,27,1,1,0.698,0.451,0.809,29
variable,0.432,2,27,1,1,0.62,0.407,0.4,29
outage,0.432,2,27,1,1,0.306,0.684,0.438,29
stove,0.432,8,83,1,1,0.466,0.391,0.405,91
garrison,0.432,2,27,1,1,0.51,0.527,0.679,29
blender,0.432,2,27,1,1,0.602,0.534,0.351,29
informal,0.432,5,55,1,1,0.48,0.398,0.441,60
watchman,0.432,2,27,1,1,0.51,0.509,0.833,29
vector,0.432,2,27,1,1,0.538,0.308,0.482,29
disparage,0.432,2,27,1,1,0.092,0.663,0.336,29
emerald,0.432,11,111,1,1,0.74,0.363,0.726,122
cursing,0.432,14,139,1,1,0.112,0.86,0.446,153
facilitate,0.432,8,83,1,1,0.812,0.333,0.509,91
contingent,0.432,2,27,1,1,0.47,0.531,0.659,29
underdog,0.432,5,55,1,1,0.25,0.41,0.226,60
anesthesia,0.432,2,27,1,1,0.365,0.216,0.394,29
unwillingness,0.432,2,27,1,1,0.204,0.311,0.113,29
rooms,0.432,170,1596,1,1,0.677,0.241,0.386,1766
details,0.431,102,961,1,1,0.583,0.367,0.481,1063
assassin,0.431,22,214,1,1,0.073,0.933,0.632,236
mistaken,0.431,42,401,1,1,0.131,0.63,0.212,443
display,0.43,59,560,1,1,0.677,0.325,0.4,619
recognition,0.43,64,607,1,1,0.833,0.587,0.726,671
roman,0.43,27,261,1,1,0.615,0.475,0.639,288
astray,0.43,13,130,1,1,0.098,0.676,0.308,143
ambulance,0.429,10,102,1,1,0.5,0.75,0.609,112
unpleasant,0.429,29,280,1,1,0.122,0.612,0.185,309
investment,0.428,26,252,1,1,0.72,0.592,0.745,278
cerebral,0.428,7,74,1,1,0.408,0.509,0.627,81
antagonist,0.428,7,74,1,1,0.24,0.615,0.7,81
navigate,0.428,31,299,1,1,0.74,0.555,0.675,330
land,0.427,344,3236,1,1,0.582,0.26,0.616,3580
schizophrenic,0.427,12,121,1,1,0.102,0.958,0.433,133
bunk,0.427,12,121,1,1,0.438,0.332,0.339,133
crawl,0.426,123,1163,1,1,0.479,0.519,0.467,1286
complex,0.426,138,1304,1,1,0.388,0.608,0.55,1442
favorite,0.426,1125,10572,1,1,0.885,0.59,0.691,11697
generally,0.426,158,1492,1,1,0.562,0.255,0.473,1650
span,0.426,32,309,1,1,0.521,0.33,0.528,341
keyword,0.425,4,46,1,1,0.602,0.52,0.747,50
moist,0.425,9,93,1,1,0.47,0.316,0.386,102
unified,0.425,4,46,1,1,0.729,0.439,0.764,50
victorious,0.425,9,93,1,1,0.884,0.886,0.946,102
paraphrase,0.425,4,46,1,1,0.5,0.375,0.444,50
hurrah,0.425,4,46,1,1,0.802,0.74,0.5,50
pike,0.425,4,46,1,1,0.427,0.41,0.452,50
destroyer,0.425,9,93,1,1,0.083,0.83,0.543,102
scape,0.425,4,46,1,1,0.29,0.625,0.536,50
tavern,0.425,9,93,1,1,0.516,0.577,0.475,102
plumber,0.425,4,46,1,1,0.327,0.51,0.448,50
buzz,0.425,44,422,1,1,0.333,0.686,0.375,466
congestion,0.425,4,46,1,1,0.271,0.654,0.491,50
fortune,0.425,51,488,1,1,0.926,0.731,0.873,539
unnoticed,0.424,26,253,1,1,0.302,0.44,0.26,279
breath,0.424,379,3574,1,1,0.684,0.392,0.451,3953
compassion,0.424,173,1636,1,1,0.735,0.258,0.509,1809
destroy,0.424,177,1674,1,1,0.046,0.935,0.635,1851
soar,0.424,16,159,1,1,0.79,0.74,0.718,175
attempted,0.424,33,319,1,1,0.594,0.58,0.567,352
clean,0.424,256,2418,1,1,0.827,0.17,0.5,2674
appropriate,0.424,57,545,1,1,0.833,0.368,0.759,602
sip,0.424,57,545,1,1,0.375,0.38,0.213,602
sloppy,0.423,11,112,1,1,0.303,0.441,0.183,123
venomous,0.423,11,112,1,1,0.159,0.841,0.636,123
neutral,0.422,32,310,1,1,0.469,0.184,0.357,342
suit,0.422,93,885,1,1,0.776,0.282,0.482,978
notify,0.422,6,65,1,1,0.643,0.471,0.573,71
sculpture,0.422,6,65,1,1,0.75,0.346,0.49,71
gilded,0.422,6,65,1,1,0.719,0.471,0.455,71
chops,0.422,6,65,1,1,0.612,0.42,0.269,71
grouchy,0.422,6,65,1,1,0.143,0.708,0.407,71
revenue,0.422,6,65,1,1,0.873,0.51,0.854,71
eater,0.422,13,131,1,1,0.459,0.337,0.51,144
liberation,0.422,36,348,1,1,0.745,0.614,0.857,384
murderous,0.421,15,150,1,1,0.017,0.94,0.682,165
roof,0.421,81,773,1,1,0.602,0.226,0.342,854
disagreement,0.42,8,84,1,1,0.104,0.618,0.236,92
proceed,0.42,26,254,1,1,0.729,0.63,0.565,280
bachelorette,0.42,8,84,1,1,0.735,0.78,0.465,92
crumble,0.42,17,169,1,1,0.333,0.48,0.423,186
photo,0.42,383,3627,1,1,0.729,0.327,0.431,4010
boxing,0.419,32,311,1,1,0.427,0.854,0.645,343
exaggerated,0.419,10,103,1,1,0.224,0.885,0.732,113
selective,0.419,43,415,1,1,0.612,0.347,0.706,458
gifted,0.419,60,576,1,1,0.902,0.647,0.868,636
attraction,0.418,53,510,1,1,0.906,0.774,0.712,563
race,0.418,202,1921,1,1,0.592,0.426,0.658,2123
abnormal,0.418,16,160,1,1,0.137,0.604,0.309,176
coma,0.417,18,179,1,1,0.219,0.255,0.302,197
impressed,0.417,41,397,1,1,0.806,0.77,0.429,438
damned,0.417,62,596,1,1,0.1,0.76,0.465,658
typically,0.417,47,454,1,1,0.569,0.377,0.559,501
choose,0.417,956,9071,1,1,0.615,0.542,0.648,10027
raindrops,0.416,26,255,1,1,0.698,0.337,0.311,281
fathom,0.416,30,293,1,1,0.52,0.41,0.523,323
relief,0.416,160,1526,1,1,0.844,0.278,0.481,1686
laundry,0.416,65,625,1,1,0.644,0.292,0.377,690
substance,0.415,52,502,1,1,0.615,0.422,0.528,554
gloomy,0.415,90,863,1,1,0.107,0.41,0.287,953
riots,0.414,3,37,1,1,0.099,0.882,0.564,40
terrific,0.414,21,208,1,1,0.859,0.65,0.821,229
dealings,0.414,3,37,1,1,0.6,0.491,0.48,40
reconstruction,0.414,5,56,1,1,0.625,0.719,0.667,61
glazed,0.414,3,37,1,1,0.622,0.41,0.491,40
pointy,0.414,3,37,1,1,0.469,0.651,0.438,40
bonfire,0.414,9,94,1,1,0.48,0.719,0.473,103
heater,0.414,11,113,1,1,0.5,0.573,0.538,124
citrus,0.414,3,37,1,1,0.469,0.368,0.375,40
honorable,0.414,27,265,1,1,0.963,0.412,0.83,292
shitfaced,0.414,3,37,1,1,0.214,0.695,0.38,40
carousel,0.414,7,75,1,1,0.704,0.5,0.412,82
cheetah,0.414,5,56,1,1,0.469,0.77,0.667,61
tempo,0.414,13,132,1,1,0.582,0.337,0.5,145
motor,0.414,7,75,1,1,0.531,0.551,0.648,82
capitol,0.414,7,75,1,1,0.535,0.375,0.705,82
breeder,0.414,3,37,1,1,0.645,0.481,0.605,40
interstellar,0.414,7,75,1,1,0.708,0.702,0.622,82
distasteful,0.414,3,37,1,1,0.264,0.676,0.222,40
separately,0.414,15,151,1,1,0.31,0.365,0.368,166
protagonist,0.414,31,303,1,1,0.765,0.704,0.877,334
shimmer,0.414,3,37,1,1,0.745,0.562,0.656,40
eighty,0.414,3,37,1,1,0.5,0.3,0.453,40
poser,0.414,3,37,1,1,0.469,0.385,0.316,40
cleric,0.414,3,37,1,1,0.521,0.324,0.589,40
premise,0.414,17,170,1,1,0.531,0.519,0.517,187
diplomacy,0.414,5,56,1,1,0.74,0.396,0.774,61
repugnant,0.414,5,56,1,1,0.061,0.735,0.453,61
deviant,0.414,5,56,1,1,0.094,0.589,0.398,61
halfway,0.413,50,484,1,1,0.51,0.254,0.339,534
noon,0.413,38,370,1,1,0.531,0.343,0.518,408
happiest,0.413,155,1483,1,1,0.99,0.716,0.746,1638
ground,0.413,312,2977,1,1,0.398,0.343,0.602,3289
irritated,0.413,55,532,1,1,0.21,0.816,0.281,587
extreme,0.412,241,2303,1,1,0.318,0.8,0.721,2544
elaborate,0.411,16,161,1,1,0.561,0.367,0.68,177
equipment,0.411,16,161,1,1,0.745,0.495,0.7,177
upcoming,0.41,73,705,1,1,0.688,0.46,0.55,778
masks,0.41,36,352,1,1,0.51,0.472,0.241,388
slayer,0.41,10,104,1,1,0.041,0.93,0.661,114
furious,0.409,19,190,1,1,0.062,0.953,0.598,209
numbness,0.409,28,276,1,1,0.306,0.398,0.265,304
cursed,0.409,82,792,1,1,0.083,0.783,0.393,874
define,0.409,89,859,1,1,0.688,0.415,0.632,948
visibility,0.409,8,85,1,1,0.75,0.444,0.676,93
apathy,0.409,26,257,1,1,0.184,0.212,0.204,283
hilltop,0.409,8,85,1,1,0.688,0.643,0.787,93
large,0.408,250,2398,1,1,0.704,0.565,0.736,2648
association,0.408,31,305,1,1,0.745,0.5,0.817,336
able,0.408,1431,13693,1,1,0.786,0.5,0.81,15124
rise,0.407,220,2114,1,1,0.667,0.593,0.745,2334
blatant,0.407,13,133,1,1,0.327,0.677,0.675,146
pew,0.407,6,66,1,1,0.449,0.235,0.664,72
festival,0.407,74,717,1,1,0.87,0.706,0.714,791
corruption,0.406,35,344,1,1,0.052,0.83,0.549,379
study,0.406,359,3449,1,1,0.653,0.361,0.768,3808
ledge,0.406,11,114,1,1,0.406,0.235,0.339,125
disdain,0.406,11,114,1,1,0.153,0.446,0.441,125
stirring,0.405,16,162,1,1,0.582,0.702,0.558,178
sit,0.405,1429,13713,1,1,0.561,0.23,0.368,15142
forward,0.405,653,6273,1,1,0.873,0.412,0.75,6926
ultimately,0.404,126,1218,1,1,0.385,0.48,0.558,1344
illegitimate,0.404,4,47,1,1,0.184,0.644,0.302,51
prescribed,0.404,9,95,1,1,0.531,0.391,0.463,104
superhuman,0.404,4,47,1,1,0.81,0.745,0.895,51
subscriber,0.404,4,47,1,1,0.562,0.398,0.57,51
herald,0.404,4,47,1,1,0.643,0.382,0.5,51
dictatorship,0.404,4,47,1,1,0.082,0.806,0.784,51
medal,0.404,9,95,1,1,0.854,0.555,0.746,104
inquiry,0.404,9,95,1,1,0.541,0.42,0.536,104
crust,0.404,4,47,1,1,0.542,0.337,0.456,51
wound,0.404,54,527,1,1,0.15,0.717,0.31,581
lager,0.404,4,47,1,1,0.584,0.48,0.353,51
grieved,0.404,4,47,1,1,0.104,0.46,0.191,51
radius,0.404,9,95,1,1,0.521,0.324,0.5,104
relation,0.404,52,508,1,1,0.857,0.604,0.625,560
option,0.404,247,2381,1,1,0.512,0.427,0.359,2628
goddess,0.403,88,854,1,1,0.865,0.56,0.888,942
fulfillment,0.403,50,489,1,1,0.833,0.528,0.683,539
deceased,0.403,17,172,1,1,0.021,0.538,0.188,189
whispered,0.403,43,422,1,1,0.548,0.358,0.309,465
platinum,0.402,12,124,1,1,0.75,0.518,0.702,136
nonchalant,0.402,12,124,1,1,0.312,0.314,0.366,136
alternative,0.402,73,711,1,1,0.628,0.373,0.631,784
lsd,0.401,7,76,1,1,0.375,0.471,0.39,83
simultaneously,0.401,79,769,1,1,0.656,0.49,0.609,848
bookmark,0.401,7,76,1,1,0.543,0.441,0.415,83
necklace,0.401,15,153,1,1,0.76,0.294,0.373,168
sew,0.401,7,76,1,1,0.51,0.34,0.34,83
partly,0.4,40,394,1,1,0.415,0.41,0.396,434
sheer,0.4,62,606,1,1,0.604,0.25,0.481,668
weirdness,0.4,10,105,1,1,0.316,0.491,0.364,115
analogy,0.4,10,105,1,1,0.51,0.367,0.509,115
reproduce,0.4,10,105,1,1,0.823,0.622,0.76,115
flavor,0.4,27,269,1,1,0.885,0.479,0.392,296
savior,0.4,55,539,1,1,0.92,0.469,0.804,594
harbor,0.399,16,163,1,1,0.594,0.356,0.634,179
foe,0.399,16,163,1,1,0.071,0.827,0.459,179
crash,0.399,70,684,1,1,0.194,0.906,0.355,754
futile,0.399,22,221,1,1,0.122,0.332,0.158,243
occupation,0.399,22,221,1,1,0.562,0.47,0.692,243
memorable,0.398,31,308,1,1,0.939,0.51,0.769,339
energetic,0.398,31,308,1,1,0.847,0.868,0.902,339
epic,0.398,105,1023,1,1,0.857,0.713,0.83,1128
schedule,0.397,168,1632,1,1,0.51,0.38,0.48,1800
govern,0.397,5,57,1,1,0.573,0.702,0.98,62
import,0.397,5,57,1,1,0.615,0.48,0.623,62
offload,0.397,2,28,1,1,0.479,0.444,0.525,30
hybrid,0.397,20,202,1,1,0.5,0.365,0.57,222
throttle,0.397,2,28,1,1,0.562,0.804,0.75,30
wintery,0.397,2,28,1,1,0.388,0.512,0.463,30
earpiece,0.397,2,28,1,1,0.583,0.286,0.452,30
fierce,0.397,32,318,1,1,0.281,0.877,0.759,350
roughly,0.397,17,173,1,1,0.448,0.539,0.463,190
respectful,0.397,29,289,1,1,0.951,0.386,0.814,318
hospitable,0.397,2,28,1,1,0.791,0.47,0.661,30
sled,0.397,2,28,1,1,0.635,0.547,0.446,30
wickedness,0.397,5,57,1,1,0.031,0.727,0.443,62
veto,0.397,2,28,1,1,0.271,0.462,0.509,30
jerky,0.397,2,28,1,1,0.233,0.538,0.358,30
strand,0.397,11,115,1,1,0.396,0.406,0.538,126
smitten,0.397,5,57,1,1,0.153,0.76,0.204,62
erratic,0.397,5,57,1,1,0.271,0.503,0.217,62
clientele,0.397,2,28,1,1,0.625,0.577,0.508,30
eulogy,0.397,2,28,1,1,0.625,0.443,0.667,30
chalk,0.397,8,86,1,1,0.385,0.185,0.121,94
colorless,0.397,5,57,1,1,0.354,0.34,0.25,62
fin,0.397,17,173,1,1,0.333,0.34,0.377,190
salve,0.397,5,57,1,1,0.612,0.39,0.5,62
pharmacist,0.397,2,28,1,1,0.592,0.382,0.648,30
squall,0.397,2,28,1,1,0.191,0.833,0.655,30
castle,0.397,161,1565,1,1,0.68,0.396,0.718,1726
decaying,0.397,8,86,1,1,0.073,0.51,0.214,94
anus,0.397,5,57,1,1,0.347,0.644,0.35,62
atrocity,0.397,2,28,1,1,0.115,0.844,0.593,30
inquiring,0.397,2,28,1,1,0.479,0.51,0.5,30
ferment,0.397,2,28,1,1,0.375,0.531,0.418,30
surround,0.397,175,1701,1,1,0.542,0.623,0.627,1876
fifty,0.396,24,241,1,1,0.571,0.368,0.439,265
audio,0.396,43,425,1,1,0.709,0.425,0.37,468
simple,0.395,500,4851,1,1,0.653,0.13,0.314,5351
reverse,0.395,34,338,1,1,0.539,0.415,0.461,372
stiff,0.395,15,154,1,1,0.158,0.459,0.569,169
leak,0.395,15,154,1,1,0.378,0.833,0.52,169
comparison,0.395,44,435,1,1,0.583,0.456,0.492,479
uneasy,0.395,28,280,1,1,0.115,0.598,0.349,308
generate,0.394,12,125,1,1,0.771,0.423,0.772,137
stake,0.394,12,125,1,1,0.406,0.608,0.46,137
closed,0.394,241,2346,1,1,0.24,0.164,0.318,2587
tread,0.394,19,193,1,1,0.51,0.52,0.426,212
continued,0.394,86,843,1,1,0.635,0.44,0.5,929
hiding,0.393,308,2997,1,1,0.25,0.567,0.364,3305
spin,0.393,60,591,1,1,0.551,0.422,0.345,651
advent,0.393,16,164,1,1,0.665,0.56,0.627,180
transportation,0.393,16,164,1,1,0.667,0.56,0.472,180
satisfied,0.393,112,1096,1,1,0.959,0.51,0.685,1208
intended,0.393,54,533,1,1,0.406,0.542,0.587,587
voiceless,0.392,6,67,1,1,0.271,0.235,0.131,73
victoria,0.392,34,339,1,1,0.896,0.811,0.837,373
rapid,0.392,13,135,1,1,0.667,0.788,0.768,148
founding,0.392,6,67,1,1,0.698,0.404,0.898,73
fraudulent,0.392,6,67,1,1,0.15,0.774,0.417,73
procrastinate,0.392,6,67,1,1,0.276,0.353,0.315,73
hellhole,0.392,6,67,1,1,0.2,0.615,0.421,73
experiment,0.392,38,378,1,1,0.479,0.72,0.675,416
burning,0.392,170,1661,1,1,0.229,0.76,0.412,1831
partnership,0.391,35,349,1,1,0.786,0.387,0.545,384
convenience,0.391,35,349,1,1,0.781,0.448,0.613,384
sprinkle,0.391,10,106,1,1,0.635,0.404,0.38,116
annual,0.391,43,427,1,1,0.552,0.236,0.5,470
enduring,0.391,32,320,1,1,0.633,0.459,0.768,352
knuckles,0.391,10,106,1,1,0.271,0.461,0.32,116
granted,0.391,142,1390,1,1,0.882,0.348,0.779,1532
shiver,0.39,14,145,1,1,0.26,0.765,0.236,159
tremendous,0.39,29,291,1,1,0.6,0.888,0.773,320
ice,0.389,385,3759,1,1,0.44,0.265,0.219,4144
selfishness,0.389,50,496,1,1,0.2,0.686,0.453,546
fashion,0.389,66,652,1,1,0.827,0.616,0.589,718
entity,0.389,23,233,1,1,0.542,0.402,0.67,256
viola,0.389,3,38,1,1,0.521,0.461,0.481,41
intolerance,0.389,7,77,1,1,0.052,0.704,0.52,84
instructor,0.389,7,77,1,1,0.771,0.49,0.782,84
rouge,0.389,7,77,1,1,0.562,0.4,0.382,84
charming,0.389,51,506,1,1,0.917,0.66,0.764,557
cattle,0.389,11,116,1,1,0.622,0.34,0.445,127
iceberg,0.389,7,77,1,1,0.344,0.54,0.648,84
dibs,0.389,3,38,1,1,0.51,0.41,0.391,41
heroic,0.389,15,155,1,1,0.89,0.77,0.912,170
voucher,0.389,3,38,1,1,0.622,0.416,0.601,41
disordered,0.389,3,38,1,1,0.21,0.714,0.288,41
cavity,0.389,3,38,1,1,0.466,0.385,0.379,41
smartass,0.389,3,38,1,1,0.364,0.52,0.62,41
deathly,0.387,20,204,1,1,0.073,0.771,0.682,224
bent,0.387,29,292,1,1,0.375,0.453,0.298,321
leap,0.387,25,253,1,1,0.75,0.663,0.667,278
traffic,0.386,86,849,1,1,0.323,0.559,0.518,935
tinge,0.386,8,87,1,1,0.469,0.292,0.264,95
tilt,0.386,8,87,1,1,0.365,0.549,0.463,95
bolt,0.386,8,87,1,1,0.354,0.363,0.426,95
whatsoever,0.385,64,635,1,1,0.4,0.314,0.302,699
deceive,0.385,13,136,1,1,0.094,0.775,0.414,149
words,0.384,1458,14284,1,1,0.71,0.216,0.473,15742
impulse,0.384,28,283,1,1,0.53,0.84,0.611,311
forsaken,0.384,33,332,1,1,0.05,0.49,0.192,365
believed,0.384,106,1047,1,1,0.5,0.562,0.547,1153
spring,0.383,283,2782,1,1,0.837,0.37,0.481,3065
driveway,0.383,14,146,1,1,0.612,0.392,0.689,160
shaky,0.383,9,97,1,1,0.26,0.734,0.223,106
regress,0.383,4,48,1,1,0.255,0.442,0.3,52
helm,0.383,4,48,1,1,0.511,0.45,0.615,52
untrustworthy,0.383,4,48,1,1,0.097,0.449,0.287,52
weariness,0.383,9,97,1,1,0.104,0.333,0.226,106
upright,0.383,9,97,1,1,0.667,0.373,0.6,106
price,0.383,259,2547,1,1,0.479,0.475,0.535,2806
remake,0.383,24,244,1,1,0.583,0.488,0.642,268
tactical,0.383,4,48,1,1,0.594,0.481,0.684,52
church,0.383,349,3429,1,1,0.708,0.198,0.61,3778
suppression,0.383,4,48,1,1,0.267,0.541,0.537,52
volcano,0.383,14,146,1,1,0.24,0.844,0.787,160
bleak,0.383,65,646,1,1,0.204,0.427,0.272,711
electricity,0.383,30,303,1,1,0.698,0.81,0.733,333
horrors,0.382,20,205,1,1,0.061,0.852,0.409,225
legendary,0.382,36,362,1,1,0.857,0.537,0.863,398
standing,0.382,451,4434,1,1,0.604,0.317,0.425,4885
ocean,0.382,395,3885,1,1,0.823,0.308,0.642,4280
sight,0.382,204,2011,1,1,0.684,0.25,0.528,2215
ere,0.382,10,107,1,1,0.479,0.312,0.377,117
splitting,0.382,10,107,1,1,0.188,0.598,0.375,117
forgiven,0.382,21,215,1,1,0.75,0.302,0.51,236
lynch,0.382,10,107,1,1,0.167,0.885,0.482,117
plan,0.381,436,4292,1,1,0.646,0.54,0.733,4728
researcher,0.38,11,117,1,1,0.569,0.51,0.857,128
savvy,0.38,5,58,1,1,0.719,0.52,0.706,63
wishful,0.38,11,117,1,1,0.885,0.712,0.606,128
carried,0.38,71,707,1,1,0.49,0.382,0.534,778
stamina,0.38,5,58,1,1,0.664,0.694,0.877,63
gibberish,0.38,5,58,1,1,0.375,0.51,0.36,63
admire,0.379,86,855,1,1,0.867,0.692,0.704,941
seal,0.379,24,245,1,1,0.49,0.218,0.518,269
dominate,0.379,12,127,1,1,0.439,0.814,0.953,139
torch,0.378,13,137,1,1,0.531,0.63,0.545,150
angelic,0.378,13,137,1,1,0.927,0.298,0.668,150
campfire,0.378,20,206,1,1,0.677,0.509,0.436,226
pianist,0.378,6,68,1,1,0.806,0.491,0.573,74
pioneer,0.378,13,137,1,1,0.796,0.618,0.802,150
coloring,0.378,13,137,1,1,0.781,0.469,0.353,150
clarification,0.378,6,68,1,1,0.802,0.461,0.613,74
karate,0.378,6,68,1,1,0.562,0.833,0.598,74
seller,0.378,6,68,1,1,0.635,0.471,0.635,74
undermine,0.378,6,68,1,1,0.316,0.491,0.413,74
stone,0.378,196,1941,1,1,0.216,0.183,0.561,2137
upstairs,0.377,58,581,1,1,0.663,0.408,0.645,639
sunday,0.376,506,5002,1,1,0.776,0.196,0.394,5508
diarrhea,0.376,7,78,1,1,0.092,0.684,0.143,85
cab,0.376,31,315,1,1,0.438,0.49,0.421,346
strings,0.375,41,414,1,1,0.457,0.292,0.355,455
phenomenon,0.375,25,256,1,1,0.625,0.721,0.848,281
vegetable,0.374,8,88,1,1,0.551,0.12,0.289,96
tornado,0.374,8,88,1,1,0.26,0.896,0.784,96
boxers,0.374,8,88,1,1,0.375,0.88,0.654,96
comical,0.374,8,88,1,1,0.844,0.737,0.327,96
endangered,0.374,8,88,1,1,0.083,0.885,0.43,96
intervene,0.374,8,88,1,1,0.52,0.677,0.768,96
potent,0.374,8,88,1,1,0.698,0.784,0.907,96
identity,0.374,144,1433,1,1,0.663,0.36,0.78,1577
cancel,0.374,64,642,1,1,0.214,0.306,0.368,706
break,0.374,1488,14729,1,1,0.61,0.265,0.37,16217
higher,0.374,198,1968,1,1,0.866,0.528,0.713,2166
trip,0.373,468,4641,1,1,0.875,0.643,0.538,5109
tempt,0.373,9,98,1,1,0.21,0.677,0.5,107
harper,0.373,19,197,1,1,0.417,0.454,0.435,216
outlaw,0.373,9,98,1,1,0.255,0.662,0.482,107
smelling,0.373,20,207,1,1,0.458,0.481,0.349,227
impressive,0.373,31,316,1,1,0.781,0.83,0.873,347
uncharted,0.372,10,108,1,1,0.188,0.406,0.413,118
tilting,0.372,10,108,1,1,0.459,0.384,0.34,118
demonstrate,0.372,10,108,1,1,0.771,0.552,0.839,118
toe,0.372,34,346,1,1,0.406,0.221,0.293,380
adjustment,0.372,11,118,1,1,0.59,0.52,0.661,129
rug,0.372,11,118,1,1,0.52,0.24,0.245,129
articulate,0.372,23,237,1,1,0.677,0.462,0.618,260
nostalgia,0.372,71,713,1,1,0.417,0.337,0.339,784
afloat,0.372,11,118,1,1,0.602,0.427,0.444,129
planets,0.371,38,386,1,1,0.724,0.318,0.658,424
waltz,0.371,12,128,1,1,0.769,0.41,0.315,140
whilst,0.37,200,1995,1,1,0.51,0.302,0.388,2195
terror,0.37,60,605,1,1,0.069,0.902,0.415,665
music,0.369,2454,24413,1,1,0.833,0.563,0.605,26867
constant,0.368,496,4945,1,1,0.74,0.296,0.686,5441
illustration,0.368,20,208,1,1,0.74,0.441,0.64,228
metaphor,0.368,42,427,1,1,0.562,0.28,0.47,469
mar,0.368,21,218,1,1,0.622,0.544,0.545,239
agreed,0.368,131,1313,1,1,0.797,0.449,0.574,1444
fearless,0.367,24,248,1,1,0.81,0.806,0.76,272
reliable,0.367,27,278,1,1,0.912,0.241,0.875,305
climate,0.367,59,597,1,1,0.635,0.24,0.483,656
golden,0.366,225,2252,1,1,0.802,0.491,0.609,2477
react,0.366,65,657,1,1,0.5,0.716,0.717,722
vulnerability,0.366,76,767,1,1,0.25,0.51,0.267,843
classic,0.366,153,1535,1,1,0.69,0.26,0.611,1688
subject,0.366,116,1166,1,1,0.602,0.344,0.558,1282
sentimental,0.365,44,448,1,1,0.583,0.378,0.312,492
place,0.365,4914,49073,1,1,0.573,0.261,0.398,53987
approaching,0.365,68,688,1,1,0.74,0.557,0.491,756
perfection,0.364,82,828,1,1,0.881,0.745,0.934,910
unfaithful,0.363,7,79,1,1,0.031,0.806,0.298,86
instigate,0.363,2,29,1,1,0.278,0.765,0.642,31
servant,0.363,26,269,1,1,0.34,0.408,0.331,295
arrow,0.363,23,239,1,1,0.439,0.39,0.454,262
affluent,0.363,3,39,1,1,0.756,0.388,0.477,42
crouched,0.363,2,29,1,1,0.333,0.363,0.279,31
generalization,0.363,3,39,1,1,0.542,0.459,0.704,42
pajama,0.363,3,39,1,1,0.908,0.157,0.245,42
inspection,0.363,2,29,1,1,0.459,0.63,0.718,31
mush,0.363,8,89,1,1,0.5,0.311,0.125,97
flea,0.363,5,59,1,1,0.286,0.353,0.218,64
attractiveness,0.363,3,39,1,1,0.938,0.667,0.755,42
terminator,0.363,3,39,1,1,0.37,0.663,0.737,42
mooch,0.363,2,29,1,1,0.378,0.413,0.309,31
preview,0.363,16,169,1,1,0.656,0.337,0.491,185
aesthetic,0.363,60,609,1,1,0.708,0.442,0.526,669
demolished,0.363,3,39,1,1,0.271,0.647,0.353,42
magnolia,0.363,3,39,1,1,0.558,0.343,0.379,42
chirp,0.363,8,89,1,1,0.469,0.602,0.365,97
forgetful,0.363,5,59,1,1,0.24,0.343,0.264,64
claw,0.363,11,119,1,1,0.26,0.6,0.598,130
snapshot,0.363,3,39,1,1,0.573,0.578,0.588,42
twirl,0.363,2,29,1,1,0.552,0.647,0.409,31
necromancer,0.363,3,39,1,1,0.333,0.625,0.536,42
enrich,0.363,12,129,1,1,0.896,0.731,0.705,141
unconnected,0.363,3,39,1,1,0.188,0.265,0.213,42
collateral,0.363,4,49,1,1,0.531,0.422,0.717,53
townhouse,0.363,2,29,1,1,0.622,0.4,0.443,31
fluctuating,0.363,2,29,1,1,0.292,0.591,0.395,31
satire,0.363,8,89,1,1,0.458,0.655,0.472,97
coop,0.363,7,79,1,1,0.612,0.445,0.65,86
weakling,0.363,3,39,1,1,0.194,0.294,0.087,42
friggen,0.363,2,29,1,1,0.39,0.55,0.442,31
stubbornness,0.363,6,69,1,1,0.156,0.673,0.508,75
obi,0.363,4,49,1,1,0.469,0.442,0.414,53
staunch,0.363,3,39,1,1,0.48,0.363,0.833,42
tart,0.363,5,59,1,1,0.719,0.38,0.219,64
insufferable,0.363,14,149,1,1,0.22,0.784,0.291,163
tact,0.363,3,39,1,1,0.55,0.417,0.417,42
neurological,0.363,2,29,1,1,0.5,0.54,0.558,31
celery,0.363,2,29,1,1,0.396,0.147,0.223,31
partially,0.363,30,309,1,1,0.418,0.368,0.396,339
rascal,0.363,4,49,1,1,0.169,0.706,0.445,53
mullet,0.363,3,39,1,1,0.521,0.356,0.377,42
culprit,0.363,5,59,1,1,0.062,0.676,0.333,64
hasty,0.363,3,39,1,1,0.188,0.885,0.424,42
immunity,0.363,6,69,1,1,0.633,0.316,0.786,75
disregarded,0.363,5,59,1,1,0.26,0.458,0.283,64
hairless,0.363,2,29,1,1,0.136,0.235,0.139,31
chess,0.363,20,209,1,1,0.656,0.363,0.518,229
seasoned,0.363,3,39,1,1,0.812,0.57,0.509,42
livid,0.363,5,59,1,1,0.469,0.788,0.49,64
saucy,0.363,2,29,1,1,0.25,0.653,0.391,31
pubic,0.363,2,29,1,1,0.406,0.57,0.509,31
cramp,0.363,2,29,1,1,0.194,0.796,0.34,31
wolverine,0.363,3,39,1,1,0.47,0.673,0.627,42
strangle,0.363,4,49,1,1,0.094,0.927,0.527,53
graveyard,0.363,32,329,1,1,0.041,0.441,0.272,361
winding,0.363,25,259,1,1,0.398,0.582,0.361,284
oneday,0.363,3,39,1,1,0.667,0.245,0.374,42
frosting,0.363,2,29,1,1,0.823,0.48,0.424,31
paint,0.363,105,1059,1,1,0.667,0.343,0.413,1164
recycled,0.363,6,69,1,1,0.561,0.316,0.409,75
reject,0.361,79,801,1,1,0.06,0.647,0.37,880
quotes,0.361,77,781,1,1,0.625,0.578,0.52,858
steady,0.36,64,651,1,1,0.68,0.186,0.763,715
route,0.36,85,862,1,1,0.583,0.353,0.518,947
stretch,0.359,69,702,1,1,0.604,0.578,0.5,771
underrated,0.359,205,2068,1,1,0.208,0.52,0.333,2273
fantasize,0.359,21,220,1,1,0.771,0.66,0.356,241
mindless,0.359,21,220,1,1,0.184,0.333,0.153,241
theater,0.358,62,632,1,1,0.76,0.635,0.516,694
betray,0.357,32,331,1,1,0.042,0.87,0.536,363
acceptable,0.357,47,482,1,1,0.812,0.286,0.583,529
vice,0.357,61,623,1,1,0.296,0.778,0.48,684
retired,0.357,60,613,1,1,0.27,0.259,0.301,673
ape,0.357,14,150,1,1,0.548,0.389,0.336,164
laden,0.356,13,140,1,1,0.392,0.478,0.554,153
realization,0.356,107,1087,1,1,0.554,0.51,0.836,1194
accomplished,0.355,47,483,1,1,0.87,0.52,0.798,530
warehouse,0.355,11,120,1,1,0.721,0.365,0.446,131
remark,0.355,11,120,1,1,0.561,0.325,0.716,131
boycott,0.355,11,120,1,1,0.112,0.69,0.505,131
architect,0.355,11,120,1,1,0.776,0.442,0.836,131
experience,0.355,1437,14502,1,1,0.827,0.618,0.905,15939
electric,0.354,56,574,1,1,0.458,0.708,0.512,630
dearest,0.354,43,443,1,1,0.902,0.427,0.508,486
approach,0.354,162,1644,1,1,0.612,0.392,0.61,1806
brink,0.354,20,211,1,1,0.375,0.413,0.356,231
elitist,0.353,9,100,1,1,0.5,0.606,0.656,109
prophecy,0.353,9,100,1,1,0.747,0.692,0.75,109
subjective,0.353,28,292,1,1,0.51,0.35,0.432,320
hammer,0.353,18,191,1,1,0.312,0.509,0.563,209
courses,0.353,18,191,1,1,0.735,0.412,0.534,209
tango,0.352,8,90,1,1,0.622,0.56,0.43,98
outcome,0.352,44,454,1,1,0.615,0.472,0.685,498
cheerleader,0.352,8,90,1,1,0.923,0.746,0.657,98
intro,0.352,60,616,1,1,0.51,0.331,0.657,676
pattern,0.352,42,434,1,1,0.479,0.422,0.664,476
paw,0.351,16,171,1,1,0.417,0.36,0.286,187
medicate,0.351,7,80,1,1,0.417,0.375,0.546,87
desolate,0.351,71,728,1,1,0.104,0.32,0.228,799
activate,0.351,7,80,1,1,0.764,0.65,0.806,87
palm,0.351,47,485,1,1,0.531,0.194,0.34,532
revenge,0.351,70,718,1,1,0.23,0.94,0.627,788
file,0.35,22,232,1,1,0.48,0.316,0.463,254
offer,0.349,376,3821,1,1,0.75,0.745,0.596,4197
lime,0.349,13,141,1,1,0.594,0.24,0.415,154
publisher,0.349,6,70,1,1,0.571,0.392,0.691,76
demonstrated,0.349,6,70,1,1,0.617,0.5,0.649,76
distribution,0.349,6,70,1,1,0.635,0.548,0.788,76
smaller,0.349,68,699,1,1,0.3,0.31,0.179,767
advance,0.349,61,628,1,1,0.673,0.472,0.858,689
amazingly,0.348,19,202,1,1,0.918,0.765,0.92,221
refrain,0.348,19,202,1,1,0.314,0.373,0.277,221
extend,0.348,31,324,1,1,0.646,0.57,0.689,355
relieving,0.348,18,192,1,1,0.74,0.255,0.455,210
tangled,0.348,18,192,1,1,0.26,0.539,0.316,210
sheltered,0.348,18,192,1,1,0.59,0.377,0.717,210
uplifting,0.347,30,314,1,1,0.771,0.548,0.605,344
cage,0.347,98,1005,1,1,0.316,0.333,0.352,1103
step,0.347,487,4960,1,1,0.531,0.321,0.347,5447
logical,0.347,41,426,1,1,0.805,0.4,0.648,467
travesty,0.347,5,60,1,1,0.354,0.644,0.407,65
generator,0.347,5,60,1,1,0.704,0.568,0.864,65
exaggeration,0.347,5,60,1,1,0.312,0.775,0.582,65
playful,0.347,29,304,1,1,0.892,0.688,0.463,333
filter,0.347,35,365,1,1,0.44,0.296,0.26,400
ambition,0.347,41,426,1,1,0.51,0.804,0.661,467
hindsight,0.347,11,121,1,1,0.333,0.431,0.532,132
injustice,0.346,28,294,1,1,0.082,0.755,0.444,322
blurry,0.346,16,172,1,1,0.059,0.385,0.218,188
assembly,0.345,10,111,1,1,0.698,0.5,0.64,121
jeep,0.345,10,111,1,1,0.602,0.51,0.612,121
lighting,0.345,42,437,1,1,0.765,0.44,0.75,479
sole,0.345,74,763,1,1,0.427,0.194,0.279,837
stew,0.345,15,162,1,1,0.667,0.373,0.25,177
shunned,0.344,36,376,1,1,0.271,0.464,0.367,412
decay,0.344,25,264,1,1,0.143,0.312,0.17,289
journalist,0.344,35,366,1,1,0.542,0.452,0.732,401
gravity,0.344,50,519,1,1,0.51,0.635,0.538,569
resurrection,0.343,19,203,1,1,0.708,0.74,0.759,222
residential,0.343,9,101,1,1,0.72,0.21,0.589,110
reincarnation,0.343,4,50,1,1,0.786,0.747,0.676,54
undressed,0.343,4,50,1,1,0.375,0.755,0.356,54
craze,0.343,4,50,1,1,0.255,0.657,0.435,54
critic,0.343,14,152,1,1,0.264,0.604,0.686,166
spiked,0.343,4,50,1,1,0.281,0.613,0.407,54
resemblance,0.343,4,50,1,1,0.743,0.216,0.57,54
pooch,0.343,4,50,1,1,0.355,0.36,0.347,54
checklist,0.343,4,50,1,1,0.561,0.521,0.552,54
premises,0.343,4,50,1,1,0.5,0.306,0.285,54
supervision,0.343,4,50,1,1,0.459,0.578,0.825,54
marrow,0.343,4,50,1,1,0.398,0.422,0.472,54
governor,0.343,14,152,1,1,0.5,0.683,0.934,166
tense,0.343,23,244,1,1,0.396,0.439,0.655,267
resent,0.342,18,193,1,1,0.073,0.553,0.163,211
features,0.342,55,571,1,1,0.667,0.433,0.509,626
partial,0.342,13,142,1,1,0.429,0.324,0.348,155
planned,0.342,100,1031,1,1,0.74,0.385,0.729,1131
path,0.341,799,8175,1,1,0.59,0.245,0.421,8974
offended,0.341,71,735,1,1,0.188,0.69,0.337,806
rattle,0.341,8,91,1,1,0.49,0.429,0.268,99
unintentionally,0.341,17,183,1,1,0.46,0.49,0.286,200
demanding,0.34,38,398,1,1,0.396,0.75,0.828,436
raging,0.34,33,347,1,1,0.219,0.927,0.598,380
survivor,0.34,54,562,1,1,0.677,0.75,0.815,616
recognize,0.339,139,1433,1,1,0.76,0.315,0.6,1572
dedicate,0.339,40,419,1,1,0.823,0.431,0.588,459
wiggle,0.338,3,40,1,1,0.531,0.676,0.359,43
beard,0.338,39,409,1,1,0.49,0.261,0.371,448
drunkard,0.338,3,40,1,1,0.24,0.873,0.25,43
perpetrator,0.338,3,40,1,1,0.229,0.765,0.538,43
artificial,0.338,23,245,1,1,0.306,0.385,0.351,268
afterlife,0.338,23,245,1,1,0.571,0.567,0.568,268
expo,0.338,3,40,1,1,0.61,0.562,0.5,43
pedestrian,0.338,3,40,1,1,0.438,0.36,0.448,43
anecdote,0.338,3,40,1,1,0.583,0.529,0.5,43
grasping,0.338,15,163,1,1,0.327,0.561,0.561,178
ubiquitous,0.338,3,40,1,1,0.635,0.571,0.884,43
cheery,0.338,11,122,1,1,0.949,0.657,0.486,133
procreate,0.338,7,81,1,1,0.646,0.76,0.802,88
magnify,0.338,3,40,1,1,0.729,0.561,0.839,43
obtuse,0.338,3,40,1,1,0.281,0.46,0.345,43
ire,0.338,3,40,1,1,0.198,0.74,0.575,43
unwashed,0.338,3,40,1,1,0.365,0.427,0.36,43
potential,0.338,157,1619,1,1,0.806,0.625,0.84,1776
wandering,0.338,149,1537,1,1,0.323,0.471,0.357,1686
trait,0.338,62,645,1,1,0.469,0.365,0.453,707
cooking,0.338,108,1117,1,1,0.694,0.51,0.434,1225
oppression,0.337,18,194,1,1,0.08,0.673,0.615,212
style,0.337,162,1673,1,1,0.745,0.472,0.586,1835
pale,0.337,73,759,1,1,0.281,0.259,0.245,832
hall,0.336,122,1263,1,1,0.51,0.34,0.424,1385
helpful,0.336,107,1109,1,1,0.816,0.337,0.705,1216
horrifying,0.336,17,184,1,1,0.01,0.76,0.352,201
leaf,0.336,60,626,1,1,0.583,0.156,0.294,686
beaten,0.336,42,441,1,1,0.083,0.846,0.265,483
garner,0.335,6,71,1,1,0.479,0.46,0.5,77
assemble,0.335,6,71,1,1,0.542,0.57,0.75,77
continuation,0.335,6,71,1,1,0.615,0.47,0.566,77
remnant,0.335,6,71,1,1,0.367,0.312,0.388,77
superb,0.334,23,246,1,1,0.98,0.708,0.852,269
decorate,0.334,16,174,1,1,0.954,0.37,0.404,190
adolescence,0.334,16,174,1,1,0.487,0.694,0.444,190
groom,0.334,9,102,1,1,0.698,0.5,0.605,111
weigh,0.334,19,205,1,1,0.333,0.396,0.375,224
daylight,0.333,32,339,1,1,0.865,0.42,0.545,371
heaven,0.333,417,4308,1,1,0.896,0.385,0.6,4725
beer,0.332,230,2381,1,1,0.592,0.654,0.5,2611
map,0.332,98,1020,1,1,0.561,0.229,0.463,1118
musician,0.332,37,391,1,1,0.816,0.509,0.618,428
amusement,0.332,21,226,1,1,0.929,0.837,0.803,247
vacuum,0.331,33,350,1,1,0.327,0.196,0.134,383
sensation,0.331,36,381,1,1,0.781,0.663,0.673,417
payer,0.33,2,30,1,1,0.313,0.63,0.638,32
endorse,0.33,5,61,1,1,0.592,0.392,0.472,66
chipping,0.33,2,30,1,1,0.354,0.452,0.353,32
fabricated,0.33,5,61,1,1,0.418,0.427,0.555,66
livelihood,0.33,5,61,1,1,0.698,0.481,0.721,66
swoon,0.33,5,61,1,1,0.292,0.51,0.16,66
substantially,0.33,2,30,1,1,0.646,0.471,0.684,32
demise,0.33,26,278,1,1,0.104,0.596,0.456,304
diverse,0.33,26,278,1,1,0.562,0.519,0.604,304
debacle,0.33,2,30,1,1,0.156,0.606,0.266,32
splinter,0.33,2,30,1,1,0.136,0.422,0.325,32
tarmac,0.33,2,30,1,1,0.357,0.302,0.398,32
legislative,0.33,2,30,1,1,0.633,0.365,0.8,32
disparaging,0.33,2,30,1,1,0.102,0.626,0.411,32
cemented,0.33,2,30,1,1,0.429,0.382,0.537,32
collage,0.33,11,123,1,1,0.68,0.321,0.375,134
spaceman,0.33,2,30,1,1,0.688,0.577,0.848,32
papyrus,0.33,2,30,1,1,0.459,0.24,0.324,32
grudge,0.33,8,92,1,1,0.115,0.647,0.414,100
rancher,0.33,2,30,1,1,0.51,0.52,0.543,32
pinball,0.33,2,30,1,1,0.582,0.64,0.442,32
infuriated,0.33,2,30,1,1,0.073,0.93,0.51,32
pelican,0.33,2,30,1,1,0.573,0.391,0.38,32
pickled,0.33,2,30,1,1,0.344,0.45,0.291,32
triumphant,0.33,5,61,1,1,0.949,0.837,0.972,66
intending,0.33,2,30,1,1,0.51,0.567,0.597,32
skull,0.33,35,371,1,1,0.276,0.558,0.574,406
primer,0.33,2,30,1,1,0.625,0.363,0.688,32
cuss,0.33,11,123,1,1,0.354,0.538,0.443,134
intersect,0.33,2,30,1,1,0.521,0.51,0.48,32
word,0.33,1082,11194,1,1,0.552,0.255,0.482,12276
illusion,0.329,89,930,1,1,0.562,0.49,0.387,1019
paper,0.329,203,2110,1,1,0.52,0.123,0.293,2313
controlling,0.329,33,351,1,1,0.49,0.441,0.885,384
confuse,0.329,101,1055,1,1,0.1,0.58,0.27,1156
thirty,0.328,27,289,1,1,0.562,0.349,0.316,316
flaw,0.328,24,258,1,1,0.319,0.491,0.175,282
daily,0.328,534,5543,1,1,0.653,0.347,0.473,6077
sorting,0.327,10,113,1,1,0.469,0.4,0.642,123
sensible,0.327,21,227,1,1,0.625,0.454,0.312,248
shambles,0.327,10,113,1,1,0.271,0.696,0.287,123
sunk,0.327,10,113,1,1,0.146,0.531,0.185,123
lifelong,0.327,34,362,1,1,0.823,0.33,0.64,396
central,0.327,66,694,1,1,0.64,0.356,0.621,760
straw,0.326,15,165,1,1,0.48,0.29,0.163,180
triangle,0.326,15,165,1,1,0.562,0.269,0.352,180
praised,0.326,15,165,1,1,0.95,0.441,0.721,180
trooper,0.326,7,82,1,1,0.458,0.694,0.713,89
artist,0.326,312,3247,1,1,0.802,0.442,0.732,3559
gusto,0.326,28,300,1,1,0.692,0.729,0.62,328
unusual,0.326,46,487,1,1,0.429,0.433,0.361,533
indication,0.325,12,134,1,1,0.719,0.432,0.75,146
peasant,0.325,12,134,1,1,0.53,0.275,0.407,146
razor,0.325,12,134,1,1,0.26,0.61,0.481,146
palette,0.325,17,186,1,1,0.59,0.333,0.205,203
desk,0.325,106,1111,1,1,0.51,0.135,0.422,1217
differences,0.324,42,446,1,1,0.365,0.582,0.342,488
yard,0.324,57,602,1,1,0.468,0.176,0.349,659
transit,0.324,14,155,1,1,0.439,0.59,0.588,169
garage,0.324,39,415,1,1,0.531,0.283,0.455,454
boiling,0.324,14,155,1,1,0.302,0.69,0.526,169
nosy,0.324,9,103,1,1,0.292,0.558,0.433,112
loudness,0.324,4,51,1,1,0.35,0.582,0.62,55
reopen,0.324,4,51,1,1,0.656,0.528,0.568,55
relay,0.324,9,103,1,1,0.738,0.542,0.543,112
approved,0.324,14,155,1,1,0.833,0.349,0.698,169
born,0.324,596,6208,1,1,0.865,0.509,0.591,6804
heavy,0.324,335,3494,1,1,0.25,0.454,0.6,3829
finale,0.323,26,280,1,1,0.406,0.33,0.468,306
breakfast,0.323,156,1633,1,1,0.885,0.33,0.429,1789
tune,0.323,174,1821,1,1,0.708,0.479,0.426,1995
hobbit,0.323,16,176,1,1,0.479,0.489,0.472,192
cosmic,0.323,50,530,1,1,0.663,0.538,0.692,580
cliff,0.323,40,426,1,1,0.361,0.62,0.509,466
vitamin,0.322,11,124,1,1,0.827,0.33,0.56,135
purely,0.322,42,447,1,1,0.684,0.441,0.536,489
brains,0.322,61,645,1,1,0.663,0.557,0.722,706
toxicity,0.322,56,593,1,1,0.104,0.865,0.491,649
door,0.322,589,6150,1,1,0.549,0.189,0.421,6739
deep,0.321,1599,16683,1,1,0.49,0.473,0.657,18282
sever,0.321,6,72,1,1,0.156,0.635,0.451,78
classified,0.321,6,72,1,1,0.571,0.46,0.663,78
management,0.321,41,437,1,1,0.792,0.491,0.806,478
underneath,0.321,55,583,1,1,0.45,0.265,0.158,638
python,0.321,6,72,1,1,0.219,0.618,0.618,78
fluent,0.321,6,72,1,1,0.76,0.5,0.614,78
mill,0.321,13,145,1,1,0.531,0.382,0.347,158
announce,0.32,47,500,1,1,0.694,0.618,0.611,547
medicine,0.32,110,1158,1,1,0.708,0.318,0.679,1268
consistent,0.319,61,647,1,1,0.786,0.431,0.726,708
antidote,0.319,32,344,1,1,0.541,0.49,0.629,376
cinematography,0.319,10,114,1,1,0.781,0.571,0.625,124
performer,0.319,10,114,1,1,0.541,0.53,0.708,124
short,0.318,550,5762,1,1,0.184,0.264,0.237,6312
celebrated,0.318,38,407,1,1,0.875,0.69,0.763,445
inexplicable,0.318,12,135,1,1,0.224,0.635,0.443,147
thick,0.318,90,951,1,1,0.449,0.433,0.596,1041
lab,0.318,59,627,1,1,0.479,0.5,0.6,686
ramble,0.318,14,156,1,1,0.615,0.464,0.44,170
thousand,0.317,203,2135,1,1,0.663,0.355,0.48,2338
astrology,0.317,18,198,1,1,0.635,0.34,0.5,216
competitive,0.316,22,240,1,1,0.447,0.718,0.908,262
exposed,0.316,70,743,1,1,0.471,0.661,0.509,813
sheet,0.316,24,261,1,1,0.439,0.174,0.302,285
drown,0.316,178,1875,1,1,0.071,0.86,0.27,2053
vibrant,0.316,28,303,1,1,0.771,0.824,0.782,331
grandfather,0.316,32,345,1,1,0.827,0.279,0.586,377
sunshine,0.315,197,2077,1,1,0.885,0.297,0.769,2274
opposing,0.314,11,125,1,1,0.188,0.66,0.518,136
brunch,0.314,25,272,1,1,0.406,0.363,0.343,297
belated,0.314,7,83,1,1,0.24,0.4,0.214,90
corporation,0.314,7,83,1,1,0.429,0.332,0.873,90
speculation,0.314,5,62,1,1,0.325,0.683,0.394,67
hugger,0.314,3,41,1,1,0.52,0.48,0.412,44
prospective,0.314,3,41,1,1,0.678,0.5,0.717,44
ecosystem,0.314,5,62,1,1,0.729,0.259,0.633,67
jug,0.314,3,41,1,1,0.52,0.25,0.213,44
thoughtless,0.314,5,62,1,1,0.194,0.58,0.452,67
obstacle,0.314,9,104,1,1,0.204,0.708,0.336,113
mania,0.314,11,125,1,1,0.29,0.683,0.382,136
wad,0.314,5,62,1,1,0.333,0.318,0.259,67
drugged,0.314,9,104,1,1,0.102,0.75,0.321,113
nauseating,0.314,3,41,1,1,0.021,0.64,0.25,44
conjuring,0.314,3,41,1,1,0.224,0.653,0.694,44
infantile,0.314,3,41,1,1,0.604,0.382,0.259,44
flaming,0.314,9,104,1,1,0.406,0.645,0.558,113
combined,0.314,49,524,1,1,0.622,0.37,0.5,573
dish,0.314,23,251,1,1,0.552,0.255,0.264,274
smithereens,0.314,3,41,1,1,0.281,0.561,0.409,44
sate,0.314,3,41,1,1,0.667,0.4,0.472,44
impatiently,0.314,3,41,1,1,0.194,0.75,0.539,44
melee,0.314,3,41,1,1,0.541,0.704,0.611,44
fad,0.314,3,41,1,1,0.663,0.52,0.57,44
ripper,0.314,3,41,1,1,0.219,0.887,0.642,44
grope,0.314,5,62,1,1,0.42,0.559,0.358,67
deflect,0.314,7,83,1,1,0.133,0.491,0.482,90
technology,0.314,120,1270,1,1,0.776,0.49,0.825,1390
willingly,0.313,34,367,1,1,0.833,0.316,0.588,401
visitor,0.312,24,262,1,1,0.646,0.48,0.461,286
concept,0.312,210,2220,1,1,0.573,0.265,0.632,2430
chilled,0.312,16,178,1,1,0.521,0.34,0.482,194
area,0.311,323,3413,1,1,0.49,0.306,0.464,3736
dangerous,0.311,631,6659,1,1,0.02,0.941,0.658,7290
collaborate,0.311,12,136,1,1,0.816,0.449,0.559,148
doorstep,0.311,12,136,1,1,0.531,0.274,0.391,148
dislike,0.311,99,1053,1,1,0.156,0.406,0.321,1152
uncontrollable,0.31,10,115,1,1,0.265,0.79,0.626,125
aim,0.31,52,558,1,1,0.481,0.569,0.567,610
crab,0.309,28,305,1,1,0.421,0.396,0.33,333
test,0.309,165,1751,1,1,0.449,0.5,0.509,1916
numerous,0.309,40,432,1,1,0.622,0.462,0.609,472
consecutive,0.308,15,168,1,1,0.663,0.418,0.643,183
folded,0.308,15,168,1,1,0.179,0.373,0.327,183
accent,0.308,22,242,1,1,0.598,0.357,0.509,264
ensemble,0.308,6,73,1,1,0.697,0.418,0.586,79
ineffective,0.308,6,73,1,1,0.093,0.422,0.094,79
discourage,0.308,6,73,1,1,0.184,0.443,0.267,79
roadside,0.308,6,73,1,1,0.5,0.569,0.472,79
lords,0.308,13,147,1,1,0.571,0.356,0.781,160
cigarette,0.307,56,602,1,1,0.219,0.528,0.304,658
barn,0.307,18,200,1,1,0.51,0.452,0.425,218
boil,0.306,11,126,1,1,0.417,0.684,0.433,137
micro,0.306,11,126,1,1,0.5,0.27,0.25,137
meantime,0.306,35,380,1,1,0.432,0.222,0.3,415
brass,0.306,11,126,1,1,0.5,0.32,0.49,137
particular,0.306,158,1682,1,1,0.562,0.402,0.552,1840
delay,0.306,16,179,1,1,0.204,0.51,0.162,195
steal,0.305,115,1228,1,1,0.021,0.856,0.528,1343
thorn,0.305,9,105,1,1,0.296,0.541,0.427,114
enormously,0.305,4,52,1,1,0.76,0.694,0.872,56
devious,0.305,4,52,1,1,0.25,0.519,0.259,56
scraping,0.305,4,52,1,1,0.265,0.479,0.305,56
tire,0.305,24,264,1,1,0.438,0.385,0.381,288
cardiac,0.305,4,52,1,1,0.344,0.765,0.615,56
fruity,0.305,4,52,1,1,0.683,0.414,0.33,56
miner,0.305,4,52,1,1,0.408,0.594,0.644,56
fugitive,0.305,4,52,1,1,0.104,0.922,0.388,56
jag,0.305,4,52,1,1,0.408,0.44,0.427,56
skateboard,0.305,4,52,1,1,0.677,0.55,0.353,56
interesting,0.304,481,5115,1,1,0.927,0.726,0.731,5596
completely,0.304,792,8416,1,1,0.73,0.37,0.69,9208
memoir,0.303,25,275,1,1,0.75,0.242,0.553,300
shortly,0.303,25,275,1,1,0.582,0.31,0.36,300
fuzzy,0.303,20,222,1,1,0.306,0.472,0.158,242
charge,0.303,78,838,1,1,0.51,0.633,0.785,916
privilege,0.303,97,1040,1,1,0.847,0.625,0.821,1137
sort,0.303,418,4450,1,1,0.673,0.389,0.674,4868
watery,0.303,7,84,1,1,0.367,0.461,0.292,91
visibly,0.303,7,84,1,1,0.724,0.373,0.591,91
criticism,0.303,39,424,1,1,0.115,0.563,0.505,463
pursuing,0.303,31,339,1,1,0.483,0.906,0.69,370
hypothetical,0.303,7,84,1,1,0.48,0.367,0.361,91
skeptical,0.303,7,84,1,1,0.207,0.5,0.452,91
axe,0.303,15,169,1,1,0.296,0.69,0.536,184
passionate,0.302,74,796,1,1,0.99,0.827,0.731,870
carrying,0.302,74,796,1,1,0.656,0.557,0.443,870
running,0.302,565,6017,1,1,0.73,0.858,0.442,6582
resisting,0.301,10,116,1,1,0.408,0.776,0.789,126
production,0.301,46,499,1,1,0.694,0.594,0.781,545
righteous,0.301,35,382,1,1,0.823,0.385,0.79,417
light,0.301,1323,14085,1,1,0.771,0.32,0.519,15408
wrinkled,0.301,13,148,1,1,0.271,0.402,0.2,161
splash,0.301,13,148,1,1,0.521,0.412,0.281,161
destroying,0.301,58,627,1,1,0.041,0.828,0.66,685
indifferent,0.301,30,329,1,1,0.396,0.157,0.25,359
inevitable,0.3,96,1032,1,1,0.316,0.419,0.623,1128
champ,0.3,19,212,1,1,0.854,0.754,0.896,231
traces,0.3,22,244,1,1,0.482,0.448,0.389,266
clarify,0.3,22,244,1,1,0.652,0.535,0.625,266
maneuver,0.299,2,31,1,1,0.615,0.663,0.608,33
illustrate,0.299,5,63,1,1,0.75,0.43,0.69,68
sickly,0.299,8,95,1,1,0.188,0.55,0.191,103
wimpy,0.299,2,31,1,1,0.188,0.292,0.134,33
prune,0.299,2,31,1,1,0.531,0.311,0.382,33
especial,0.299,2,31,1,1,0.827,0.419,0.794,33
missiles,0.299,2,31,1,1,0.07,0.922,0.83,33
zebra,0.299,5,63,1,1,0.567,0.448,0.314,68
longevity,0.299,8,95,1,1,0.75,0.353,0.745,103
cite,0.299,5,63,1,1,0.625,0.454,0.532,68
cardigan,0.299,2,31,1,1,0.599,0.324,0.264,33
overestimate,0.299,2,31,1,1,0.367,0.796,0.444,33
contractor,0.299,2,31,1,1,0.592,0.479,0.727,33
verve,0.299,2,31,1,1,0.724,0.84,0.693,33
spectrum,0.299,35,383,1,1,0.312,0.7,0.527,418
radiator,0.299,2,31,1,1,0.385,0.452,0.475,33
graft,0.299,2,31,1,1,0.41,0.528,0.42,33
seating,0.299,11,127,1,1,0.552,0.265,0.286,138
mild,0.299,26,287,1,1,0.635,0.198,0.216,313
bankroll,0.299,2,31,1,1,0.469,0.57,0.509,33
newsflash,0.299,5,63,1,1,0.604,0.637,0.518,68
sunbeam,0.299,2,31,1,1,0.729,0.44,0.505,33
interim,0.299,2,31,1,1,0.604,0.4,0.524,33
asparagus,0.299,2,31,1,1,0.469,0.317,0.264,33
motley,0.299,2,31,1,1,0.48,0.398,0.412,33
beginner,0.299,2,31,1,1,0.49,0.48,0.387,33
avert,0.299,2,31,1,1,0.51,0.388,0.465,33
pride,0.298,305,3264,1,1,0.729,0.634,0.848,3569
damage,0.298,84,906,1,1,0.059,0.726,0.403,990
fourth,0.298,42,458,1,1,0.559,0.28,0.398,500
german,0.298,67,725,1,1,0.438,0.29,0.57,792
unreal,0.297,37,405,1,1,0.173,0.431,0.296,442
continuing,0.297,50,544,1,1,0.667,0.5,0.52,594
experienced,0.297,274,2938,1,1,0.771,0.613,0.914,3212
blood,0.297,298,3195,1,1,0.219,0.684,0.585,3493
masked,0.296,12,138,1,1,0.375,0.549,0.518,150
encore,0.296,12,138,1,1,0.51,0.423,0.5,150
therapy,0.296,212,2277,1,1,0.49,0.353,0.607,2489
deadlines,0.296,19,213,1,1,0.406,0.769,0.411,232
uncomfortable,0.295,202,2172,1,1,0.188,0.61,0.214,2374
woodwork,0.294,6,74,1,1,0.49,0.481,0.545,80
rinse,0.294,13,149,1,1,0.663,0.168,0.409,162
programmer,0.294,6,74,1,1,0.562,0.426,0.759,80
entry,0.294,38,417,1,1,0.552,0.353,0.602,455
operation,0.293,17,192,1,1,0.475,0.611,0.755,209
masculine,0.293,17,192,1,1,0.653,0.54,0.773,209
grey,0.293,163,1758,1,1,0.347,0.14,0.295,1921
dig,0.293,94,1018,1,1,0.367,0.585,0.637,1112
nightly,0.293,21,235,1,1,0.673,0.41,0.474,256
unbreakable,0.293,10,117,1,1,0.653,0.573,0.759,127
shore,0.293,109,1179,1,1,0.542,0.304,0.204,1288
gently,0.293,98,1061,1,1,0.917,0.255,0.36,1159
daze,0.293,10,117,1,1,0.245,0.735,0.329,127
purchase,0.293,36,396,1,1,0.625,0.5,0.616,432
analysis,0.293,36,396,1,1,0.729,0.448,0.705,432
happiness,0.292,1652,17741,1,1,0.96,0.732,0.85,19393
dome,0.292,18,203,1,1,0.62,0.398,0.509,221
owl,0.292,56,611,1,1,0.52,0.27,0.321,667
deaf,0.292,45,493,1,1,0.186,0.324,0.161,538
friendship,0.292,651,7001,1,1,0.958,0.343,0.694,7652
circle,0.292,248,2674,1,1,0.48,0.29,0.343,2922
lard,0.291,3,42,1,1,0.427,0.239,0.179,45
stellar,0.291,11,128,1,1,0.796,0.58,0.769,139
restriction,0.291,3,42,1,1,0.13,0.59,0.569,45
gambler,0.291,3,42,1,1,0.458,0.694,0.618,45
superficial,0.291,35,386,1,1,0.357,0.407,0.309,421
eviction,0.291,3,42,1,1,0.185,0.731,0.455,45
rapids,0.291,3,42,1,1,0.573,0.817,0.788,45
theoretical,0.291,3,42,1,1,0.615,0.27,0.546,45
hem,0.291,3,42,1,1,0.562,0.283,0.291,45
opener,0.291,11,128,1,1,0.584,0.526,0.377,139
fickle,0.291,11,128,1,1,0.406,0.481,0.346,139
tor,0.291,3,42,1,1,0.337,0.43,0.418,45
continuum,0.291,3,42,1,1,0.677,0.39,0.491,45
cone,0.291,15,171,1,1,0.417,0.208,0.343,186
quack,0.291,3,42,1,1,0.53,0.451,0.625,45
regressive,0.291,3,42,1,1,0.302,0.434,0.363,45
mainland,0.291,3,42,1,1,0.68,0.407,0.806,45
inserted,0.291,3,42,1,1,0.479,0.402,0.476,45
steam,0.291,31,343,1,1,0.469,0.413,0.421,374
winter,0.29,685,7378,1,1,0.663,0.355,0.5,8063
vanilla,0.29,24,268,1,1,0.706,0.216,0.284,292
vehicle,0.29,20,225,1,1,0.641,0.565,0.5,245
considerate,0.289,16,182,1,1,0.781,0.38,0.633,198
guest,0.289,67,731,1,1,0.719,0.49,0.558,798
result,0.289,208,2249,1,1,0.812,0.49,0.652,2457
informed,0.289,29,322,1,1,0.543,0.298,0.617,351
flare,0.289,12,139,1,1,0.558,0.823,0.508,151
lurk,0.289,12,139,1,1,0.219,0.74,0.655,151
recent,0.289,156,1690,1,1,0.592,0.365,0.589,1846
consent,0.289,21,236,1,1,0.75,0.5,0.62,257
drip,0.288,17,193,1,1,0.392,0.193,0.175,210
caress,0.288,35,387,1,1,0.833,0.418,0.509,422
memo,0.288,8,96,1,1,0.625,0.235,0.407,104
acid,0.288,31,344,1,1,0.265,0.642,0.566,375
lungs,0.288,54,592,1,1,0.531,0.352,0.555,646
legacy,0.288,45,495,1,1,0.792,0.529,0.827,540
stardust,0.288,13,150,1,1,0.843,0.41,0.549,163
educational,0.288,13,150,1,1,0.745,0.457,0.764,163
painful,0.287,565,6105,1,1,0.05,0.742,0.33,6670
turning,0.287,265,2869,1,1,0.51,0.684,0.42,3134
numbers,0.287,147,1596,1,1,0.406,0.241,0.44,1743
paranoia,0.287,47,517,1,1,0.146,0.841,0.407,564
unreasonable,0.286,9,107,1,1,0.115,0.702,0.264,116
variations,0.286,4,53,1,1,0.458,0.548,0.353,57
shuttle,0.286,4,53,1,1,0.531,0.591,0.547,57
bondage,0.286,19,215,1,1,0.146,0.705,0.355,234
greeted,0.286,19,215,1,1,0.781,0.317,0.454,234
pasta,0.286,34,377,1,1,0.615,0.306,0.375,411
whiplash,0.286,4,53,1,1,0.257,0.76,0.5,57
unfriendly,0.286,9,107,1,1,0.173,0.67,0.458,116
stunned,0.286,9,107,1,1,0.306,0.663,0.356,116
maggot,0.286,4,53,1,1,0.235,0.5,0.235,57
addition,0.286,45,496,1,1,0.562,0.373,0.471,541
condo,0.285,20,226,1,1,0.439,0.288,0.607,246
temptation,0.285,36,399,1,1,0.365,0.817,0.56,435
human,0.285,1738,18799,1,1,0.767,0.314,0.605,20537
apt,0.285,52,572,1,1,0.582,0.418,0.382,624
incoming,0.285,15,172,1,1,0.66,0.509,0.596,187
three,0.285,741,8023,1,1,0.653,0.225,0.377,8764
consuming,0.285,70,767,1,1,0.573,0.541,0.536,837
faculty,0.285,10,118,1,1,0.615,0.412,0.732,128
orbit,0.285,21,237,1,1,0.561,0.422,0.575,258
yearly,0.285,10,118,1,1,0.592,0.295,0.431,128
assets,0.285,10,118,1,1,0.667,0.613,0.765,128
madman,0.285,10,118,1,1,0.135,0.88,0.312,128
snowing,0.285,10,118,1,1,0.586,0.49,0.387,128
humble,0.284,99,1081,1,1,0.867,0.236,0.483,1180
prisoner,0.284,40,443,1,1,0.071,0.654,0.308,483
ways,0.283,641,6954,1,1,0.688,0.56,0.425,7595
soggy,0.283,5,64,1,1,0.312,0.35,0.241,69
championship,0.283,17,194,1,1,0.833,0.8,0.88,211
sake,0.283,177,1928,1,1,0.49,0.573,0.407,2105
chilling,0.283,159,1733,1,1,0.208,0.85,0.358,1892
traditional,0.283,36,400,1,1,0.677,0.221,0.604,436
recovery,0.282,75,823,1,1,0.781,0.402,0.737,898
digital,0.282,115,1257,1,1,0.74,0.382,0.529,1372
disinterested,0.281,6,75,1,1,0.398,0.284,0.392,81
lustful,0.281,6,75,1,1,0.427,0.896,0.643,81
sprout,0.281,6,75,1,1,0.582,0.565,0.443,81
apparent,0.281,42,466,1,1,0.473,0.383,0.398,508
furniture,0.28,28,314,1,1,0.688,0.26,0.264,342
launch,0.28,52,575,1,1,0.684,0.814,0.598,627
become,0.28,1770,19250,1,1,0.641,0.583,0.643,21020
appeal,0.28,46,510,1,1,0.663,0.598,0.558,556
mechanic,0.279,7,86,1,1,0.571,0.433,0.566,93
backbone,0.279,7,86,1,1,0.538,0.464,0.62,93
instant,0.279,72,793,1,1,0.766,0.454,0.554,865
inform,0.279,16,184,1,1,0.723,0.582,0.679,200
fame,0.278,147,1610,1,1,0.896,0.755,0.852,1757
avoid,0.278,418,4560,1,1,0.427,0.442,0.415,4978
swimming,0.278,79,870,1,1,0.76,0.559,0.524,949
timer,0.278,8,97,1,1,0.469,0.433,0.5,105
root,0.278,71,783,1,1,0.602,0.279,0.508,854
mercury,0.278,35,391,1,1,0.337,0.312,0.475,426
tailor,0.278,8,97,1,1,0.573,0.206,0.45,105
guise,0.278,8,97,1,1,0.531,0.547,0.324,105
passive,0.278,27,304,1,1,0.42,0.116,0.241,331
stare,0.277,123,1350,1,1,0.541,0.43,0.538,1473
practical,0.277,28,315,1,1,0.71,0.49,0.608,343
empress,0.277,9,108,1,1,0.716,0.669,0.855,117
porter,0.277,9,108,1,1,0.571,0.375,0.654,117
rift,0.277,9,108,1,1,0.246,0.519,0.289,117
suite,0.277,19,217,1,1,0.79,0.42,0.4,236
chair,0.277,140,1536,1,1,0.562,0.082,0.276,1676
five,0.276,285,3118,1,1,0.51,0.221,0.298,3403
dilemma,0.276,31,348,1,1,0.153,0.59,0.43,379
deposit,0.276,10,119,1,1,0.54,0.379,0.483,129
anti,0.276,101,1112,1,1,0.365,0.412,0.384,1213
panther,0.275,11,130,1,1,0.303,0.594,0.682,141
speak,0.275,779,8515,1,1,0.765,0.472,0.5,9294
humane,0.275,12,141,1,1,0.8,0.37,0.58,153
dragon,0.275,129,1419,1,1,0.541,0.821,0.712,1548
soap,0.274,28,316,1,1,0.531,0.163,0.311,344
ruined,0.274,116,1278,1,1,0.135,0.564,0.194,1394
larger,0.274,46,513,1,1,0.729,0.654,0.763,559
restart,0.274,15,174,1,1,0.531,0.519,0.554,189
jesus,0.274,693,7590,1,1,0.8,0.4,0.62,8283
gospel,0.273,32,360,1,1,0.74,0.333,0.58,392
swallow,0.273,67,743,1,1,0.466,0.608,0.436,810
patron,0.273,16,185,1,1,0.583,0.451,0.87,201
office,0.273,436,4781,1,1,0.427,0.302,0.509,5217
dew,0.273,18,207,1,1,0.604,0.225,0.464,225
color,0.273,210,2309,1,1,0.786,0.28,0.402,2519
academic,0.272,39,437,1,1,0.781,0.42,0.812,476
mile,0.272,70,777,1,1,0.521,0.417,0.456,847
cooler,0.272,23,262,1,1,0.664,0.375,0.46,285
restless,0.272,72,799,1,1,0.219,0.81,0.304,871
means,0.271,1285,14095,1,1,0.615,0.373,0.46,15380
food,0.271,934,10248,1,1,0.888,0.324,0.527,11182
unfortunate,0.271,53,591,1,1,0.073,0.487,0.195,644
arena,0.271,27,306,1,1,0.51,0.235,0.404,333
irritating,0.271,28,317,1,1,0.104,0.912,0.393,345
eastern,0.271,32,361,1,1,0.521,0.42,0.48,393
brush,0.27,40,449,1,1,0.49,0.265,0.186,489
preach,0.27,41,460,1,1,0.602,0.48,0.702,501
knife,0.269,57,636,1,1,0.344,0.717,0.573,693
faithful,0.269,69,768,1,1,0.888,0.333,0.627,837
destroyed,0.269,97,1076,1,1,0.031,0.696,0.288,1173
malaise,0.268,4,54,1,1,0.15,0.6,0.161,58
divide,0.268,29,329,1,1,0.333,0.52,0.417,358
paddock,0.268,2,32,1,1,0.48,0.429,0.481,34
reproduction,0.268,4,54,1,1,0.8,0.736,0.713,58
confetti,0.268,3,43,1,1,0.781,0.573,0.25,46
caramel,0.268,7,87,1,1,0.901,0.363,0.4,94
fragrant,0.268,2,32,1,1,0.615,0.598,0.613,34
yogurt,0.268,8,98,1,1,0.66,0.269,0.24,106
blindly,0.268,16,186,1,1,0.439,0.598,0.278,202
gallant,0.268,2,32,1,1,0.908,0.539,0.679,34
implied,0.268,11,131,1,1,0.327,0.53,0.481,142
nebula,0.268,6,76,1,1,0.51,0.418,0.438,82
possessing,0.268,3,43,1,1,0.461,0.593,0.612,46
distribute,0.268,3,43,1,1,0.643,0.596,0.709,46
accountable,0.268,26,296,1,1,0.709,0.282,0.777,322
coupled,0.268,28,318,1,1,0.612,0.286,0.65,346
pernicious,0.268,2,32,1,1,0.229,0.6,0.382,34
potter,0.268,48,538,1,1,0.573,0.417,0.482,586
helix,0.268,2,32,1,1,0.521,0.462,0.509,34
lineage,0.268,6,76,1,1,0.633,0.465,0.721,82
distortion,0.268,3,43,1,1,0.299,0.57,0.38,46
aspen,0.268,3,43,1,1,0.479,0.28,0.395,46
segregated,0.268,4,54,1,1,0.164,0.575,0.411,58
shattering,0.268,11,131,1,1,0.135,0.76,0.475,142
thirteen,0.268,9,109,1,1,0.459,0.385,0.331,118
nebulous,0.268,2,32,1,1,0.469,0.347,0.417,34
sinning,0.268,2,32,1,1,0.17,0.7,0.422,34
staple,0.268,4,54,1,1,0.542,0.306,0.438,58
mutant,0.268,6,76,1,1,0.337,0.676,0.573,82
reckless,0.268,34,384,1,1,0.262,0.788,0.279,418
pedal,0.268,3,43,1,1,0.5,0.32,0.342,46
preoccupied,0.268,12,142,1,1,0.265,0.7,0.235,154
largo,0.268,2,32,1,1,0.521,0.48,0.517,34
discard,0.268,5,65,1,1,0.24,0.343,0.337,70
screech,0.268,3,43,1,1,0.214,0.802,0.306,46
knots,0.268,6,76,1,1,0.418,0.346,0.267,82
storehouse,0.268,2,32,1,1,0.57,0.25,0.491,34
beaver,0.268,5,65,1,1,0.49,0.344,0.393,70
goggles,0.268,2,32,1,1,0.667,0.36,0.278,34
dissociative,0.268,3,43,1,1,0.281,0.615,0.397,46
impractical,0.268,2,32,1,1,0.16,0.373,0.291,34
saver,0.268,6,76,1,1,0.745,0.382,0.802,82
hardness,0.268,2,32,1,1,0.417,0.58,0.745,34
storage,0.268,12,142,1,1,0.698,0.406,0.564,154
exhale,0.268,14,164,1,1,0.542,0.49,0.411,178
jive,0.268,2,32,1,1,0.561,0.551,0.373,34
signal,0.266,46,517,1,1,0.615,0.417,0.464,563
suffer,0.265,454,5017,1,1,0.082,0.91,0.259,5471
flip,0.265,56,628,1,1,0.281,0.529,0.435,684
pray,0.264,769,8498,1,1,0.714,0.127,0.627,9267
slight,0.264,51,573,1,1,0.521,0.24,0.155,624
excellent,0.264,127,1412,1,1,0.97,0.587,0.87,1539
morning,0.264,1719,18991,1,1,0.688,0.235,0.444,20710
groove,0.264,22,253,1,1,0.552,0.448,0.361,275
leaning,0.264,44,496,1,1,0.48,0.409,0.352,540
consume,0.264,64,717,1,1,0.427,0.62,0.509,781
grill,0.263,19,220,1,1,0.755,0.491,0.546,239
correction,0.263,18,209,1,1,0.448,0.485,0.558,227
champion,0.263,35,397,1,1,0.89,0.88,0.945,432
blanket,0.262,150,1669,1,1,0.74,0.132,0.391,1819
demonic,0.262,15,176,1,1,0.146,0.875,0.6,191
doc,0.262,46,519,1,1,0.458,0.317,0.392,565
negativity,0.262,119,1327,1,1,0.06,0.52,0.273,1446
motivational,0.262,14,165,1,1,0.906,0.646,0.858,179
sensitive,0.262,132,1471,1,1,0.714,0.426,0.254,1603
thunder,0.262,43,486,1,1,0.296,0.916,0.526,529
league,0.262,116,1294,1,1,0.656,0.34,0.462,1410
traveling,0.261,197,2191,1,1,0.9,0.75,0.582,2388
bridge,0.261,124,1383,1,1,0.625,0.324,0.519,1507
declining,0.261,12,143,1,1,0.328,0.4,0.264,155
amount,0.261,375,4164,1,1,0.562,0.422,0.649,4539
accident,0.261,63,708,1,1,0.125,0.908,0.336,771
pudding,0.26,11,132,1,1,0.75,0.255,0.202,143
inconsiderate,0.26,11,132,1,1,0.224,0.519,0.423,143
leftovers,0.26,11,132,1,1,0.219,0.35,0.116,143
destructive,0.26,66,742,1,1,0.177,0.87,0.713,808
indigenous,0.26,10,121,1,1,0.5,0.509,0.552,131
rebellious,0.259,20,232,1,1,0.344,0.88,0.663,252
repetitive,0.259,20,232,1,1,0.32,0.438,0.362,252
may,0.259,2970,32966,1,1,0.704,0.273,0.245,35936
starship,0.259,9,110,1,1,0.74,0.719,0.704,119
reinforce,0.259,9,110,1,1,0.604,0.583,0.76,119
resume,0.259,19,221,1,1,0.573,0.411,0.586,240
poignant,0.259,29,332,1,1,0.646,0.444,0.518,361
placement,0.257,16,188,1,1,0.643,0.46,0.528,204
combine,0.257,16,188,1,1,0.663,0.442,0.533,204
father,0.257,542,6038,1,1,0.812,0.333,0.824,6580
carrier,0.257,7,88,1,1,0.533,0.588,0.638,95
harden,0.257,7,88,1,1,0.276,0.598,0.677,95
seething,0.257,7,88,1,1,0.312,0.821,0.642,95
lover,0.257,397,4427,1,1,0.881,0.816,0.75,4824
bear,0.256,389,4339,1,1,0.448,0.57,0.475,4728
crow,0.256,29,333,1,1,0.224,0.439,0.363,362
exclude,0.256,14,166,1,1,0.292,0.5,0.53,180
offense,0.255,49,556,1,1,0.23,0.765,0.51,605
godly,0.255,13,155,1,1,0.747,0.298,0.589,168
zoning,0.255,6,77,1,1,0.417,0.4,0.578,83
mosquito,0.255,6,77,1,1,0.229,0.4,0.198,83
baggage,0.254,26,300,1,1,0.61,0.363,0.427,326
respected,0.254,39,445,1,1,0.908,0.441,0.853,484
thin,0.254,90,1014,1,1,0.469,0.337,0.356,1104
indicate,0.254,12,144,1,1,0.594,0.35,0.676,156
determined,0.254,63,713,1,1,0.76,0.528,0.673,776
eldest,0.253,11,133,1,1,0.625,0.471,0.741,144
wayward,0.253,5,66,1,1,0.344,0.573,0.409,71
ceremony,0.253,17,200,1,1,0.76,0.559,0.761,217
rejoicing,0.253,5,66,1,1,0.811,0.637,0.592,71
accounting,0.253,5,66,1,1,0.552,0.39,0.677,71
diversity,0.252,28,323,1,1,0.806,0.472,0.711,351
tragedy,0.252,74,837,1,1,0.052,0.843,0.34,911
royal,0.252,44,502,1,1,0.796,0.43,0.759,546
everlasting,0.252,38,435,1,1,0.74,0.413,0.809,473
letters,0.252,115,1296,1,1,0.663,0.327,0.364,1411
intersection,0.251,10,122,1,1,0.344,0.541,0.658,132
robotic,0.251,10,122,1,1,0.417,0.602,0.657,132
misunderstanding,0.251,21,245,1,1,0.112,0.618,0.284,266
vale,0.251,10,122,1,1,0.592,0.276,0.387,132
alone,0.25,18160,203313,1,1,0.333,0.167,0.216,221473
march,0.25,150,1690,1,1,0.531,0.2,0.483,1840
condescending,0.25,14,167,1,1,0.583,0.363,0.593,181
sweating,0.25,14,167,1,1,0.292,0.667,0.265,181
starfish,0.25,4,55,1,1,0.68,0.32,0.421,59
wreckage,0.25,9,111,1,1,0.082,0.353,0.333,120
forming,0.25,34,391,1,1,0.729,0.343,0.8,425
worn,0.249,52,593,1,1,0.35,0.482,0.189,645
werewolf,0.249,18,212,1,1,0.235,0.811,0.591,230
wide,0.249,155,1748,1,1,0.571,0.312,0.472,1903
trader,0.249,13,156,1,1,0.562,0.632,0.854,169
crowded,0.249,306,3442,1,1,0.694,0.286,0.585,3748
differently,0.248,103,1166,1,1,0.48,0.431,0.506,1269
fluid,0.248,8,100,1,1,0.673,0.407,0.589,108
troublesome,0.248,8,100,1,1,0.283,0.894,0.404,108
respectable,0.248,8,100,1,1,0.85,0.35,0.889,108
transient,0.248,8,100,1,1,0.51,0.405,0.43,108
robin,0.248,53,605,1,1,0.552,0.363,0.393,658
thrown,0.247,86,976,1,1,0.5,0.55,0.619,1062
unused,0.247,12,145,1,1,0.344,0.231,0.234,157
nuclear,0.246,24,280,1,1,0.219,0.856,0.781,304
laptop,0.246,78,887,1,1,0.724,0.27,0.519,965
threatened,0.246,36,415,1,1,0.052,0.928,0.354,451
mature,0.246,126,1427,1,1,0.625,0.347,0.6,1553
surprising,0.246,44,505,1,1,0.888,0.79,0.692,549
truth,0.246,927,10438,1,1,0.971,0.4,0.685,11365
formidable,0.245,3,44,1,1,0.708,0.709,0.857,47
snot,0.245,3,44,1,1,0.214,0.34,0.269,47
diminished,0.245,7,89,1,1,0.156,0.269,0.196,96
footprint,0.245,3,44,1,1,0.592,0.292,0.336,47
marginal,0.245,3,44,1,1,0.235,0.644,0.345,47
rancid,0.245,3,44,1,1,0.156,0.451,0.214,47
crayons,0.245,3,44,1,1,0.684,0.366,0.405,47
pencil,0.245,15,179,1,1,0.552,0.2,0.263,194
envelope,0.245,7,89,1,1,0.604,0.275,0.377,96
ruthless,0.245,15,179,1,1,0.208,0.85,0.67,194
unexplainable,0.245,11,134,1,1,0.26,0.448,0.61,145
fluorescent,0.245,3,44,1,1,0.602,0.595,0.5,47
discreet,0.245,7,89,1,1,0.552,0.216,0.532,96
attendance,0.245,11,134,1,1,0.812,0.5,0.592,145
lore,0.245,15,179,1,1,0.719,0.373,0.768,194
ware,0.245,3,44,1,1,0.604,0.443,0.455,47
passing,0.245,168,1901,1,1,0.458,0.298,0.509,2069
ash,0.245,81,922,1,1,0.26,0.21,0.207,1003
rejoice,0.245,38,438,1,1,0.827,0.65,0.698,476
fold,0.245,30,348,1,1,0.385,0.412,0.33,378
ounce,0.245,26,303,1,1,0.531,0.255,0.288,329
rollercoaster,0.244,22,258,1,1,0.802,0.91,0.651,280
august,0.244,70,799,1,1,0.652,0.292,0.462,869
portion,0.243,32,371,1,1,0.536,0.364,0.398,403
jewelry,0.243,10,123,1,1,0.823,0.569,0.597,133
separate,0.243,149,1690,1,1,0.24,0.514,0.349,1839
lightning,0.243,28,326,1,1,0.429,0.683,0.595,354
equal,0.243,117,1330,1,1,0.781,0.178,0.407,1447
throbbing,0.242,6,78,1,1,0.645,0.808,0.491,84
bold,0.242,55,631,1,1,0.49,0.271,0.483,686
sway,0.242,13,157,1,1,0.69,0.596,0.721,170
overlap,0.242,6,78,1,1,0.594,0.615,0.627,84
idealism,0.242,6,78,1,1,0.635,0.436,0.689,84
clam,0.242,6,78,1,1,0.442,0.302,0.272,84
pester,0.242,6,78,1,1,0.143,0.78,0.385,84
consider,0.242,296,3353,1,1,0.677,0.368,0.579,3649
thrilled,0.241,26,304,1,1,0.898,0.818,0.807,330
tree,0.241,359,4067,1,1,0.67,0.118,0.442,4426
owe,0.241,102,1163,1,1,0.5,0.429,0.386,1265
literal,0.24,71,813,1,1,0.57,0.353,0.574,884
raised,0.24,162,1842,1,1,0.656,0.326,0.643,2004
psychiatric,0.24,12,146,1,1,0.21,0.616,0.525,158
environmental,0.24,12,146,1,1,0.633,0.313,0.664,158
betting,0.24,12,146,1,1,0.237,0.804,0.411,158
sandwich,0.239,52,599,1,1,0.672,0.314,0.31,651
disgust,0.239,27,316,1,1,0.052,0.775,0.317,343
scares,0.239,89,1018,1,1,0.122,0.847,0.386,1107
stamp,0.238,11,135,1,1,0.438,0.327,0.441,146
irregular,0.238,5,67,1,1,0.312,0.548,0.321,72
peck,0.238,5,67,1,1,0.202,0.53,0.321,72
genitalia,0.238,2,33,1,1,0.323,0.667,0.5,35
pedicure,0.238,2,33,1,1,0.695,0.269,0.296,35
experimentation,0.238,2,33,1,1,0.637,0.769,0.767,35
vat,0.238,2,33,1,1,0.333,0.491,0.509,35
audit,0.238,2,33,1,1,0.375,0.562,0.735,35
payroll,0.238,2,33,1,1,0.521,0.36,0.549,35
phenomenal,0.238,20,237,1,1,0.915,0.75,0.918,257
perky,0.238,2,33,1,1,0.896,0.792,0.673,35
meter,0.238,8,101,1,1,0.438,0.3,0.463,109
refute,0.238,2,33,1,1,0.312,0.731,0.583,35
canine,0.238,5,67,1,1,0.573,0.569,0.425,72
opal,0.238,2,33,1,1,0.623,0.479,0.379,35
retort,0.238,2,33,1,1,0.417,0.52,0.481,35
moldy,0.238,2,33,1,1,0.235,0.387,0.25,35
mint,0.238,14,169,1,1,0.688,0.221,0.345,183
cork,0.238,5,67,1,1,0.347,0.25,0.281,72
sellout,0.238,2,33,1,1,0.398,0.49,0.465,35
slum,0.238,2,33,1,1,0.292,0.528,0.302,35
seventy,0.238,2,33,1,1,0.625,0.353,0.446,35
checkers,0.238,2,33,1,1,0.676,0.451,0.437,35
paperwork,0.238,8,101,1,1,0.448,0.355,0.422,109
arduous,0.238,5,67,1,1,0.344,0.783,0.605,72
unborn,0.238,8,101,1,1,0.312,0.3,0.216,109
flamboyant,0.238,2,33,1,1,0.615,0.794,0.705,35
cram,0.238,2,33,1,1,0.354,0.73,0.598,35
mannered,0.238,2,33,1,1,0.469,0.556,0.291,35
powerfully,0.238,5,67,1,1,0.854,0.724,0.935,72
coincide,0.238,2,33,1,1,0.635,0.49,0.593,35
criterion,0.238,2,33,1,1,0.396,0.41,0.736,35
remorse,0.238,20,237,1,1,0.103,0.673,0.377,257
blurt,0.238,2,33,1,1,0.408,0.439,0.441,35
period,0.238,396,4499,1,1,0.396,0.324,0.588,4895
cafe,0.238,97,1110,1,1,0.781,0.392,0.358,1207
opposite,0.237,281,3197,1,1,0.235,0.545,0.408,3478
death,0.237,1247,14162,1,1,0.031,0.72,0.472,15409
recording,0.236,56,646,1,1,0.573,0.537,0.474,702
abbey,0.236,36,419,1,1,0.58,0.367,0.444,455
disturbing,0.236,87,998,1,1,0.146,0.792,0.439,1085
intervention,0.236,16,192,1,1,0.388,0.696,0.689,208
blooming,0.236,27,317,1,1,0.86,0.452,0.593,344
tyrant,0.235,10,124,1,1,0.115,0.85,0.683,134
stance,0.235,21,249,1,1,0.604,0.333,0.609,270
alarming,0.235,10,124,1,1,0.204,0.89,0.585,134
tragedies,0.235,10,124,1,1,0.1,0.91,0.442,134
advantage,0.235,179,2045,1,1,0.917,0.548,0.859,2224
promising,0.235,18,215,1,1,0.791,0.549,0.858,233
smooth,0.235,45,522,1,1,0.823,0.127,0.281,567
heels,0.235,26,306,1,1,0.5,0.439,0.396,332
din,0.235,42,488,1,1,0.44,0.417,0.398,530
overflow,0.234,7,90,1,1,0.398,0.792,0.5,97
tidal,0.234,7,90,1,1,0.592,0.539,0.519,97
decide,0.234,251,2866,1,1,0.656,0.54,0.855,3117
brilliant,0.234,183,2093,1,1,0.939,0.575,0.923,2276
rent,0.234,96,1103,1,1,0.344,0.429,0.446,1199
works,0.233,542,6182,1,1,0.776,0.434,0.657,6724
afford,0.233,163,1867,1,1,0.571,0.58,0.575,2030
excitement,0.233,78,899,1,1,0.896,0.684,0.731,977
knight,0.233,60,694,1,1,0.78,0.441,0.835,754
sour,0.233,32,375,1,1,0.276,0.594,0.373,407
ale,0.232,14,170,1,1,0.53,0.45,0.358,184
nickel,0.232,4,56,1,1,0.51,0.347,0.406,60
reunion,0.232,24,284,1,1,0.837,0.5,0.672,308
impaired,0.232,4,56,1,1,0.13,0.459,0.269,60
dehydration,0.232,4,56,1,1,0.188,0.472,0.259,60
airline,0.232,4,56,1,1,0.65,0.482,0.688,60
stupor,0.232,4,56,1,1,0.323,0.59,0.33,60
individual,0.232,308,3522,1,1,0.627,0.327,0.533,3830
solo,0.231,539,6160,1,1,0.438,0.19,0.325,6699
city,0.231,1123,12828,1,1,0.847,0.531,0.508,13951
familiar,0.231,179,2054,1,1,0.906,0.33,0.615,2233
ten,0.231,183,2100,1,1,0.562,0.26,0.406,2283
variety,0.23,37,433,1,1,0.714,0.472,0.598,470
shield,0.23,53,616,1,1,0.51,0.373,0.663,669
groceries,0.23,20,239,1,1,0.74,0.363,0.417,259
potion,0.23,6,79,1,1,0.5,0.4,0.417,85
inch,0.23,34,399,1,1,0.481,0.327,0.3,433
additional,0.23,20,239,1,1,0.673,0.462,0.526,259
wits,0.23,6,79,1,1,0.76,0.596,0.765,85
scores,0.23,13,159,1,1,0.594,0.469,0.629,172
traps,0.23,20,239,1,1,0.235,0.673,0.481,259
spine,0.229,22,262,1,1,0.495,0.461,0.6,284
divided,0.229,22,262,1,1,0.271,0.623,0.391,284
shadow,0.229,238,2732,1,1,0.302,0.343,0.158,2970
needle,0.229,15,182,1,1,0.25,0.472,0.36,197
violet,0.229,24,285,1,1,0.688,0.272,0.401,309
difference,0.228,712,8159,1,1,0.474,0.56,0.483,8871
baking,0.227,23,274,1,1,0.549,0.455,0.451,297
lord,0.227,650,7460,1,1,0.618,0.327,0.684,8110
classroom,0.226,39,458,1,1,0.539,0.292,0.363,497
statue,0.225,22,263,1,1,0.542,0.153,0.57,285
corporate,0.225,32,378,1,1,0.592,0.454,0.745,410
appear,0.225,139,1607,1,1,0.735,0.506,0.567,1746
giant,0.224,128,1481,1,1,0.646,0.814,0.963,1609
skin,0.224,257,2963,1,1,0.569,0.35,0.395,3220
bonds,0.224,46,539,1,1,0.74,0.472,0.583,585
understood,0.224,265,3056,1,1,0.78,0.441,0.686,3321
mart,0.223,3,45,1,1,0.531,0.402,0.418,48
stylish,0.223,5,68,1,1,0.885,0.49,0.689,73
economics,0.223,9,114,1,1,0.625,0.481,0.632,123
allergy,0.223,5,68,1,1,0.296,0.606,0.389,73
reciprocate,0.223,15,183,1,1,0.76,0.46,0.618,198
disheartening,0.223,13,160,1,1,0.01,0.353,0.224,173
deadbeat,0.223,5,68,1,1,0.229,0.453,0.368,73
denim,0.223,5,68,1,1,0.52,0.382,0.327,73
panicky,0.223,3,45,1,1,0.284,0.962,0.393,48
detailed,0.223,13,160,1,1,0.603,0.314,0.472,173
accommodation,0.223,11,137,1,1,0.817,0.415,0.587,148
freeman,0.223,3,45,1,1,0.823,0.454,0.618,48
smoky,0.223,5,68,1,1,0.459,0.42,0.327,73
tang,0.223,5,68,1,1,0.594,0.383,0.34,73
backside,0.223,3,45,1,1,0.182,0.417,0.342,48
outlandish,0.223,3,45,1,1,0.448,0.737,0.657,48
maiden,0.223,25,298,1,1,0.755,0.396,0.461,323
usage,0.223,13,160,1,1,0.646,0.36,0.426,173
precarious,0.223,5,68,1,1,0.107,0.54,0.273,73
continuously,0.223,35,413,1,1,0.719,0.417,0.702,448
unsuspecting,0.223,7,91,1,1,0.302,0.509,0.413,98
unhelpful,0.223,3,45,1,1,0.104,0.32,0.118,48
yacht,0.223,7,91,1,1,0.823,0.67,0.66,98
entertainment,0.223,118,1368,1,1,0.847,0.75,0.569,1486
purpose,0.223,412,4752,1,1,0.8,0.534,0.782,5164
context,0.222,77,897,1,1,0.531,0.3,0.553,974
spell,0.222,82,955,1,1,0.385,0.38,0.368,1037
slip,0.222,76,886,1,1,0.316,0.714,0.321,962
item,0.222,24,287,1,1,0.594,0.27,0.465,311
supply,0.222,49,575,1,1,0.708,0.519,0.603,624
parking,0.222,72,840,1,1,0.777,0.469,0.51,912
sneak,0.222,47,552,1,1,0.281,0.745,0.449,599
backwards,0.222,47,552,1,1,0.302,0.372,0.33,599
exist,0.221,471,5438,1,1,0.857,0.421,0.788,5909
deception,0.221,20,241,1,1,0.09,0.745,0.37,261
cafeteria,0.221,16,195,1,1,0.757,0.4,0.382,211
departure,0.221,16,195,1,1,0.573,0.5,0.426,211
insane,0.221,207,2398,1,1,0.062,0.67,0.265,2605
connection,0.22,452,5224,1,1,0.729,0.56,0.655,5676
wretched,0.22,25,299,1,1,0.135,0.56,0.19,324
doubts,0.22,49,576,1,1,0.306,0.448,0.305,625
widespread,0.219,10,126,1,1,0.633,0.456,0.713,136
loft,0.219,10,126,1,1,0.51,0.378,0.343,136
explorer,0.219,10,126,1,1,0.729,0.663,0.714,136
distorted,0.219,10,126,1,1,0.25,0.521,0.28,136
dreadful,0.219,35,415,1,1,0.092,0.786,0.348,450
denying,0.219,26,311,1,1,0.08,0.542,0.272,337
cross,0.218,182,2114,1,1,0.448,0.321,0.569,2296
fancy,0.218,112,1305,1,1,0.854,0.673,0.534,1417
wizard,0.218,42,496,1,1,0.656,0.43,0.526,538
voice,0.218,994,11503,1,1,0.594,0.343,0.528,12497
commitment,0.218,93,1086,1,1,0.714,0.71,0.843,1179
laughter,0.218,160,1861,1,1,0.959,0.654,0.588,2021
time,0.218,16956,196138,1,1,0.604,0.288,0.609,213094
perform,0.218,80,936,1,1,0.765,0.555,0.773,1016
adoring,0.217,6,80,1,1,0.885,0.62,0.717,86
profitable,0.217,6,80,1,1,0.87,0.392,0.736,86
entertainer,0.217,6,80,1,1,0.888,0.709,0.759,86
offender,0.217,6,80,1,1,0.104,0.851,0.537,86
seat,0.216,161,1875,1,1,0.542,0.281,0.434,2036
greeting,0.216,23,277,1,1,0.854,0.556,0.51,300
incurable,0.216,11,138,1,1,0.104,0.667,0.255,149
fragile,0.216,96,1123,1,1,0.302,0.163,0.126,1219
committee,0.216,16,196,1,1,0.592,0.392,0.721,212
drum,0.216,33,393,1,1,0.615,0.679,0.339,426
gorgeous,0.216,158,1842,1,1,0.92,0.56,0.741,2000
fulfilled,0.215,56,660,1,1,0.896,0.48,0.676,716
fly,0.215,275,3200,1,1,0.76,0.775,0.676,3475
carton,0.215,4,57,1,1,0.286,0.186,0.241,61
primary,0.215,44,521,1,1,0.562,0.39,0.545,565
bender,0.215,4,57,1,1,0.49,0.51,0.466,61
wager,0.215,4,57,1,1,0.479,0.816,0.615,61
clink,0.215,4,57,1,1,0.458,0.462,0.319,61
absorption,0.215,4,57,1,1,0.609,0.422,0.446,61
reasonable,0.214,32,382,1,1,0.902,0.337,0.726,414
lifestyle,0.214,135,1578,1,1,0.75,0.472,0.645,1713
mediocrity,0.214,17,208,1,1,0.073,0.398,0.225,225
commit,0.214,126,1474,1,1,0.365,0.529,0.491,1600
quickly,0.213,231,2695,1,1,0.784,0.85,0.636,2926
nightmare,0.213,118,1382,1,1,0.005,0.81,0.436,1500
defense,0.213,55,650,1,1,0.652,0.698,0.802,705
inferior,0.212,18,220,1,1,0.26,0.254,0.106,238
narrative,0.212,70,825,1,1,0.58,0.303,0.443,895
acutely,0.212,10,127,1,1,0.417,0.543,0.491,137
salon,0.212,10,127,1,1,0.531,0.296,0.463,137
mushy,0.212,10,127,1,1,0.52,0.2,0.182,137
resemble,0.211,13,162,1,1,0.602,0.388,0.463,175
disappear,0.211,228,2666,1,1,0.143,0.441,0.35,2894
weighing,0.211,16,197,1,1,0.449,0.441,0.468,213
incredible,0.21,197,2307,1,1,0.857,0.796,0.902,2504
draw,0.209,220,2577,1,1,0.704,0.449,0.481,2797
handicapped,0.209,5,69,1,1,0.204,0.467,0.18,74
moose,0.209,14,174,1,1,0.648,0.373,0.318,188
indebted,0.209,2,34,1,1,0.138,0.698,0.275,36
educator,0.209,2,34,1,1,0.827,0.317,0.845,36
cad,0.209,2,34,1,1,0.447,0.406,0.404,36
catapult,0.209,2,34,1,1,0.48,0.83,0.649,36
feverish,0.209,2,34,1,1,0.385,0.696,0.436,36
bamboo,0.209,5,69,1,1,0.646,0.222,0.356,74
tentacle,0.209,2,34,1,1,0.37,0.559,0.398,36
rabid,0.209,8,104,1,1,0.089,0.827,0.454,112
famine,0.209,5,69,1,1,0.163,0.679,0.31,74
rendition,0.209,11,139,1,1,0.417,0.36,0.398,150
tobacco,0.209,5,69,1,1,0.327,0.546,0.387,74
partridge,0.209,2,34,1,1,0.583,0.415,0.25,36
jovial,0.209,2,34,1,1,0.823,0.46,0.526,36
predictor,0.209,2,34,1,1,0.646,0.615,0.738,36
lorry,0.209,2,34,1,1,0.521,0.481,0.402,36
average,0.209,90,1061,1,1,0.684,0.28,0.455,1151
social,0.208,2543,29720,1,1,0.806,0.37,0.614,32263
mute,0.207,63,747,1,1,0.271,0.2,0.25,810
physics,0.207,15,186,1,1,0.582,0.415,0.664,201
lobster,0.207,12,151,1,1,0.571,0.356,0.291,163
rehab,0.207,22,268,1,1,0.531,0.45,0.593,290
possibly,0.206,214,2514,1,1,0.448,0.4,0.5,2728
gold,0.206,188,2210,1,1,0.939,0.686,0.692,2398
heel,0.206,9,116,1,1,0.48,0.35,0.385,125
budget,0.206,29,350,1,1,0.643,0.396,0.731,379
helicopter,0.206,9,116,1,1,0.714,0.806,0.617,125
diminish,0.206,9,116,1,1,0.24,0.357,0.167,125
proper,0.206,153,1801,1,1,0.796,0.312,0.757,1954
current,0.206,262,3077,1,1,0.625,0.312,0.612,3339
decade,0.206,74,877,1,1,0.531,0.402,0.665,951
goods,0.205,23,280,1,1,0.888,0.396,0.726,303
woe,0.205,23,280,1,1,0.34,0.606,0.204,303
journey,0.205,744,8724,1,1,0.91,0.702,0.625,9468
allowed,0.205,310,3642,1,1,0.73,0.36,0.655,3952
soothe,0.205,34,409,1,1,0.817,0.194,0.412,443
sliver,0.205,6,81,1,1,0.388,0.347,0.291,87
leftover,0.205,13,163,1,1,0.49,0.46,0.222,176
bewildered,0.205,6,81,1,1,0.23,0.63,0.3,87
sketchy,0.205,6,81,1,1,0.333,0.479,0.241,87
literacy,0.205,6,81,1,1,0.73,0.306,0.638,87
john,0.205,393,4616,1,1,0.562,0.382,0.327,5009
stealing,0.204,49,585,1,1,0.086,0.913,0.455,634
unavoidable,0.204,17,210,1,1,0.35,0.58,0.445,227
enlighten,0.204,10,128,1,1,0.729,0.549,0.667,138
guardian,0.204,69,820,1,1,0.656,0.686,0.789,889
national,0.204,235,2767,1,1,0.698,0.365,0.663,3002
rain,0.203,726,8532,1,1,0.542,0.388,0.33,9258
dust,0.203,114,1349,1,1,0.344,0.246,0.241,1463
pad,0.203,22,269,1,1,0.684,0.279,0.33,291
amen,0.202,116,1373,1,1,0.781,0.182,0.542,1489
figure,0.202,438,5155,1,1,0.688,0.328,0.509,5593
rage,0.202,129,1526,1,1,0.082,0.888,0.658,1655
accept,0.202,577,6790,1,1,0.847,0.286,0.565,7367
doubled,0.202,7,93,1,1,0.427,0.536,0.56,100
lobe,0.202,3,46,1,1,0.459,0.364,0.352,49
humanities,0.202,3,46,1,1,0.729,0.325,0.677,49
notoriety,0.202,3,46,1,1,0.552,0.633,0.769,49
doubling,0.202,3,46,1,1,0.459,0.452,0.464,49
muscle,0.202,19,234,1,1,0.359,0.49,0.645,253
mope,0.202,7,93,1,1,0.406,0.309,0.345,100
autograph,0.202,3,46,1,1,0.735,0.565,0.473,49
seriousness,0.202,19,234,1,1,0.439,0.365,0.75,253
marks,0.202,47,563,1,1,0.43,0.48,0.424,610
inauguration,0.202,3,46,1,1,0.847,0.712,0.769,49
pardon,0.202,19,234,1,1,0.552,0.413,0.542,253
pronounced,0.202,7,93,1,1,0.67,0.551,0.694,100
silicon,0.202,3,46,1,1,0.439,0.448,0.445,49
asteroid,0.202,7,93,1,1,0.43,0.721,0.623,100
touchdown,0.202,3,46,1,1,0.667,0.77,0.586,49
electoral,0.202,3,46,1,1,0.49,0.631,0.602,49
appreciated,0.202,174,2056,1,1,0.91,0.434,0.779,2230
relieved,0.201,44,528,1,1,0.896,0.314,0.391,572
net,0.201,44,528,1,1,0.441,0.288,0.417,572
roads,0.201,134,1586,1,1,0.677,0.448,0.496,1720
sketch,0.201,28,340,1,1,0.704,0.276,0.42,368
complaint,0.201,20,246,1,1,0.143,0.606,0.281,266
stark,0.201,41,493,1,1,0.33,0.63,0.577,534
employment,0.201,16,199,1,1,0.75,0.594,0.611,215
mocked,0.201,16,199,1,1,0.225,0.746,0.204,215
moods,0.201,67,799,1,1,0.578,0.633,0.491,866
spoken,0.2,107,1270,1,1,0.551,0.363,0.545,1377
pair,0.2,116,1376,1,1,0.552,0.317,0.304,1492
confession,0.2,43,517,1,1,0.469,0.642,0.46,560
strange,0.2,399,4710,1,1,0.314,0.663,0.395,5109
credible,0.2,8,105,1,1,0.917,0.441,0.75,113
hygiene,0.2,8,105,1,1,0.781,0.287,0.537,113
nursery,0.2,8,105,1,1,0.894,0.406,0.389,113
feeble,0.2,8,105,1,1,0.157,0.28,0.109,113
availability,0.2,8,105,1,1,0.796,0.544,0.6,113
lesser,0.2,26,317,1,1,0.396,0.167,0.211,343
alley,0.199,31,376,1,1,0.347,0.5,0.355,407
freelance,0.199,18,223,1,1,0.833,0.577,0.736,241
week,0.198,1941,22897,1,1,0.51,0.231,0.351,24838
scolding,0.198,4,58,1,1,0.071,0.833,0.417,62
wade,0.198,14,176,1,1,0.51,0.656,0.472,190
downward,0.198,14,176,1,1,0.188,0.347,0.255,190
destruct,0.198,4,58,1,1,0.071,0.868,0.525,62
atrocious,0.198,4,58,1,1,0.073,0.811,0.445,62
coverage,0.198,19,235,1,1,0.767,0.413,0.629,254
appoint,0.198,4,58,1,1,0.565,0.33,0.509,62
nutty,0.198,4,58,1,1,0.444,0.317,0.271,62
disgraceful,0.198,14,176,1,1,0.082,0.702,0.24,190
include,0.198,140,1663,1,1,0.729,0.449,0.702,1803
parts,0.198,196,2324,1,1,0.459,0.327,0.392,2520
editor,0.197,20,247,1,1,0.772,0.431,0.673,267
uncertainty,0.197,57,684,1,1,0.064,0.494,0.282,741
matrix,0.197,15,188,1,1,0.551,0.378,0.673,203
stack,0.196,27,330,1,1,0.47,0.282,0.427,357
settled,0.196,61,732,1,1,0.521,0.51,0.473,793
narrator,0.196,16,200,1,1,0.673,0.43,0.623,216
things,0.195,4853,57436,1,1,0.519,0.25,0.368,62289
disheartened,0.195,5,70,1,1,0.153,0.343,0.238,75
extract,0.195,5,70,1,1,0.565,0.402,0.519,75
swine,0.195,5,70,1,1,0.34,0.519,0.277,75
orbs,0.195,5,70,1,1,0.469,0.355,0.482,75
overpriced,0.195,5,70,1,1,0.271,0.556,0.472,75
daycare,0.195,11,141,1,1,0.776,0.481,0.36,152
dynamite,0.195,5,70,1,1,0.344,0.86,0.783,75
shaggy,0.195,5,70,1,1,0.51,0.302,0.321,75
insular,0.195,5,70,1,1,0.531,0.426,0.465,75
nervousness,0.195,5,70,1,1,0.163,0.915,0.241,75
goon,0.195,5,70,1,1,0.312,0.481,0.361,75
survive,0.195,326,3869,1,1,0.77,0.824,0.726,4195
term,0.195,176,2094,1,1,0.45,0.255,0.598,2270
beacon,0.194,18,224,1,1,0.58,0.407,0.537,242
assistance,0.194,31,378,1,1,0.656,0.519,0.633,409
solution,0.194,200,2380,1,1,0.79,0.339,0.664,2580
selfless,0.194,25,307,1,1,0.521,0.235,0.396,332
certified,0.194,12,153,1,1,0.781,0.422,0.806,165
western,0.193,74,888,1,1,0.573,0.5,0.689,962
vigil,0.193,13,165,1,1,0.521,0.48,0.491,178
motive,0.193,13,165,1,1,0.667,0.588,0.663,178
bruise,0.193,6,82,1,1,0.133,0.64,0.474,88
jazzy,0.193,6,82,1,1,0.725,0.431,0.389,88
summons,0.193,6,82,1,1,0.552,0.604,0.598,88
humanitarian,0.193,6,82,1,1,0.786,0.317,0.709,88
tortoise,0.193,6,82,1,1,0.673,0.078,0.25,88
wall,0.192,353,4198,1,1,0.417,0.25,0.509,4551
toast,0.192,43,521,1,1,0.74,0.382,0.356,564
mingle,0.192,43,521,1,1,0.561,0.48,0.434,564
phobia,0.192,14,177,1,1,0.173,0.904,0.291,191
bereft,0.192,14,177,1,1,0.229,0.49,0.336,191
engineering,0.192,14,177,1,1,0.735,0.471,0.836,191
meal,0.192,139,1661,1,1,0.833,0.461,0.473,1800
decision,0.191,214,2552,1,1,0.646,0.51,0.839,2766
resident,0.191,31,379,1,1,0.592,0.327,0.5,410
slate,0.191,7,94,1,1,0.531,0.283,0.431,101
rebels,0.191,7,94,1,1,0.135,0.86,0.609,101
ridicule,0.191,15,189,1,1,0.143,0.745,0.255,204
bakery,0.191,7,94,1,1,0.802,0.5,0.38,101
mug,0.191,31,379,1,1,0.542,0.214,0.382,410
rhyme,0.191,16,201,1,1,0.667,0.249,0.481,217
compare,0.19,69,831,1,1,0.552,0.408,0.524,900
sham,0.19,8,106,1,1,0.354,0.602,0.395,114
persist,0.19,8,106,1,1,0.765,0.644,0.727,114
six,0.19,166,1985,1,1,0.5,0.154,0.271,2151
square,0.19,75,903,1,1,0.509,0.34,0.291,978
mixture,0.189,29,356,1,1,0.546,0.36,0.481,385
lecture,0.189,30,368,1,1,0.594,0.462,0.737,398
hardship,0.188,32,392,1,1,0.094,0.775,0.482,424
seminar,0.188,10,130,1,1,0.583,0.36,0.623,140
spicy,0.188,21,261,1,1,0.44,0.733,0.61,282
endeavor,0.188,22,273,1,1,0.677,0.755,0.765,295
faith,0.188,376,4493,1,1,0.833,0.22,0.763,4869
sink,0.187,103,1239,1,1,0.375,0.439,0.322,1342
simulation,0.187,12,154,1,1,0.552,0.574,0.567,166
fuss,0.187,12,154,1,1,0.406,0.876,0.48,166
repay,0.187,12,154,1,1,0.469,0.632,0.592,166
frosty,0.187,12,154,1,1,0.427,0.48,0.381,166
boards,0.187,13,166,1,1,0.469,0.27,0.524,179
tick,0.187,28,345,1,1,0.521,0.386,0.412,373
heat,0.186,119,1431,1,1,0.534,0.612,0.433,1550
set,0.186,732,8748,1,1,0.521,0.482,0.63,9480
favor,0.186,95,1145,1,1,0.812,0.308,0.519,1240
gratification,0.186,16,202,1,1,0.867,0.643,0.755,218
leather,0.186,17,214,1,1,0.51,0.324,0.341,231
stand,0.185,896,10715,1,1,0.6,0.324,0.509,11611
evil,0.185,327,3918,1,1,0.04,0.827,0.545,4245
fall,0.185,1387,16585,1,1,0.177,0.657,0.221,17972
elephant,0.185,62,752,1,1,0.531,0.51,0.615,814
semi,0.184,27,334,1,1,0.296,0.345,0.304,361
different,0.183,1994,23880,1,1,0.612,0.394,0.473,25874
awe,0.183,68,825,1,1,0.469,0.74,0.3,893
appointment,0.183,35,430,1,1,0.688,0.594,0.547,465
awesome,0.183,374,4490,1,1,0.98,0.897,0.891,4864
work,0.182,4244,50867,1,1,0.719,0.596,0.75,55111
mob,0.182,67,814,1,1,0.296,0.788,0.567,881
multiply,0.181,6,83,1,1,0.802,0.625,0.777,89
transitional,0.181,2,35,1,1,0.573,0.472,0.491,37
collie,0.181,2,35,1,1,0.562,0.308,0.328,37
accusation,0.181,5,71,1,1,0.073,0.718,0.564,76
negotiate,0.181,7,95,1,1,0.612,0.708,0.769,102
sting,0.181,29,359,1,1,0.163,0.651,0.373,388
pronunciation,0.181,2,35,1,1,0.531,0.431,0.588,37
cloth,0.181,9,119,1,1,0.51,0.19,0.287,128
huddle,0.181,3,47,1,1,0.604,0.509,0.445,50
toothbrush,0.181,5,71,1,1,0.517,0.33,0.321,76
brake,0.181,5,71,1,1,0.312,0.481,0.31,76
investigator,0.181,2,35,1,1,0.615,0.509,0.779,37
unsettled,0.181,6,83,1,1,0.208,0.647,0.17,89
dictate,0.181,16,203,1,1,0.48,0.423,0.668,219
psychosis,0.181,9,119,1,1,0.167,0.859,0.312,128
drawers,0.181,3,47,1,1,0.539,0.26,0.236,50
talon,0.181,2,35,1,1,0.344,0.569,0.475,37
cereal,0.181,18,227,1,1,0.612,0.206,0.316,245
snuff,0.181,4,59,1,1,0.357,0.47,0.377,63
saliva,0.181,2,35,1,1,0.214,0.265,0.236,37
commuter,0.181,4,59,1,1,0.646,0.52,0.512,63
bidding,0.181,5,71,1,1,0.586,0.644,0.509,76
removal,0.181,5,71,1,1,0.245,0.54,0.368,76
advised,0.181,8,107,1,1,0.823,0.33,0.509,115
inflation,0.181,3,47,1,1,0.219,0.792,0.508,50
showcase,0.181,14,179,1,1,0.521,0.255,0.415,193
refusing,0.181,24,299,1,1,0.143,0.67,0.203,323
dud,0.181,3,47,1,1,0.167,0.455,0.246,50
hypocritical,0.181,15,191,1,1,0.048,0.74,0.415,206
overtaken,0.181,2,35,1,1,0.594,0.552,0.702,37
frowning,0.181,6,83,1,1,0.194,0.582,0.5,89
physician,0.181,5,71,1,1,0.583,0.49,0.843,76
defective,0.181,4,59,1,1,0.122,0.58,0.274,63
wasteful,0.181,2,35,1,1,0.173,0.73,0.409,37
sinful,0.181,10,131,1,1,0.143,0.788,0.417,141
euphoria,0.181,28,347,1,1,0.769,0.955,0.648,375
cloning,0.181,2,35,1,1,0.216,0.696,0.679,37
clearance,0.181,5,71,1,1,0.542,0.459,0.473,76
retaliation,0.181,2,35,1,1,0.156,0.812,0.491,37
horrendous,0.181,16,203,1,1,0.073,0.755,0.365,219
oddity,0.181,2,35,1,1,0.312,0.557,0.386,37
adviser,0.181,3,47,1,1,0.745,0.362,0.705,50
bedside,0.181,5,71,1,1,0.604,0.167,0.375,76
mistress,0.181,35,431,1,1,0.63,0.796,0.694,466
precedent,0.181,2,35,1,1,0.574,0.392,0.721,37
putrid,0.181,3,47,1,1,0.146,0.62,0.385,50
uninvited,0.181,7,95,1,1,0.09,0.385,0.307,102
weakly,0.181,2,35,1,1,0.27,0.255,0.111,37
amusing,0.181,20,251,1,1,0.96,0.829,0.632,271
eavesdropping,0.181,2,35,1,1,0.49,0.38,0.441,37
shitless,0.181,3,47,1,1,0.271,0.545,0.333,50
den,0.181,48,587,1,1,0.51,0.347,0.398,635
specter,0.181,3,47,1,1,0.265,0.723,0.54,50
surge,0.181,12,155,1,1,0.449,0.684,0.5,167
imminent,0.181,7,95,1,1,0.49,0.784,0.643,102
teammate,0.181,7,95,1,1,0.865,0.449,0.66,102
federation,0.181,3,47,1,1,0.633,0.354,0.763,50
fashionable,0.181,4,59,1,1,0.75,0.51,0.605,63
pip,0.181,6,83,1,1,0.448,0.43,0.366,89
teacher,0.18,159,1921,1,1,0.76,0.404,0.885,2080
disappointing,0.179,48,588,1,1,0.073,0.64,0.2,636
meaningful,0.179,140,1694,1,1,0.77,0.5,0.802,1834
similar,0.179,263,3173,1,1,0.562,0.25,0.423,3436
spill,0.178,33,408,1,1,0.408,0.633,0.456,441
trailer,0.178,52,637,1,1,0.541,0.49,0.473,689
regular,0.177,165,1998,1,1,0.435,0.188,0.558,2163
heartfelt,0.177,22,276,1,1,0.904,0.44,0.54,298
odd,0.177,180,2179,1,1,0.265,0.337,0.302,2359
cognitive,0.177,19,240,1,1,0.513,0.401,0.634,259
witch,0.176,87,1060,1,1,0.292,0.71,0.473,1147
vibe,0.176,230,2785,1,1,0.71,0.48,0.517,3015
example,0.176,189,2291,1,1,0.542,0.337,0.51,2480
ducking,0.175,14,180,1,1,0.344,0.573,0.294,194
dump,0.175,42,518,1,1,0.345,0.5,0.37,560
sloth,0.175,13,168,1,1,0.198,0.14,0.125,181
amazing,0.175,1095,13234,1,1,0.906,0.837,0.849,14329
bundle,0.174,12,156,1,1,0.51,0.343,0.434,168
comp,0.174,12,156,1,1,0.573,0.45,0.371,168
invalid,0.174,11,144,1,1,0.18,0.33,0.255,155
rewrite,0.174,11,144,1,1,0.49,0.5,0.434,155
extinction,0.174,11,144,1,1,0.104,0.75,0.611,155
poker,0.173,10,132,1,1,0.48,0.689,0.398,142
assumption,0.173,20,253,1,1,0.479,0.431,0.417,273
stars,0.173,560,6785,1,1,0.796,0.521,0.484,7345
nag,0.173,19,241,1,1,0.271,0.451,0.472,260
shred,0.173,9,120,1,1,0.224,0.75,0.627,129
audience,0.172,96,1173,1,1,0.698,0.61,0.613,1269
niche,0.172,18,229,1,1,0.459,0.413,0.318,247
eager,0.172,37,459,1,1,0.521,0.812,0.306,496
spark,0.172,64,786,1,1,0.688,0.745,0.529,850
browse,0.172,8,108,1,1,0.635,0.75,0.592,116
mistrust,0.172,8,108,1,1,0.135,0.657,0.231,116
likelihood,0.172,8,108,1,1,0.76,0.469,0.542,116
stir,0.171,24,302,1,1,0.448,0.773,0.453,326
hurricane,0.171,24,302,1,1,0.177,0.958,0.787,326
barren,0.171,40,496,1,1,0.173,0.373,0.221,536
refusal,0.171,7,96,1,1,0.052,0.61,0.321,103
suburban,0.171,15,193,1,1,0.439,0.45,0.453,208
mascot,0.171,7,96,1,1,0.75,0.337,0.337,103
crime,0.171,143,1745,1,1,0.071,0.943,0.63,1888
understand,0.17,2108,25573,1,1,0.76,0.374,0.643,27681
bat,0.17,53,654,1,1,0.324,0.409,0.48,707
scream,0.17,197,2401,1,1,0.188,0.863,0.594,2598
artists,0.17,150,1831,1,1,0.796,0.667,0.741,1981
rear,0.17,14,181,1,1,0.459,0.52,0.284,195
acquaintance,0.17,14,181,1,1,0.656,0.29,0.67,195
fabric,0.17,14,181,1,1,0.635,0.19,0.345,195
rule,0.17,117,1431,1,1,0.567,0.427,0.593,1548
timing,0.17,43,533,1,1,0.521,0.311,0.577,576
christ,0.169,220,2682,1,1,0.781,0.51,0.75,2902
meteor,0.169,6,84,1,1,0.398,0.714,0.737,90
apathetic,0.169,13,169,1,1,0.188,0.292,0.333,182
allot,0.169,6,84,1,1,0.622,0.481,0.616,90
hierarchy,0.169,6,84,1,1,0.583,0.722,0.902,90
prog,0.169,6,84,1,1,0.448,0.412,0.397,90
insightful,0.168,19,242,1,1,0.664,0.691,0.713,261
happily,0.168,155,1895,1,1,1,0.69,0.674,2050
shattered,0.168,57,704,1,1,0.097,0.806,0.309,761
fear,0.168,1466,17834,1,1,0.073,0.84,0.293,19300
temporarily,0.167,42,522,1,1,0.5,0.365,0.373,564
month,0.167,719,8758,1,1,0.688,0.255,0.411,9477
depicting,0.167,5,72,1,1,0.49,0.566,0.602,77
flight,0.167,131,1605,1,1,0.646,0.63,0.587,1736
mire,0.167,5,72,1,1,0.344,0.376,0.298,77
orc,0.167,5,72,1,1,0.24,0.51,0.388,77
confidant,0.167,5,72,1,1,0.837,0.633,0.631,77
plane,0.167,83,1021,1,1,0.51,0.356,0.386,1104
spray,0.167,17,218,1,1,0.438,0.41,0.333,235
patriarchal,0.167,5,72,1,1,0.531,0.5,0.857,77
unattended,0.167,5,72,1,1,0.255,0.4,0.167,77
treason,0.167,11,145,1,1,0.094,0.806,0.552,156
duchess,0.167,5,72,1,1,0.656,0.548,0.711,77
recall,0.166,56,693,1,1,0.583,0.351,0.525,749
cinema,0.166,71,876,1,1,0.698,0.538,0.5,947
repeated,0.166,21,267,1,1,0.429,0.472,0.314,288
peek,0.165,15,194,1,1,0.486,0.36,0.411,209
gesture,0.165,31,389,1,1,0.667,0.481,0.427,420
homemade,0.165,15,194,1,1,0.869,0.34,0.398,209
gifts,0.165,126,1548,1,1,0.865,0.755,0.509,1674
avail,0.164,9,121,1,1,0.8,0.43,0.603,130
knuckle,0.164,4,60,1,1,0.655,0.333,0.393,64
bumper,0.164,4,60,1,1,0.385,0.573,0.518,64
sandbox,0.164,4,60,1,1,0.573,0.274,0.264,64
hindering,0.164,4,60,1,1,0.26,0.654,0.435,64
unforgivable,0.164,4,60,1,1,0.276,0.743,0.49,64
suspicions,0.164,4,60,1,1,0.208,0.745,0.5,64
unofficial,0.164,4,60,1,1,0.26,0.302,0.255,64
resist,0.164,58,719,1,1,0.414,0.676,0.651,777
serious,0.164,438,5357,1,1,0.5,0.455,0.619,5795
downright,0.163,13,170,1,1,0.625,0.454,0.679,183
guide,0.163,171,2101,1,1,0.688,0.315,0.62,2272
pool,0.163,103,1270,1,1,0.625,0.356,0.598,1373
forbid,0.163,17,219,1,1,0.115,0.686,0.598,236
stunted,0.163,8,109,1,1,0.194,0.472,0.275,117
triple,0.163,26,329,1,1,0.585,0.385,0.481,355
reel,0.163,8,109,1,1,0.449,0.332,0.395,117
invisible,0.163,143,1759,1,1,0.417,0.345,0.412,1902
temperature,0.163,17,219,1,1,0.521,0.559,0.473,236
railway,0.163,8,109,1,1,0.613,0.615,0.623,117
humorous,0.163,8,109,1,1,0.906,0.616,0.665,117
mold,0.163,17,219,1,1,0.33,0.274,0.402,236
genuine,0.162,222,2725,1,1,0.875,0.45,0.685,2947
visible,0.162,38,476,1,1,0.75,0.342,0.509,514
exclusive,0.162,46,574,1,1,0.792,0.63,0.653,620
scale,0.162,63,782,1,1,0.31,0.35,0.577,845
layer,0.161,16,207,1,1,0.5,0.208,0.366,223
sweat,0.161,54,672,1,1,0.388,0.579,0.297,726
assumed,0.161,37,464,1,1,0.612,0.247,0.454,501
repeatedly,0.161,37,464,1,1,0.479,0.575,0.5,501
delinquent,0.16,3,48,1,1,0.051,0.904,0.5,51
locker,0.16,11,146,1,1,0.439,0.3,0.393,157
boarding,0.16,19,244,1,1,0.531,0.402,0.534,263
shading,0.16,3,48,1,1,0.42,0.324,0.318,51
daredevil,0.16,3,48,1,1,0.429,0.714,0.653,51
caliber,0.16,3,48,1,1,0.429,0.551,0.606,51
subtext,0.16,3,48,1,1,0.635,0.276,0.412,51
handle,0.16,399,4899,1,1,0.698,0.571,0.558,5298
ninth,0.16,3,48,1,1,0.49,0.212,0.396,51
graph,0.16,3,48,1,1,0.51,0.286,0.621,51
classify,0.16,3,48,1,1,0.646,0.411,0.72,51
accountant,0.16,3,48,1,1,0.625,0.45,0.639,51
futon,0.16,3,48,1,1,0.429,0.351,0.343,51
asphalt,0.16,3,48,1,1,0.479,0.264,0.439,51
stairway,0.16,7,97,1,1,0.562,0.51,0.407,104
handicap,0.16,3,48,1,1,0.133,0.394,0.264,51
particle,0.16,3,48,1,1,0.521,0.265,0.438,51
chlorine,0.16,3,48,1,1,0.306,0.327,0.332,51
coal,0.16,15,195,1,1,0.36,0.241,0.34,210
raven,0.16,35,440,1,1,0.479,0.446,0.426,475
stalls,0.16,3,48,1,1,0.582,0.378,0.451,51
weekend,0.16,1079,13238,1,1,0.844,0.625,0.519,14317
impending,0.159,22,281,1,1,0.48,0.735,0.752,303
believing,0.159,116,1434,1,1,0.87,0.418,0.833,1550
melody,0.159,63,784,1,1,0.847,0.434,0.405,847
vineyard,0.159,14,183,1,1,0.806,0.382,0.595,197
riff,0.158,10,134,1,1,0.521,0.551,0.343,144
savage,0.158,54,674,1,1,0.204,0.931,0.605,728
aesthetics,0.158,10,134,1,1,0.847,0.327,0.549,144
guilty,0.158,171,2111,1,1,0.135,0.77,0.352,2282
changing,0.158,160,1976,1,1,0.571,0.569,0.461,2136
suggest,0.157,125,1547,1,1,0.573,0.471,0.517,1672
retards,0.157,6,85,1,1,0.362,0.434,0.218,91
gust,0.157,6,85,1,1,0.49,0.755,0.556,91
slit,0.157,6,85,1,1,0.406,0.49,0.366,91
plenty,0.157,236,2912,1,1,0.827,0.612,0.824,3148
finally,0.157,1260,15500,1,1,0.583,0.433,0.465,16760
inspirational,0.156,29,368,1,1,0.927,0.72,0.81,397
warming,0.155,41,516,1,1,0.594,0.637,0.58,557
gym,0.155,257,3175,1,1,0.635,0.69,0.613,3432
conference,0.155,76,947,1,1,0.688,0.615,0.606,1023
longing,0.154,254,3141,1,1,0.604,0.434,0.56,3395
lark,0.153,2,36,1,1,0.57,0.292,0.352,38
defensive,0.153,17,221,1,1,0.542,0.64,0.678,238
infamous,0.153,8,110,1,1,0.146,0.58,0.472,118
doctorate,0.153,2,36,1,1,0.776,0.479,0.841,38
inconsistent,0.153,8,110,1,1,0.271,0.431,0.295,118
spur,0.153,11,147,1,1,0.378,0.545,0.34,158
cautionary,0.153,2,36,1,1,0.51,0.541,0.519,38
corrosive,0.153,2,36,1,1,0.14,0.618,0.57,38
unsteady,0.153,2,36,1,1,0.122,0.5,0.19,38
gallon,0.153,5,73,1,1,0.531,0.327,0.345,78
incubus,0.153,2,36,1,1,0.458,0.529,0.482,38
drape,0.153,2,36,1,1,0.417,0.439,0.404,38
ballet,0.153,8,110,1,1,0.656,0.48,0.358,118
tack,0.153,2,36,1,1,0.365,0.431,0.431,38
oversight,0.153,2,36,1,1,0.385,0.618,0.723,38
lumberjack,0.153,2,36,1,1,0.5,0.66,0.726,38
broker,0.153,2,36,1,1,0.582,0.462,0.6,38
lagging,0.153,2,36,1,1,0.135,0.538,0.277,38
rationality,0.153,2,36,1,1,0.633,0.51,0.767,38
odds,0.153,34,431,1,1,0.5,0.472,0.68,465
brow,0.152,16,209,1,1,0.562,0.311,0.481,225
bubbly,0.152,16,209,1,1,0.698,0.608,0.462,225
limbo,0.152,16,209,1,1,0.385,0.284,0.309,225
heated,0.152,13,172,1,1,0.479,0.497,0.542,185
bollocks,0.152,13,172,1,1,0.448,0.471,0.327,185
wed,0.152,13,172,1,1,0.604,0.549,0.448,185
resources,0.151,57,716,1,1,0.604,0.348,0.627,773
hyper,0.151,29,370,1,1,0.542,0.616,0.64,399
kin,0.151,18,234,1,1,0.543,0.441,0.457,252
unkind,0.15,7,98,1,1,0.135,0.409,0.31,105
inseparable,0.15,7,98,1,1,0.7,0.52,0.571,105
living,0.15,2613,32349,1,1,0.865,0.608,0.727,34962
appearance,0.15,57,717,1,1,0.669,0.49,0.534,774
torture,0.15,130,1621,1,1,0.115,0.878,0.555,1751
claws,0.149,12,160,1,1,0.281,0.698,0.562,172
greatful,0.149,12,160,1,1,0.923,0.571,0.676,172
ensure,0.149,40,507,1,1,0.737,0.406,0.759,547
lace,0.148,9,123,1,1,0.625,0.2,0.293,132
tacky,0.148,4,61,1,1,0.245,0.49,0.373,65
cost,0.148,129,1611,1,1,0.365,0.42,0.439,1740
roasted,0.148,9,123,1,1,0.615,0.52,0.339,132
convincing,0.148,29,371,1,1,0.76,0.527,0.9,400
darkside,0.148,4,61,1,1,0.102,0.69,0.365,65
lotto,0.148,4,61,1,1,0.76,0.635,0.475,65
disagreeing,0.148,4,61,1,1,0.255,0.643,0.35,65
fuming,0.148,4,61,1,1,0.24,0.66,0.481,65
prerogative,0.148,4,61,1,1,0.521,0.442,0.538,65
irreplaceable,0.148,14,185,1,1,0.479,0.58,0.833,199
workshop,0.147,26,334,1,1,0.531,0.426,0.51,360
monologue,0.147,16,210,1,1,0.5,0.284,0.534,226
grim,0.147,28,359,1,1,0.31,0.483,0.298,387
revolution,0.146,25,322,1,1,0.417,0.902,0.798,347
reeling,0.146,6,86,1,1,0.327,0.542,0.267,92
direct,0.146,76,956,1,1,0.793,0.403,0.65,1032
stash,0.146,6,86,1,1,0.344,0.63,0.361,92
offend,0.145,15,198,1,1,0.094,0.804,0.333,213
memory,0.145,263,3284,1,1,0.792,0.378,0.573,3547
shifting,0.144,26,335,1,1,0.518,0.548,0.546,361
democracy,0.143,36,460,1,1,0.68,0.5,0.84,496
distraught,0.143,12,161,1,1,0.115,0.903,0.264,173
wonderful,0.143,540,6742,1,1,0.971,0.776,0.83,7282
king,0.143,408,5097,1,1,0.677,0.69,0.892,5505
household,0.143,42,535,1,1,0.781,0.23,0.667,577
category,0.143,29,373,1,1,0.571,0.264,0.521,402
vengeance,0.143,31,398,1,1,0.103,0.927,0.719,429
contribution,0.142,16,211,1,1,0.854,0.452,0.76,227
widely,0.142,16,211,1,1,0.698,0.453,0.725,227
unbroken,0.142,16,211,1,1,0.55,0.224,0.602,227
united,0.142,86,1084,1,1,0.781,0.431,0.783,1170
manic,0.142,26,336,1,1,0.054,0.892,0.368,362
casually,0.141,38,486,1,1,0.658,0.29,0.333,524
reference,0.141,62,786,1,1,0.633,0.312,0.595,848
goodwill,0.14,7,99,1,1,0.938,0.327,0.667,106
flog,0.14,1,24,1,1,0.408,0.52,0.382,25
hissing,0.14,3,49,1,1,0.5,0.454,0.4,52
unanimously,0.14,1,24,1,1,0.686,0.333,0.738,25
romp,0.14,1,24,1,1,0.61,0.64,0.417,25
implant,0.14,1,24,1,1,0.429,0.51,0.588,25
vista,0.14,5,74,1,1,0.698,0.39,0.45,79
cosmetics,0.14,1,24,1,1,0.765,0.464,0.472,25
mutter,0.14,1,24,1,1,0.406,0.427,0.228,25
burdensome,0.14,5,74,1,1,0.229,0.696,0.419,79
blaze,0.14,13,174,1,1,0.698,0.467,0.658,187
unbelief,0.14,1,24,1,1,0.265,0.582,0.407,25
expressway,0.14,1,24,1,1,0.633,0.635,0.587,25
exec,0.14,3,49,1,1,0.64,0.352,0.769,52
backdoor,0.14,1,24,1,1,0.344,0.41,0.333,25
wedlock,0.14,1,24,1,1,0.747,0.654,0.745,25
alzheimers,0.14,1,24,1,1,0.194,0.518,0.319,25
tampon,0.14,1,24,1,1,0.396,0.394,0.345,25
midwife,0.14,1,24,1,1,0.531,0.57,0.453,25
spoiling,0.14,17,224,1,1,0.135,0.678,0.306,241
muzzle,0.14,1,24,1,1,0.388,0.43,0.232,25
sluggish,0.14,1,24,1,1,0.224,0.124,0.155,25
walnut,0.14,1,24,1,1,0.688,0.302,0.255,25
connected,0.14,259,3249,1,1,0.816,0.55,0.612,3508
preceding,0.14,1,24,1,1,0.456,0.442,0.663,25
calender,0.14,1,24,1,1,0.531,0.275,0.451,25
slush,0.14,1,24,1,1,0.427,0.283,0.296,25
antibiotics,0.14,1,24,1,1,0.448,0.406,0.557,25
chemotherapy,0.14,1,24,1,1,0.163,0.689,0.517,25
scorching,0.14,3,49,1,1,0.406,0.635,0.464,52
stench,0.14,9,124,1,1,0.104,0.57,0.298,133
pantomime,0.14,1,24,1,1,0.552,0.481,0.385,25
repeal,0.14,1,24,1,1,0.26,0.48,0.482,25
loving,0.139,838,10499,1,1,0.948,0.612,0.636,11337
moody,0.138,49,625,1,1,0.245,0.811,0.595,674
abject,0.138,18,237,1,1,0.354,0.59,0.417,255
propose,0.138,18,237,1,1,0.604,0.72,0.71,255
corrupt,0.138,50,638,1,1,0.02,0.806,0.5,688
concern,0.137,83,1052,1,1,0.25,0.734,0.463,1135
wallow,0.137,53,676,1,1,0.286,0.878,0.491,729
kiddos,0.137,12,162,1,1,0.5,0.48,0.342,174
deed,0.137,12,162,1,1,0.52,0.32,0.592,174
canon,0.137,25,325,1,1,0.385,0.519,0.541,350
slam,0.137,12,162,1,1,0.459,0.577,0.48,174
adore,0.136,151,1906,1,1,0.854,0.438,0.657,2057
moral,0.136,94,1191,1,1,0.7,0.459,0.796,1285
spinning,0.135,40,514,1,1,0.594,0.61,0.481,554
list,0.135,383,4824,1,1,0.528,0.26,0.402,5207
loudly,0.135,43,552,1,1,0.541,0.755,0.667,595
musty,0.134,6,87,1,1,0.354,0.367,0.267,93
institution,0.134,13,175,1,1,0.58,0.311,0.79,188
misinformed,0.134,6,87,1,1,0.156,0.567,0.25,93
wrapping,0.134,25,326,1,1,0.46,0.368,0.462,351
stereo,0.133,11,150,1,1,0.617,0.519,0.5,161
mini,0.133,59,754,1,1,0.421,0.324,0.221,813
leaned,0.133,23,301,1,1,0.57,0.373,0.49,324
attend,0.133,81,1031,1,1,0.65,0.42,0.625,1112
project,0.133,239,3020,1,1,0.725,0.462,0.853,3259
violin,0.133,16,213,1,1,0.823,0.396,0.389,229
green,0.133,294,3713,1,1,0.63,0.306,0.333,4007
pressing,0.133,31,402,1,1,0.24,0.755,0.636,433
pasture,0.132,4,62,1,1,0.688,0.145,0.17,66
translator,0.132,4,62,1,1,0.76,0.412,0.473,66
vomit,0.132,14,188,1,1,0.073,0.569,0.188,202
proxy,0.132,4,62,1,1,0.521,0.408,0.52,66
pitcher,0.132,4,62,1,1,0.51,0.673,0.704,66
flag,0.132,54,692,1,1,0.592,0.378,0.536,746
alerts,0.132,4,62,1,1,0.337,0.804,0.673,66
consumer,0.132,9,125,1,1,0.507,0.551,0.677,134
admiral,0.132,4,62,1,1,0.844,0.49,0.847,66
grinder,0.132,4,62,1,1,0.459,0.615,0.561,66
saga,0.132,19,251,1,1,0.635,0.44,0.6,270
question,0.132,515,6504,1,1,0.51,0.41,0.509,7019
species,0.131,68,869,1,1,0.561,0.33,0.645,937
yellow,0.131,94,1197,1,1,0.671,0.275,0.387,1291
seed,0.131,35,453,1,1,0.656,0.135,0.306,488
welcome,0.131,597,7541,1,1,0.898,0.555,0.664,8138
supper,0.131,12,163,1,1,0.708,0.429,0.552,175
harm,0.131,101,1286,1,1,0.073,0.679,0.423,1387
foremost,0.13,7,100,1,1,0.735,0.593,0.907,107
reception,0.13,15,201,1,1,0.694,0.375,0.567,216
setup,0.13,15,201,1,1,0.667,0.398,0.635,216
fatty,0.13,7,100,1,1,0.286,0.361,0.325,107
difficult,0.13,539,6820,1,1,0.235,0.7,0.508,7359
expense,0.13,18,239,1,1,0.317,0.451,0.377,257
sound,0.129,937,11850,1,1,0.765,0.623,0.398,12787
industrial,0.129,10,138,1,1,0.469,0.6,0.875,148
foolishness,0.129,10,138,1,1,0.235,0.472,0.173,148
division,0.129,32,416,1,1,0.37,0.481,0.472,448
phase,0.128,140,1782,1,1,0.645,0.3,0.482,1922
service,0.128,270,3426,1,1,0.684,0.408,0.535,3696
yessss,0.128,16,214,1,1,0.719,0.796,0.415,230
trusting,0.128,54,695,1,1,0.857,0.508,0.75,749
beholder,0.127,2,37,1,1,0.714,0.491,0.52,39
mayonnaise,0.127,2,37,1,1,0.51,0.32,0.222,39
base,0.127,110,1405,1,1,0.635,0.298,0.553,1515
rail,0.127,11,151,1,1,0.47,0.5,0.526,162
hatch,0.127,5,75,1,1,0.479,0.653,0.402,80
bedrock,0.127,2,37,1,1,0.561,0.34,0.598,39
liter,0.127,2,37,1,1,0.573,0.208,0.382,39
broadcasting,0.127,8,113,1,1,0.542,0.7,0.706,121
appease,0.127,8,113,1,1,0.633,0.278,0.434,121
fumble,0.127,2,37,1,1,0.36,0.551,0.412,39
morale,0.127,5,75,1,1,0.729,0.158,0.792,80
pinching,0.127,2,37,1,1,0.25,0.788,0.345,39
unattainable,0.127,8,113,1,1,0.22,0.635,0.571,121
malfunction,0.127,2,37,1,1,0.125,0.577,0.229,39
erasure,0.127,2,37,1,1,0.281,0.36,0.265,39
flattery,0.127,2,37,1,1,0.47,0.575,0.404,39
basics,0.127,8,113,1,1,0.688,0.311,0.491,121
apology,0.127,26,341,1,1,0.571,0.346,0.402,367
peddle,0.127,2,37,1,1,0.539,0.549,0.538,39
cryptic,0.127,5,75,1,1,0.296,0.516,0.474,80
climber,0.127,2,37,1,1,0.573,0.716,0.735,39
hyperbole,0.127,2,37,1,1,0.469,0.521,0.542,39
suave,0.127,2,37,1,1,0.724,0.265,0.269,39
slurp,0.127,2,37,1,1,0.54,0.528,0.411,39
gala,0.127,8,113,1,1,0.755,0.443,0.679,121
selection,0.127,17,227,1,1,0.594,0.34,0.595,244
possum,0.127,2,37,1,1,0.408,0.471,0.306,39
commons,0.127,5,75,1,1,0.633,0.396,0.623,80
quirk,0.127,5,75,1,1,0.49,0.384,0.618,80
auditorium,0.127,2,37,1,1,0.529,0.49,0.538,39
windshield,0.127,2,37,1,1,0.615,0.375,0.333,39
paternal,0.127,2,37,1,1,0.776,0.353,0.755,39
adamant,0.127,5,75,1,1,0.344,0.529,0.575,80
coupling,0.127,2,37,1,1,0.594,0.479,0.555,39
albino,0.127,2,37,1,1,0.5,0.24,0.358,39
organism,0.127,2,37,1,1,0.457,0.559,0.8,39
unlikely,0.126,24,316,1,1,0.271,0.293,0.245,340
walking,0.125,667,8473,1,1,0.708,0.48,0.781,9140
outfit,0.125,34,443,1,1,0.76,0.49,0.566,477
theory,0.125,90,1154,1,1,0.583,0.314,0.529,1244
rental,0.124,9,126,1,1,0.51,0.37,0.308,135
hallway,0.124,26,342,1,1,0.573,0.23,0.279,368
fairly,0.124,53,685,1,1,0.79,0.406,0.75,738
dealing,0.124,287,3658,1,1,0.724,0.415,0.598,3945
damages,0.123,6,88,1,1,0.082,0.76,0.31,94
millennium,0.123,6,88,1,1,0.573,0.398,0.76,94
fanatic,0.123,6,88,1,1,0.573,0.78,0.629,94
distance,0.123,520,6624,1,1,0.233,0.317,0.418,7144
misery,0.123,305,3891,1,1,0.146,0.378,0.158,4196
sir,0.122,222,2836,1,1,0.622,0.306,0.778,3058
witty,0.122,17,228,1,1,0.857,0.707,0.759,245
bathtub,0.122,10,139,1,1,0.625,0.24,0.318,149
prod,0.122,10,139,1,1,0.48,0.479,0.426,149
behave,0.122,32,419,1,1,0.677,0.363,0.747,451
grocery,0.122,62,801,1,1,0.687,0.54,0.446,863
bland,0.122,14,190,1,1,0.3,0.226,0.157,204
marketing,0.122,29,381,1,1,0.521,0.774,0.675,410
statement,0.121,93,1196,1,1,0.688,0.608,0.825,1289
practically,0.121,48,623,1,1,0.622,0.402,0.588,671
persons,0.121,79,1018,1,1,0.869,0.302,0.588,1097
reminiscing,0.121,30,394,1,1,0.688,0.431,0.418,424
domestic,0.121,34,445,1,1,0.729,0.327,0.5,479
worries,0.121,124,1592,1,1,0.094,0.679,0.363,1716
bickering,0.12,3,50,1,1,0.122,0.8,0.536,53
lucid,0.12,7,101,1,1,0.771,0.49,0.705,108
tile,0.12,3,50,1,1,0.429,0.245,0.348,53
junkie,0.12,7,101,1,1,0.135,0.86,0.363,108
confirmation,0.12,15,203,1,1,0.812,0.48,0.692,218
cot,0.12,3,50,1,1,0.625,0.23,0.278,53
existing,0.12,83,1070,1,1,0.802,0.344,0.75,1153
demonstration,0.12,3,50,1,1,0.551,0.676,0.679,53
carols,0.12,3,50,1,1,0.847,0.42,0.491,53
recycling,0.12,7,101,1,1,0.552,0.32,0.509,108
differing,0.12,3,50,1,1,0.418,0.41,0.455,53
baron,0.12,7,101,1,1,0.52,0.358,0.709,108
backfire,0.12,3,50,1,1,0.265,0.612,0.491,53
crusader,0.12,3,50,1,1,0.439,0.588,0.548,53
librarian,0.12,11,152,1,1,0.625,0.135,0.509,163
brace,0.12,7,101,1,1,0.61,0.385,0.364,108
godsend,0.12,3,50,1,1,0.865,0.562,0.613,53
obstruction,0.12,3,50,1,1,0.125,0.742,0.491,53
dormitory,0.12,3,50,1,1,0.633,0.204,0.382,53
rebuke,0.12,7,101,1,1,0.115,0.677,0.429,108
wash,0.12,93,1198,1,1,0.635,0.377,0.297,1291
interlude,0.119,20,267,1,1,0.47,0.417,0.377,287
pee,0.119,37,484,1,1,0.449,0.529,0.391,521
crumbling,0.119,16,216,1,1,0.167,0.696,0.308,232
sixth,0.119,16,216,1,1,0.521,0.275,0.366,232
spoke,0.119,166,2131,1,1,0.635,0.433,0.483,2297
feedback,0.119,42,548,1,1,0.622,0.557,0.645,590
stairs,0.118,31,408,1,1,0.51,0.439,0.342,439
haven,0.117,556,7121,1,1,0.684,0.265,0.547,7677
pronto,0.116,4,63,1,1,0.646,0.5,0.468,67
spade,0.116,4,63,1,1,0.469,0.667,0.529,67
absurdity,0.116,4,63,1,1,0.115,0.528,0.227,67
chaps,0.116,4,63,1,1,0.35,0.462,0.35,67
imp,0.116,4,63,1,1,0.35,0.448,0.42,67
nada,0.116,14,191,1,1,0.25,0.231,0.136,205
politics,0.116,146,1881,1,1,0.25,0.528,0.855,2027
slow,0.116,307,3943,1,1,0.357,0.073,0.131,4250
expecting,0.116,102,1318,1,1,0.561,0.45,0.302,1420
interactive,0.115,15,204,1,1,0.727,0.811,0.77,219
panicking,0.115,10,140,1,1,0.094,0.882,0.333,150
farming,0.114,16,217,1,1,0.58,0.414,0.568,233
farther,0.114,22,294,1,1,0.418,0.5,0.43,316
sequel,0.114,28,371,1,1,0.65,0.48,0.574,399
apologize,0.114,98,1269,1,1,0.551,0.378,0.389,1367
peanuts,0.114,5,76,1,1,0.542,0.294,0.324,81
disadvantage,0.114,5,76,1,1,0.15,0.377,0.282,81
hitch,0.114,5,76,1,1,0.512,0.48,0.554,81
shuffling,0.114,5,76,1,1,0.521,0.408,0.293,81
custody,0.114,11,153,1,1,0.494,0.472,0.675,164
permanent,0.113,73,949,1,1,0.745,0.345,0.736,1022
phoenix,0.113,30,397,1,1,0.653,0.481,0.594,427
independent,0.113,282,3633,1,1,0.885,0.44,0.872,3915
lasting,0.113,37,487,1,1,0.804,0.535,0.745,524
proposal,0.113,18,243,1,1,0.888,0.667,0.596,261
smell,0.113,196,2529,1,1,0.51,0.52,0.33,2725
succeed,0.113,51,667,1,1,0.926,0.755,0.926,718
dumpster,0.113,12,166,1,1,0.229,0.418,0.101,178
mechanism,0.113,58,757,1,1,0.573,0.583,0.664,815
credit,0.112,107,1387,1,1,0.673,0.549,0.648,1494
echo,0.112,88,1143,1,1,0.573,0.373,0.345,1231
teller,0.112,6,89,1,1,0.5,0.395,0.443,95
schooling,0.112,6,89,1,1,0.582,0.462,0.64,95
salesman,0.112,6,89,1,1,0.643,0.559,0.664,95
calculate,0.112,6,89,1,1,0.49,0.452,0.44,95
charitable,0.112,6,89,1,1,0.865,0.38,0.593,95
motivating,0.112,13,179,1,1,0.958,0.82,0.787,192
run,0.112,873,11239,1,1,0.542,0.787,0.543,12112
intend,0.111,21,282,1,1,0.562,0.52,0.519,303
unexpectedly,0.111,21,282,1,1,0.354,0.759,0.462,303
thesis,0.111,22,295,1,1,0.583,0.582,0.552,317
fire,0.111,484,6243,1,1,0.38,0.804,0.635,6727
fright,0.11,7,102,1,1,0.177,0.816,0.191,109
resource,0.11,15,205,1,1,0.74,0.357,0.749,220
crippled,0.11,16,218,1,1,0.035,0.358,0.236,234
disaster,0.11,42,553,1,1,0.082,0.892,0.433,595
taste,0.11,251,3246,1,1,0.802,0.406,0.465,3497
tone,0.11,78,1017,1,1,0.551,0.355,0.411,1095
executive,0.109,17,231,1,1,0.704,0.449,0.894,248
avocado,0.109,8,115,1,1,0.677,0.255,0.287,123
catching,0.109,79,1031,1,1,0.49,0.788,0.644,1110
misplaced,0.109,9,128,1,1,0.247,0.45,0.324,137
facade,0.108,30,399,1,1,0.52,0.333,0.518,429
bother,0.108,304,3935,1,1,0.208,0.78,0.37,4239
grip,0.108,52,683,1,1,0.52,0.549,0.602,735
cheers,0.108,119,1548,1,1,0.948,0.77,0.702,1667
inferiority,0.108,10,141,1,1,0.177,0.43,0.205,151
cruelty,0.107,36,477,1,1,0.092,0.836,0.536,513
hostile,0.107,25,335,1,1,0.188,0.877,0.474,360
knit,0.107,12,167,1,1,0.63,0.144,0.295,179
effort,0.107,262,3398,1,1,0.698,0.778,0.858,3660
film,0.106,347,4498,1,1,0.823,0.491,0.566,4845
offensive,0.106,27,361,1,1,0.135,0.882,0.6,388
overflowing,0.106,13,180,1,1,0.439,0.796,0.635,193
quarter,0.106,28,374,1,1,0.568,0.296,0.509,402
universal,0.106,58,762,1,1,0.802,0.417,0.833,820
substitute,0.106,29,387,1,1,0.427,0.406,0.398,416
hostel,0.106,15,206,1,1,0.479,0.5,0.398,221
secondary,0.105,17,232,1,1,0.636,0.375,0.26,249
edition,0.105,73,957,1,1,0.542,0.455,0.564,1030
previous,0.105,77,1009,1,1,0.521,0.337,0.348,1086
disgrace,0.105,38,504,1,1,0.061,0.531,0.331,542
problematic,0.104,43,569,1,1,0.073,0.72,0.361,612
tank,0.104,46,608,1,1,0.431,0.454,0.634,654
federal,0.104,25,336,1,1,0.53,0.459,0.859,361
deal,0.104,910,11808,1,1,0.719,0.599,0.543,12718
troubles,0.104,53,699,1,1,0.051,0.854,0.269,752
foot,0.103,90,1180,1,1,0.49,0.29,0.254,1270
correct,0.101,121,1584,1,1,0.857,0.306,0.723,1705
speaking,0.101,312,4066,1,1,0.753,0.59,0.575,4378
glum,0.101,3,51,1,1,0.244,0.337,0.123,54
cranium,0.101,2,38,1,1,0.439,0.491,0.725,40
gluttony,0.101,3,51,1,1,0.5,0.702,0.412,54
auburn,0.101,3,51,1,1,0.51,0.24,0.411,54
dim,0.101,47,623,1,1,0.398,0.321,0.273,670
smear,0.101,4,64,1,1,0.23,0.433,0.4,68
reptile,0.101,2,38,1,1,0.35,0.566,0.365,40
verification,0.101,3,51,1,1,0.75,0.276,0.642,54
medic,0.101,2,38,1,1,0.5,0.472,0.585,40
platoon,0.101,1,25,1,1,0.448,0.7,0.745,26
occupant,0.101,2,38,1,1,0.5,0.417,0.483,40
sprinkling,0.101,1,25,1,1,0.677,0.51,0.466,26
picker,0.101,1,25,1,1,0.534,0.34,0.609,26
batter,0.101,2,38,1,1,0.561,0.245,0.373,40
republic,0.101,17,233,1,1,0.635,0.34,0.83,250
speeding,0.101,6,90,1,1,0.438,0.908,0.645,96
fainting,0.101,1,25,1,1,0.333,0.51,0.214,26
overview,0.101,1,25,1,1,0.615,0.38,0.539,26
limo,0.101,2,38,1,1,0.76,0.367,0.667,40
mach,0.101,1,25,1,1,0.541,0.432,0.463,26
insure,0.101,1,25,1,1,0.7,0.415,0.698,26
undertaking,0.101,2,38,1,1,0.667,0.53,0.696,40
pap,0.101,3,51,1,1,0.438,0.403,0.302,54
cast,0.101,126,1650,1,1,0.558,0.62,0.517,1776
copycat,0.101,2,38,1,1,0.449,0.58,0.443,40
assign,0.101,3,51,1,1,0.622,0.417,0.709,54
landed,0.101,28,376,1,1,0.709,0.62,0.48,404
zoom,0.101,7,103,1,1,0.49,0.52,0.462,110
designing,0.101,7,103,1,1,0.792,0.355,0.552,110
sewage,0.101,1,25,1,1,0.255,0.343,0.339,26
blackface,0.101,1,25,1,1,0.302,0.49,0.441,26
demolish,0.101,1,25,1,1,0.125,0.632,0.7,26
autopilot,0.101,2,38,1,1,0.594,0.462,0.632,40
dumpling,0.101,1,25,1,1,0.58,0.321,0.36,26
thong,0.101,2,38,1,1,0.467,0.596,0.269,40
torso,0.101,3,51,1,1,0.408,0.394,0.473,54
towel,0.101,13,181,1,1,0.63,0.208,0.286,194
reindeer,0.101,6,90,1,1,0.592,0.336,0.396,96
confederate,0.101,1,25,1,1,0.551,0.546,0.792,26
foodie,0.101,2,38,1,1,0.781,0.465,0.484,40
inexcusable,0.101,1,25,1,1,0.271,0.582,0.546,26
tinfoil,0.101,1,25,1,1,0.448,0.284,0.311,26
curfew,0.101,3,51,1,1,0.219,0.618,0.623,54
canteen,0.101,3,51,1,1,0.688,0.6,0.514,54
agressive,0.101,2,38,1,1,0.083,0.918,0.751,40
acknowledgement,0.101,10,142,1,1,0.819,0.539,0.83,152
sneaker,0.101,1,25,1,1,0.794,0.479,0.389,26
morphine,0.101,2,38,1,1,0.229,0.49,0.496,40
voyager,0.101,7,103,1,1,0.684,0.596,0.627,110
snazzy,0.101,1,25,1,1,0.735,0.37,0.66,26
ammo,0.101,3,51,1,1,0.323,0.765,0.621,54
prism,0.101,4,64,1,1,0.52,0.429,0.343,68
homily,0.101,1,25,1,1,0.621,0.358,0.425,26
dissipated,0.101,2,38,1,1,0.281,0.421,0.231,40
charlatan,0.101,2,38,1,1,0.2,0.64,0.352,40
splurge,0.101,1,25,1,1,0.365,0.481,0.542,26
troupe,0.101,1,25,1,1,0.625,0.406,0.557,26
predicament,0.101,7,103,1,1,0.365,0.48,0.541,110
plaintive,0.101,2,38,1,1,0.292,0.529,0.306,40
silo,0.101,2,38,1,1,0.4,0.365,0.357,40
predictable,0.101,14,194,1,1,0.312,0.296,0.42,208
pushover,0.101,1,25,1,1,0.347,0.558,0.375,26
amazed,0.101,36,480,1,1,0.796,0.779,0.533,516
plankton,0.101,1,25,1,1,0.552,0.321,0.371,26
rooster,0.101,5,77,1,1,0.459,0.385,0.275,82
commonwealth,0.101,2,38,1,1,0.63,0.406,0.702,40
mercenary,0.101,3,51,1,1,0.245,0.837,0.673,54
animation,0.101,22,298,1,1,0.888,0.75,0.549,320
strain,0.101,12,168,1,1,0.19,0.75,0.38,180
lava,0.101,8,116,1,1,0.28,0.539,0.615,124
tangent,0.101,2,38,1,1,0.573,0.373,0.454,40
streetlight,0.101,1,25,1,1,0.673,0.268,0.39,26
shard,0.101,1,25,1,1,0.388,0.407,0.426,26
appetite,0.101,23,311,1,1,0.704,0.637,0.581,334
scrappy,0.101,1,25,1,1,0.301,0.375,0.406,26
confidence,0.1,172,2250,1,1,0.959,0.276,0.943,2422
grin,0.099,41,546,1,1,0.885,0.57,0.491,587
leadership,0.099,111,1458,1,1,0.87,0.69,0.983,1569
loyalty,0.099,66,872,1,1,0.885,0.406,0.793,938
explode,0.098,28,377,1,1,0.277,0.885,0.773,405
lunch,0.098,342,4472,1,1,0.88,0.41,0.542,4814
fit,0.096,330,4321,1,1,0.604,0.45,0.632,4651
tripping,0.096,31,417,1,1,0.276,0.594,0.293,448
overcome,0.096,187,2455,1,1,0.719,0.689,0.848,2642
breeding,0.096,14,195,1,1,0.667,0.481,0.61,209
reputation,0.096,29,391,1,1,0.74,0.542,0.721,420
political,0.095,156,2051,1,1,0.347,0.73,0.875,2207
kirk,0.095,13,182,1,1,0.51,0.39,0.388,195
engagement,0.095,54,718,1,1,0.906,0.587,0.807,772
agenda,0.095,51,679,1,1,0.531,0.296,0.553,730
ranger,0.094,23,313,1,1,0.526,0.545,0.705,336
flawless,0.094,10,143,1,1,0.729,0.42,0.741,153
blast,0.094,73,968,1,1,0.167,0.929,0.777,1041
magnet,0.093,9,130,1,1,0.571,0.318,0.553,139
lurking,0.093,29,392,1,1,0.421,0.781,0.575,421
parenthood,0.093,9,130,1,1,0.75,0.63,0.782,139
flood,0.093,27,366,1,1,0.208,0.778,0.608,393
fairness,0.092,8,117,1,1,0.74,0.317,0.552,125
announcement,0.092,26,353,1,1,0.729,0.491,0.482,379
crossing,0.092,51,681,1,1,0.549,0.349,0.451,732
marital,0.091,7,104,1,1,0.76,0.529,0.5,111
scarecrow,0.091,7,104,1,1,0.219,0.274,0.349,111
diary,0.091,78,1036,1,1,0.698,0.292,0.464,1114
smashed,0.091,14,196,1,1,0.143,0.66,0.256,210
communist,0.091,14,196,1,1,0.265,0.702,0.632,210
useful,0.09,71,945,1,1,0.833,0.411,0.726,1016
theme,0.09,155,2049,1,1,0.541,0.176,0.427,2204
wallflower,0.09,6,91,1,1,0.667,0.298,0.342,97
cheeseburger,0.09,6,91,1,1,0.802,0.529,0.336,97
coat,0.089,32,433,1,1,0.677,0.256,0.464,465
game,0.089,1131,14888,1,1,0.735,0.788,0.493,16019
admin,0.089,25,341,1,1,0.688,0.42,0.854,366
law,0.089,128,1696,1,1,0.74,0.59,0.815,1824
stifling,0.088,5,78,1,1,0.163,0.858,0.608,83
protein,0.088,5,78,1,1,0.75,0.337,0.654,83
room,0.088,2217,29206,1,1,0.729,0.283,0.445,31423
stock,0.087,39,526,1,1,0.594,0.418,0.407,565
criticize,0.087,16,223,1,1,0.143,0.708,0.473,239
improve,0.087,106,1409,1,1,0.833,0.528,0.815,1515
barrier,0.087,21,289,1,1,0.333,0.48,0.562,310
witness,0.087,95,1265,1,1,0.562,0.569,0.593,1360
sarcasm,0.087,31,421,1,1,0.125,0.685,0.346,452
contract,0.086,25,342,1,1,0.594,0.412,0.636,367
progressive,0.086,30,408,1,1,0.755,0.606,0.81,438
zoo,0.086,35,474,1,1,0.76,0.52,0.58,509
christian,0.086,125,1662,1,1,0.76,0.241,0.591,1787
hypothesis,0.086,4,65,1,1,0.552,0.37,0.509,69
fiend,0.086,9,131,1,1,0.146,0.903,0.608,140
scoff,0.086,4,65,1,1,0.125,0.686,0.306,69
unnamed,0.086,4,65,1,1,0.316,0.189,0.284,69
flyer,0.086,4,65,1,1,0.48,0.3,0.362,69
roadtrip,0.086,4,65,1,1,0.677,0.596,0.519,69
asylum,0.086,19,263,1,1,0.407,0.33,0.445,282
pompous,0.086,4,65,1,1,0.5,0.571,0.409,69
gel,0.086,4,65,1,1,0.524,0.206,0.279,69
puzzled,0.086,4,65,1,1,0.204,0.5,0.272,69
injured,0.085,28,382,1,1,0.083,0.68,0.302,410
insists,0.084,8,118,1,1,0.49,0.587,0.61,126
lighten,0.084,17,237,1,1,0.688,0.438,0.362,254
worrying,0.084,89,1189,1,1,0.047,0.75,0.296,1278
pipe,0.083,21,290,1,1,0.541,0.34,0.33,311
trade,0.083,100,1335,1,1,0.561,0.544,0.69,1435
burst,0.083,47,634,1,1,0.156,0.894,0.845,681
ease,0.083,217,2883,1,1,0.796,0.385,0.491,3100
debt,0.083,73,978,1,1,0.204,0.598,0.336,1051
options,0.083,90,1203,1,1,0.622,0.327,0.473,1293
banana,0.083,45,608,1,1,0.612,0.23,0.241,653
sunny,0.082,81,1085,1,1,0.74,0.348,0.481,1166
patch,0.082,44,595,1,1,0.439,0.288,0.283,639
visiting,0.082,105,1403,1,1,0.729,0.44,0.519,1508
shallow,0.082,64,860,1,1,0.427,0.298,0.351,924
warlock,0.082,7,105,1,1,0.312,0.558,0.657,112
pow,0.082,3,52,1,1,0.375,0.44,0.426,55
launches,0.082,3,52,1,1,0.49,0.663,0.602,55
scrambled,0.082,3,52,1,1,0.451,0.535,0.539,55
jackal,0.082,3,52,1,1,0.333,0.582,0.436,55
horrified,0.082,7,105,1,1,0.04,0.885,0.368,112
mandarin,0.082,3,52,1,1,0.625,0.398,0.491,55
drawing,0.082,131,1748,1,1,0.698,0.216,0.333,1879
foreplay,0.082,3,52,1,1,0.724,0.627,0.474,55
visual,0.081,50,675,1,1,0.813,0.462,0.462,725
flame,0.081,73,980,1,1,0.448,0.574,0.615,1053
material,0.081,96,1285,1,1,0.521,0.363,0.439,1381
jolly,0.081,18,251,1,1,0.959,0.705,0.708,269
courage,0.081,229,3050,1,1,0.83,0.728,0.849,3279
impression,0.081,44,596,1,1,0.684,0.557,0.577,640
agree,0.081,505,6712,1,1,0.906,0.26,0.545,7217
four,0.08,283,3767,1,1,0.552,0.28,0.383,4050
assurance,0.08,10,145,1,1,0.675,0.442,0.704,155
ref,0.08,10,145,1,1,0.469,0.38,0.368,155
wick,0.08,10,145,1,1,0.337,0.481,0.309,155
leads,0.08,243,3238,1,1,0.53,0.471,0.615,3481
absent,0.08,39,530,1,1,0.177,0.221,0.116,569
received,0.079,95,1274,1,1,0.646,0.436,0.561,1369
african,0.079,31,424,1,1,0.49,0.423,0.555,455
cola,0.079,6,92,1,1,0.469,0.325,0.24,98
posh,0.079,6,92,1,1,0.823,0.337,0.75,98
unneeded,0.079,6,92,1,1,0.177,0.375,0.245,98
bawl,0.079,6,92,1,1,0.385,0.88,0.561,98
jury,0.079,6,92,1,1,0.479,0.607,0.789,98
otter,0.079,6,92,1,1,0.439,0.216,0.339,98
falsely,0.079,6,92,1,1,0.083,0.48,0.265,98
brigade,0.079,6,92,1,1,0.604,0.71,0.828,98
alert,0.079,44,597,1,1,0.479,0.82,0.648,641
rush,0.079,170,2272,1,1,0.406,0.809,0.546,2442
daring,0.078,16,225,1,1,0.583,0.84,0.711,241
diet,0.078,43,584,1,1,0.429,0.235,0.398,627
listener,0.078,29,398,1,1,0.667,0.375,0.403,427
despairing,0.078,9,132,1,1,0.073,0.735,0.286,141
underwear,0.078,19,265,1,1,0.61,0.546,0.375,284
frightening,0.078,42,571,1,1,0.122,0.969,0.625,613
blowing,0.078,68,917,1,1,0.521,0.472,0.434,985
annoyed,0.078,146,1955,1,1,0.104,0.783,0.345,2101
eight,0.077,47,638,1,1,0.54,0.199,0.315,685
bucket,0.077,31,425,1,1,0.408,0.167,0.336,456
liking,0.077,162,2169,1,1,0.963,0.604,0.589,2331
commentary,0.077,24,332,1,1,0.602,0.402,0.446,356
moon,0.076,843,11246,1,1,0.673,0.233,0.547,12089
lines,0.076,149,1998,1,1,0.542,0.317,0.33,2147
contact,0.076,399,5331,1,1,0.719,0.424,0.526,5730
ell,0.076,2,39,1,1,0.469,0.418,0.373,41
ducky,0.076,2,39,1,1,0.52,0.43,0.368,41
ivory,0.076,14,199,1,1,0.625,0.235,0.566,213
juggle,0.076,2,39,1,1,0.594,0.76,0.426,41
piped,0.076,2,39,1,1,0.36,0.529,0.379,41
tolerable,0.076,8,119,1,1,0.75,0.35,0.374,127
shotgun,0.076,8,119,1,1,0.2,0.868,0.684,127
scorned,0.076,5,79,1,1,0.062,0.529,0.226,84
psychiatry,0.076,2,39,1,1,0.191,0.663,0.698,41
emphasize,0.076,20,279,1,1,0.51,0.605,0.769,299
scout,0.076,11,159,1,1,0.656,0.611,0.763,170
oddball,0.076,2,39,1,1,0.316,0.36,0.357,41
legally,0.076,17,239,1,1,0.771,0.482,0.842,256
preschool,0.076,2,39,1,1,0.604,0.382,0.393,41
biology,0.076,11,159,1,1,0.479,0.274,0.546,170
affordable,0.076,14,199,1,1,0.84,0.398,0.493,213
detector,0.076,2,39,1,1,0.459,0.63,0.724,41
geek,0.076,20,279,1,1,0.479,0.392,0.39,299
indecisive,0.076,8,119,1,1,0.271,0.42,0.19,127
inability,0.076,95,1279,1,1,0.15,0.529,0.25,1374
scene,0.075,246,3293,1,1,0.57,0.34,0.578,3539
stolen,0.073,53,721,1,1,0.156,0.646,0.308,774
weather,0.073,306,4104,1,1,0.755,0.404,0.567,4410
smokey,0.072,7,106,1,1,0.494,0.462,0.43,113
delta,0.072,7,106,1,1,0.551,0.343,0.509,113
bothering,0.072,78,1056,1,1,0.208,0.764,0.449,1134
horn,0.072,20,280,1,1,0.385,0.51,0.366,300
toddler,0.072,20,280,1,1,0.812,0.469,0.368,300
doodle,0.072,12,173,1,1,0.604,0.402,0.376,185
siren,0.071,17,240,1,1,0.57,0.627,0.5,257
earn,0.071,45,615,1,1,0.865,0.769,0.817,660
working,0.071,1174,15734,1,1,0.74,0.585,0.576,16908
mood,0.071,810,10861,1,1,0.72,0.5,0.5,11671
world,0.071,6163,82576,1,1,0.622,0.394,0.75,88739
freezing,0.071,44,602,1,1,0.327,0.367,0.471,646
submissive,0.071,14,200,1,1,0.48,0.217,0.173,214
plea,0.071,14,200,1,1,0.633,0.491,0.517,214
pied,0.071,4,66,1,1,0.594,0.433,0.35,70
disingenuous,0.071,4,66,1,1,0.194,0.509,0.204,70
wardrobe,0.071,9,133,1,1,0.612,0.51,0.336,142
pack,0.069,145,1958,1,1,0.51,0.347,0.475,2103
catch,0.069,362,4870,1,1,0.531,0.437,0.552,5232
greet,0.069,44,603,1,1,0.885,0.539,0.618,647
tower,0.068,109,1476,1,1,0.606,0.38,0.644,1585
whatnot,0.068,13,187,1,1,0.375,0.493,0.363,200
quantity,0.068,20,281,1,1,0.52,0.472,0.783,301
degrade,0.068,6,93,1,1,0.083,0.5,0.184,99
advocacy,0.068,6,93,1,1,0.5,0.646,0.731,99
cycle,0.068,148,2000,1,1,0.635,0.4,0.533,2148
card,0.068,165,2230,1,1,0.531,0.269,0.436,2395
notorious,0.067,8,120,1,1,0.366,0.582,0.609,128
salad,0.067,30,416,1,1,0.75,0.26,0.307,446
scratch,0.066,32,443,1,1,0.276,0.625,0.27,475
sonic,0.066,25,349,1,1,0.594,0.5,0.481,374
point,0.066,1558,20992,1,1,0.49,0.193,0.431,22550
prepared,0.065,110,1494,1,1,0.71,0.48,0.733,1604
score,0.065,56,767,1,1,0.67,0.388,0.589,823
vicious,0.065,41,565,1,1,0.208,0.694,0.407,606
body,0.065,876,11819,1,1,0.694,0.461,0.571,12695
horrific,0.065,22,309,1,1,0.094,0.846,0.481,331
chuckle,0.064,26,363,1,1,0.844,0.736,0.481,389
dozen,0.064,30,417,1,1,0.583,0.343,0.425,447
plot,0.064,92,1253,1,1,0.469,0.567,0.51,1345
distress,0.064,48,660,1,1,0.073,0.84,0.396,708
interest,0.063,238,3225,1,1,0.78,0.667,0.618,3463
vicar,0.063,1,26,1,1,0.531,0.37,0.555,27
leaflet,0.063,1,26,1,1,0.49,0.206,0.375,27
outcry,0.063,1,26,1,1,0.271,0.773,0.718,27
outnumber,0.063,1,26,1,1,0.347,0.615,0.577,27
heifer,0.063,1,26,1,1,0.439,0.443,0.321,27
manageable,0.063,7,107,1,1,0.75,0.361,0.655,114
thwart,0.063,1,26,1,1,0.281,0.684,0.409,27
firearm,0.063,1,26,1,1,0.086,0.943,0.864,27
reduced,0.063,31,431,1,1,0.229,0.365,0.204,462
fizz,0.063,1,26,1,1,0.459,0.708,0.349,27
stomped,0.063,3,53,1,1,0.229,0.684,0.406,56
doormat,0.063,3,53,1,1,0.458,0.269,0.267,56
unusually,0.063,5,80,1,1,0.385,0.406,0.358,85
toots,0.063,1,26,1,1,0.552,0.48,0.451,27
suburb,0.063,3,53,1,1,0.354,0.566,0.441,56
census,0.063,1,26,1,1,0.449,0.289,0.553,27
supplier,0.063,1,26,1,1,0.615,0.462,0.736,27
toothache,0.063,1,26,1,1,0.188,0.853,0.412,27
whiz,0.063,1,26,1,1,0.896,0.627,0.82,27
mace,0.063,1,26,1,1,0.45,0.412,0.415,27
circulation,0.063,1,26,1,1,0.735,0.52,0.657,27
jester,0.063,9,134,1,1,0.388,0.67,0.264,143
acquainted,0.063,17,242,1,1,0.906,0.358,0.632,259
tabloid,0.063,1,26,1,1,0.438,0.365,0.444,27
parcels,0.063,1,26,1,1,0.551,0.445,0.418,27
aghhh,0.063,1,26,1,1,0.281,0.635,0.243,27
negligence,0.063,3,53,1,1,0.092,0.57,0.251,56
vendor,0.063,1,26,1,1,0.541,0.541,0.627,27
lukewarm,0.063,3,53,1,1,0.573,0.3,0.241,56
mutt,0.063,3,53,1,1,0.418,0.408,0.387,56
grrrrr,0.063,1,26,1,1,0.281,0.633,0.444,27
ethical,0.063,11,161,1,1,0.854,0.324,0.634,172
zip,0.063,7,107,1,1,0.487,0.368,0.422,114
devalued,0.063,1,26,1,1,0.321,0.462,0.212,27
knockout,0.063,1,26,1,1,0.388,0.755,0.664,27
foil,0.063,3,53,1,1,0.312,0.204,0.342,56
popularity,0.063,33,458,1,1,0.896,0.784,0.861,491
derail,0.063,1,26,1,1,0.108,0.802,0.375,27
olden,0.063,1,26,1,1,0.284,0.213,0.425,27
twister,0.063,1,26,1,1,0.33,0.68,0.647,27
sanitary,0.063,1,26,1,1,0.458,0.32,0.425,27
auction,0.063,5,80,1,1,0.594,0.702,0.519,85
hanger,0.063,3,53,1,1,0.439,0.462,0.461,56
ammunition,0.063,1,26,1,1,0.338,0.635,0.667,27
skilled,0.063,9,134,1,1,0.886,0.614,0.929,143
absentee,0.063,1,26,1,1,0.235,0.33,0.279,27
lined,0.063,11,161,1,1,0.438,0.367,0.424,172
prescribe,0.063,7,107,1,1,0.459,0.55,0.618,114
unjustified,0.063,1,26,1,1,0.288,0.541,0.314,27
avatar,0.063,17,242,1,1,0.633,0.41,0.567,259
stroller,0.063,1,26,1,1,0.786,0.398,0.314,27
iteration,0.063,1,26,1,1,0.531,0.449,0.486,27
testify,0.063,5,80,1,1,0.521,0.65,0.741,85
dynasty,0.063,7,107,1,1,0.725,0.588,0.936,114
godmother,0.063,1,26,1,1,0.733,0.311,0.53,27
nutritious,0.063,1,26,1,1,0.833,0.337,0.655,27
craps,0.063,1,26,1,1,0.375,0.42,0.273,27
dues,0.063,3,53,1,1,0.367,0.461,0.288,56
rabies,0.063,1,26,1,1,0.115,0.75,0.382,27
black,0.063,865,11696,1,1,0.326,0.339,0.39,12561
fart,0.062,40,553,1,1,0.194,0.439,0.264,593
purposely,0.062,26,364,1,1,0.646,0.706,0.703,390
stupidity,0.062,47,648,1,1,0.06,0.418,0.151,695
god,0.061,3991,53980,1,1,0.758,0.518,0.886,57971
attract,0.061,64,878,1,1,0.796,0.663,0.769,942
past,0.061,1340,18135,1,1,0.49,0.422,0.311,19475
field,0.061,163,2217,1,1,0.64,0.38,0.336,2380
occupied,0.061,56,770,1,1,0.337,0.546,0.441,826
marine,0.061,14,202,1,1,0.633,0.471,0.679,216
relevance,0.061,14,202,1,1,0.71,0.599,0.791,216
jar,0.061,29,405,1,1,0.43,0.346,0.318,434
dictator,0.061,14,202,1,1,0.073,0.76,0.862,216
worthy,0.061,115,1569,1,1,0.812,0.34,0.796,1684
sushi,0.06,27,378,1,1,0.698,0.343,0.394,405
terrorism,0.06,12,175,1,1,0.06,0.971,0.673,187
pleased,0.06,49,676,1,1,0.939,0.548,0.795,725
batch,0.06,10,148,1,1,0.56,0.357,0.357,158
warning,0.06,74,1015,1,1,0.229,0.774,0.629,1089
professor,0.059,48,663,1,1,0.656,0.398,0.721,711
take,0.059,4383,59409,1,1,0.828,0.537,0.348,63792
cracked,0.059,28,392,1,1,0.224,0.52,0.228,420
spineless,0.059,8,121,1,1,0.344,0.387,0.321,129
director,0.059,49,677,1,1,0.688,0.58,0.912,726
boots,0.058,31,433,1,1,0.602,0.255,0.35,464
bay,0.058,86,1179,1,1,0.719,0.365,0.569,1265
fork,0.058,13,189,1,1,0.406,0.3,0.529,202
assuage,0.058,6,94,1,1,0.745,0.255,0.5,100
lift,0.058,109,1492,1,1,0.704,0.518,0.656,1601
fearful,0.058,39,542,1,1,0.083,0.482,0.278,581
marvel,0.057,59,814,1,1,0.961,0.755,0.866,873
empire,0.057,69,950,1,1,0.688,0.73,0.944,1019
membership,0.057,16,230,1,1,0.698,0.411,0.778,246
session,0.056,99,1358,1,1,0.51,0.481,0.491,1457
dreading,0.056,21,298,1,1,0.125,0.76,0.377,319
illiterate,0.056,9,135,1,1,0.12,0.41,0.151,144
inject,0.056,4,67,1,1,0.406,0.735,0.596,71
bossy,0.056,4,67,1,1,0.24,0.824,0.75,71
probable,0.056,4,67,1,1,0.583,0.433,0.481,71
cube,0.056,19,271,1,1,0.469,0.226,0.274,290
alias,0.056,4,67,1,1,0.541,0.353,0.333,71
burrito,0.056,14,203,1,1,0.688,0.294,0.166,217
curious,0.056,134,1835,1,1,0.635,0.6,0.483,1969
idea,0.056,898,12226,1,1,0.75,0.538,0.704,13124
general,0.055,287,3919,1,1,0.834,0.484,0.853,4206
jelly,0.055,17,244,1,1,0.651,0.294,0.256,261
confusion,0.055,102,1401,1,1,0.255,0.667,0.277,1503
arcade,0.055,12,176,1,1,0.676,0.521,0.502,188
segment,0.055,12,176,1,1,0.469,0.29,0.44,188
sharing,0.055,423,5772,1,1,0.827,0.462,0.545,6195
car,0.054,538,7339,1,1,0.776,0.54,0.5,7877
planes,0.054,20,285,1,1,0.667,0.606,0.575,305
trapped,0.054,236,3228,1,1,0.135,0.615,0.38,3464
arrest,0.054,15,217,1,1,0.146,0.951,0.5,232
bummer,0.054,15,217,1,1,0.163,0.5,0.267,232
loathing,0.054,47,653,1,1,0.083,0.796,0.368,700
teeth,0.054,79,1089,1,1,0.52,0.388,0.427,1168
risk,0.054,260,3556,1,1,0.24,0.816,0.438,3816
tip,0.054,88,1212,1,1,0.708,0.221,0.518,1300
expert,0.053,37,517,1,1,0.776,0.646,0.911,554
mentality,0.053,56,776,1,1,0.711,0.415,0.726,832
fabulous,0.053,48,667,1,1,0.979,0.66,0.797,715
dope,0.053,89,1226,1,1,0.295,0.855,0.425,1315
drug,0.053,142,1949,1,1,0.214,0.79,0.453,2091
confide,0.053,32,449,1,1,0.669,0.472,0.595,481
thankful,0.053,288,3940,1,1,0.969,0.344,0.714,4228
lure,0.053,13,190,1,1,0.439,0.565,0.3,203
available,0.052,235,3219,1,1,0.844,0.356,0.623,3454
remembering,0.052,114,1569,1,1,0.535,0.386,0.509,1683
share,0.052,1162,15882,1,1,0.759,0.548,0.545,17044
confirmed,0.051,37,518,1,1,0.76,0.49,0.764,555
hill,0.051,183,2513,1,1,0.615,0.353,0.518,2696
grizzly,0.051,2,40,1,1,0.398,0.679,0.657,42
hooray,0.051,8,122,1,1,0.61,0.481,0.536,130
uneven,0.051,2,40,1,1,0.125,0.457,0.24,42
generous,0.051,32,450,1,1,1,0.41,0.81,482
darken,0.051,2,40,1,1,0.25,0.471,0.382,42
lid,0.051,5,81,1,1,0.49,0.189,0.255,86
pest,0.051,5,81,1,1,0.188,0.68,0.452,86
emit,0.051,2,40,1,1,0.638,0.445,0.51,42
trim,0.051,2,40,1,1,0.5,0.466,0.43,42
vanguard,0.051,2,40,1,1,0.693,0.64,0.78,42
vandal,0.051,2,40,1,1,0.135,0.792,0.473,42
apprentice,0.051,5,81,1,1,0.615,0.413,0.452,86
trickster,0.051,2,40,1,1,0.375,0.68,0.446,42
godless,0.051,5,81,1,1,0.316,0.557,0.358,86
tuesday,0.05,112,1544,1,1,0.469,0.184,0.33,1656
bare,0.05,104,1435,1,1,0.333,0.717,0.296,1539
unit,0.05,46,642,1,1,0.562,0.235,0.578,688
ant,0.05,21,300,1,1,0.448,0.216,0.216,321
excruciating,0.05,18,259,1,1,0.083,0.837,0.345,277
ownership,0.049,12,177,1,1,0.628,0.445,0.741,189
upbringing,0.049,12,177,1,1,0.677,0.49,0.6,189
falling,0.049,506,6942,1,1,0.202,0.716,0.306,7448
stumble,0.049,22,314,1,1,0.153,0.716,0.259,336
nerve,0.049,55,766,1,1,0.129,0.698,0.307,821
embarrass,0.048,9,136,1,1,0.082,0.667,0.364,145
violence,0.048,96,1328,1,1,0.061,0.933,0.719,1424
produced,0.048,33,465,1,1,0.724,0.528,0.693,498
need,0.048,12401,169990,1,1,0.51,0.574,0.2,182391
negative,0.048,356,4893,1,1,0.102,0.527,0.176,5249
shining,0.048,99,1370,1,1,0.885,0.673,0.812,1469
identify,0.048,58,808,1,1,0.635,0.48,0.667,866
shrinking,0.047,6,95,1,1,0.19,0.4,0.217,101
trending,0.047,20,287,1,1,0.75,0.472,0.6,307
ethic,0.047,6,95,1,1,0.786,0.26,0.791,101
west,0.047,162,2235,1,1,0.562,0.337,0.414,2397
greed,0.047,49,685,1,1,0.173,0.78,0.528,734
personality,0.047,238,3279,1,1,0.896,0.513,0.79,3517
improving,0.047,28,397,1,1,0.911,0.51,0.682,425
bees,0.046,18,260,1,1,0.562,0.635,0.412,278
inclusion,0.046,22,315,1,1,0.774,0.404,0.712,337
cloudy,0.045,26,370,1,1,0.281,0.28,0.202,396
affair,0.045,53,741,1,1,0.52,0.459,0.657,794
intensely,0.045,30,425,1,1,0.694,0.846,0.75,455
proven,0.045,46,645,1,1,0.724,0.311,0.611,691
transition,0.045,50,700,1,1,0.605,0.561,0.558,750
dart,0.045,3,54,1,1,0.417,0.608,0.5,57
compatibility,0.045,3,54,1,1,0.816,0.45,0.673,57
hallucination,0.045,3,54,1,1,0.396,0.706,0.37,57
pessimist,0.045,3,54,1,1,0.125,0.47,0.218,57
runes,0.045,3,54,1,1,0.438,0.3,0.304,57
document,0.045,7,109,1,1,0.594,0.24,0.667,116
leech,0.045,7,109,1,1,0.25,0.623,0.268,116
aircraft,0.045,3,54,1,1,0.646,0.644,0.691,57
worthwhile,0.045,39,549,1,1,0.908,0.385,0.538,588
spaceship,0.045,7,109,1,1,0.643,0.781,0.664,116
handmade,0.045,3,54,1,1,0.776,0.383,0.475,57
soapbox,0.045,3,54,1,1,0.5,0.415,0.393,57
disliked,0.045,15,219,1,1,0.062,0.51,0.221,234
counteract,0.045,3,54,1,1,0.378,0.542,0.688,57
transport,0.044,33,467,1,1,0.613,0.627,0.605,500
ladder,0.044,16,233,1,1,0.56,0.438,0.358,249
hear,0.043,1543,21262,1,1,0.76,0.429,0.444,22805
fade,0.043,109,1514,1,1,0.354,0.333,0.245,1623
milkshake,0.043,8,123,1,1,0.796,0.521,0.33,131
hush,0.043,26,371,1,1,0.471,0.231,0.312,397
tub,0.042,31,440,1,1,0.449,0.235,0.265,471
sneaking,0.042,13,192,1,1,0.203,0.755,0.545,205
smug,0.042,13,192,1,1,0.198,0.552,0.587,205
deadly,0.042,60,840,1,1,0.143,0.849,0.554,900
imagined,0.042,61,854,1,1,0.656,0.412,0.418,915
comic,0.042,71,992,1,1,0.917,0.459,0.387,1063
constitutional,0.041,4,68,1,1,0.633,0.418,0.827,72
corridor,0.041,9,137,1,1,0.604,0.589,0.592,146
courts,0.041,9,137,1,1,0.367,0.71,0.816,146
yawning,0.041,4,68,1,1,0.323,0.216,0.15,72
frequency,0.041,30,427,1,1,0.561,0.557,0.537,457
restaurant,0.041,108,1504,1,1,0.847,0.406,0.5,1612
prone,0.04,31,441,1,1,0.415,0.434,0.454,472
impatient,0.04,15,220,1,1,0.25,0.708,0.429,235
exhaustion,0.04,42,593,1,1,0.366,0.633,0.269,635
nurse,0.04,42,593,1,1,0.635,0.578,0.521,635
thrilling,0.04,10,151,1,1,0.93,0.827,0.782,161
stable,0.04,76,1063,1,1,0.725,0.204,0.735,1139
woohoo,0.04,10,151,1,1,0.658,0.67,0.451,161
animal,0.04,210,2915,1,1,0.521,0.51,0.513,3125
foresee,0.039,5,82,1,1,0.583,0.452,0.522,87
ukulele,0.039,5,82,1,1,0.513,0.358,0.365,87
aggravating,0.039,5,82,1,1,0.257,0.794,0.64,87
danger,0.038,128,1784,1,1,0.115,0.923,0.673,1912
producer,0.038,24,345,1,1,0.559,0.561,0.917,369
taboo,0.038,18,262,1,1,0.198,0.794,0.482,280
marathon,0.038,38,539,1,1,0.646,0.778,0.74,577
pro,0.037,74,1038,1,1,0.667,0.471,0.692,1112
exhausted,0.037,185,2576,1,1,0.123,0.423,0.202,2761
wrecked,0.036,14,207,1,1,0.078,0.618,0.28,221
stranded,0.036,38,540,1,1,0.292,0.459,0.219,578
maternal,0.036,7,110,1,1,0.847,0.417,0.634,117
mattress,0.035,16,235,1,1,0.612,0.255,0.397,251
advisor,0.035,8,124,1,1,0.646,0.35,0.689,132
rushing,0.035,35,499,1,1,0.398,0.821,0.529,534
script,0.034,28,402,1,1,0.61,0.45,0.527,430
thumb,0.033,21,305,1,1,0.673,0.271,0.361,326
love,0.033,18497,257350,1,1,1,0.519,0.673,275847
flicker,0.033,11,166,1,1,0.635,0.321,0.333,177
socialism,0.032,12,180,1,1,0.51,0.5,0.56,192
lane,0.032,95,1336,1,1,0.449,0.49,0.451,1431
shopping,0.032,153,2144,1,1,0.915,0.445,0.63,2297
confident,0.032,116,1629,1,1,0.765,0.324,0.723,1745
abandonment,0.031,90,1268,1,1,0.128,0.43,0.202,1358
abba,0.03,18,264,1,1,0.562,0.5,0.48,282
reassuring,0.03,18,264,1,1,0.847,0.308,0.691,282
encourage,0.03,95,1338,1,1,0.896,0.58,0.704,1433
meaningless,0.03,76,1073,1,1,0.156,0.314,0.143,1149
leading,0.03,121,1701,1,1,0.823,0.698,0.954,1822
unaware,0.03,20,292,1,1,0.208,0.355,0.31,312
designed,0.03,63,892,1,1,0.745,0.38,0.595,955
minute,0.029,299,4190,1,1,0.582,0.279,0.356,4489
bounce,0.029,33,474,1,1,0.375,0.633,0.386,507
clock,0.028,96,1355,1,1,0.677,0.173,0.407,1451
definition,0.028,97,1369,1,1,0.573,0.375,0.579,1466
loose,0.028,88,1244,1,1,0.573,0.312,0.365,1332
connect,0.027,350,4910,1,1,0.724,0.299,0.536,5260
totally,0.027,452,6339,1,1,0.82,0.422,0.702,6791
discredited,0.027,1,27,1,1,0.112,0.491,0.182,28
forthcoming,0.027,4,69,1,1,0.66,0.509,0.6,73
amaze,0.027,9,139,1,1,0.896,0.843,0.783,148
coordination,0.027,1,27,1,1,0.677,0.454,0.789,28
toothpaste,0.027,2,41,1,1,0.51,0.29,0.371,43
deuce,0.027,1,27,1,1,0.479,0.338,0.425,28
casserole,0.027,1,27,1,1,0.57,0.36,0.328,28
downfall,0.027,17,251,1,1,0.2,0.717,0.182,268
narration,0.027,5,83,1,1,0.622,0.408,0.551,88
cookery,0.027,1,27,1,1,0.633,0.368,0.345,28
antiquated,0.027,1,27,1,1,0.42,0.392,0.236,28
scandalous,0.027,3,55,1,1,0.135,0.907,0.556,58
titled,0.027,35,503,1,1,0.677,0.24,0.658,538
humongous,0.027,1,27,1,1,0.378,0.538,0.536,28
possessive,0.027,9,139,1,1,0.279,0.648,0.696,148
gob,0.027,1,27,1,1,0.28,0.357,0.447,28
stag,0.027,3,55,1,1,0.594,0.25,0.389,58
recruiter,0.027,1,27,1,1,0.662,0.63,0.69,28
oozing,0.027,3,55,1,1,0.238,0.515,0.427,58
gangster,0.027,8,125,1,1,0.292,0.833,0.655,133
disconnection,0.027,23,335,1,1,0.167,0.283,0.277,358
kaleidoscope,0.027,1,27,1,1,0.615,0.439,0.58,28
replicate,0.027,3,55,1,1,0.48,0.63,0.585,58
perpetuate,0.027,7,111,1,1,0.397,0.588,0.788,118
overpass,0.027,1,27,1,1,0.562,0.561,0.565,28
feather,0.027,11,167,1,1,0.677,0.208,0.144,178
assessment,0.027,11,167,1,1,0.75,0.623,0.658,178
skillet,0.027,2,41,1,1,0.51,0.296,0.345,43
rhino,0.027,3,55,1,1,0.531,0.549,0.555,58
revolting,0.027,3,55,1,1,0.102,0.69,0.3,58
foolproof,0.027,3,55,1,1,0.479,0.484,0.5,58
fossil,0.027,2,41,1,1,0.48,0.292,0.38,43
recycle,0.027,3,55,1,1,0.521,0.392,0.526,58
aisle,0.027,15,223,1,1,0.438,0.222,0.283,238
items,0.027,30,433,1,1,0.542,0.401,0.434,463
weepy,0.027,4,69,1,1,0.068,0.615,0.116,73
gummy,0.027,5,83,1,1,0.521,0.302,0.291,88
dodo,0.027,3,55,1,1,0.438,0.306,0.353,58
skating,0.027,16,237,1,1,0.745,0.673,0.435,253
erosion,0.027,2,41,1,1,0.312,0.77,0.465,43
scruffy,0.027,2,41,1,1,0.194,0.435,0.176,43
madden,0.027,3,55,1,1,0.329,0.602,0.457,58
impartial,0.027,1,27,1,1,0.531,0.406,0.685,28
injure,0.027,1,27,1,1,0.177,0.71,0.364,28
newsroom,0.027,3,55,1,1,0.531,0.392,0.658,58
moderator,0.027,1,27,1,1,0.519,0.354,0.802,28
washer,0.027,2,41,1,1,0.594,0.39,0.365,43
employ,0.027,4,69,1,1,0.729,0.481,0.702,73
icky,0.027,5,83,1,1,0.357,0.51,0.342,88
aid,0.027,40,573,1,1,0.796,0.491,0.541,613
chased,0.027,18,265,1,1,0.188,0.83,0.287,283
kooky,0.027,1,27,1,1,0.418,0.582,0.366,28
boardwalk,0.027,1,27,1,1,0.643,0.481,0.549,28
screenwriter,0.027,2,41,1,1,0.571,0.5,0.712,43
heartland,0.027,1,27,1,1,0.812,0.51,0.675,28
fink,0.027,1,27,1,1,0.41,0.514,0.439,28
deduce,0.027,1,27,1,1,0.49,0.51,0.466,28
culmination,0.027,1,27,1,1,0.656,0.586,0.695,28
sultry,0.027,2,41,1,1,0.735,0.696,0.627,43
snort,0.027,4,69,1,1,0.469,0.531,0.413,73
commission,0.027,16,237,1,1,0.677,0.48,0.571,253
bureau,0.027,1,27,1,1,0.562,0.373,0.618,28
excited,0.026,456,6400,1,1,0.908,0.931,0.709,6856
physical,0.026,314,4412,1,1,0.75,0.52,0.607,4726
education,0.026,87,1232,1,1,0.896,0.275,0.84,1319
kindness,0.026,168,2367,1,1,0.938,0.35,0.508,2535
included,0.025,94,1331,1,1,0.76,0.402,0.57,1425
horror,0.025,153,2159,1,1,0.115,0.85,0.438,2312
accompanying,0.024,24,350,1,1,0.787,0.46,0.582,374
terrifying,0.023,86,1221,1,1,0.031,0.836,0.602,1307
chef,0.023,20,294,1,1,0.854,0.411,0.57,314
unite,0.023,36,519,1,1,0.781,0.375,0.61,555
burdened,0.022,13,196,1,1,0.429,0.519,0.565,209
pass,0.022,425,5994,1,1,0.51,0.324,0.362,6419
pint,0.021,26,379,1,1,0.686,0.333,0.321,405
kitchen,0.021,105,1491,1,1,0.7,0.234,0.398,1596
timid,0.021,12,182,1,1,0.327,0.276,0.132,194
halo,0.021,25,365,1,1,0.49,0.37,0.441,390
hide,0.021,389,5491,1,1,0.438,0.51,0.218,5880
comparable,0.021,11,168,1,1,0.562,0.443,0.458,179
colorful,0.021,23,337,1,1,0.85,0.52,0.519,360
scientist,0.021,23,337,1,1,0.562,0.5,0.79,360
representative,0.021,11,168,1,1,0.704,0.366,0.694,179
encouraged,0.021,34,492,1,1,0.953,0.702,0.657,526
jet,0.021,22,323,1,1,0.612,0.721,0.606,345
hub,0.021,22,323,1,1,0.479,0.399,0.433,345
fantastic,0.02,169,2394,1,1,0.969,0.696,0.831,2563
economy,0.02,33,478,1,1,0.583,0.434,0.771,511
seventh,0.02,9,140,1,1,0.5,0.245,0.288,149
chance,0.019,531,7501,1,1,0.833,0.551,0.525,8032
jenny,0.019,18,267,1,1,0.542,0.406,0.407,285
blown,0.019,46,662,1,1,0.333,0.548,0.412,708
shook,0.019,45,648,1,1,0.163,0.759,0.509,693
cranky,0.019,17,253,1,1,0.194,0.776,0.396,270
infatuation,0.019,8,126,1,1,0.844,0.745,0.53,134
finger,0.019,78,1114,1,1,0.321,0.264,0.291,1192
flying,0.019,139,1975,1,1,0.877,0.606,0.696,2114
surprise,0.018,137,1947,1,1,0.875,0.875,0.562,2084
gemini,0.018,40,578,1,1,0.531,0.32,0.327,618
poisoned,0.018,7,112,1,1,0.057,0.808,0.402,119
finesse,0.018,7,112,1,1,0.74,0.387,0.412,119
outpost,0.018,7,112,1,1,0.635,0.571,0.675,119
backwoods,0.018,7,112,1,1,0.541,0.35,0.482,119
psychological,0.017,60,861,1,1,0.406,0.449,0.66,921
chain,0.017,51,734,1,1,0.378,0.5,0.547,785
booking,0.017,13,197,1,1,0.708,0.503,0.583,210
rash,0.017,6,98,1,1,0.219,0.82,0.491,104
condemnation,0.017,6,98,1,1,0.133,0.725,0.449,104
logic,0.017,62,890,1,1,0.646,0.245,0.819,952
violent,0.016,60,862,1,1,0.112,0.918,0.616,922
computer,0.016,114,1626,1,1,0.802,0.356,0.639,1740
formal,0.016,12,183,1,1,0.735,0.25,0.625,195
incapable,0.016,38,551,1,1,0.156,0.529,0.155,589
initial,0.015,24,353,1,1,0.583,0.314,0.539,377
tighten,0.015,5,84,1,1,0.388,0.487,0.627,89
eddy,0.015,5,84,1,1,0.5,0.394,0.35,89
cameo,0.015,5,84,1,1,0.573,0.457,0.509,89
ambiguous,0.015,5,84,1,1,0.265,0.462,0.358,89
bottling,0.015,5,84,1,1,0.365,0.333,0.37,89
rebound,0.014,16,240,1,1,0.521,0.48,0.506,256
strike,0.014,55,793,1,1,0.271,0.811,0.571,848
mark,0.014,203,2892,1,1,0.491,0.231,0.6,3095
inanimate,0.014,10,155,1,1,0.281,0.143,0.224,165
cheap,0.014,86,1233,1,1,0.612,0.471,0.272,1319
musical,0.014,69,992,1,1,0.908,0.63,0.53,1061
nine,0.013,58,836,1,1,0.552,0.255,0.327,894
leader,0.013,138,1971,1,1,0.833,0.582,0.926,2109
iffy,0.013,4,70,1,1,0.38,0.442,0.333,74
plum,0.013,4,70,1,1,0.724,0.306,0.17,74
pinpoint,0.013,4,70,1,1,0.583,0.443,0.528,74
incompetence,0.013,4,70,1,1,0.077,0.551,0.208,74
calculated,0.013,4,70,1,1,0.633,0.425,0.683,74
atheism,0.013,4,70,1,1,0.276,0.46,0.481,74
forevermore,0.013,4,70,1,1,0.843,0.425,0.614,74
sleeper,0.013,4,70,1,1,0.64,0.154,0.254,74
elated,0.013,4,70,1,1,0.792,0.96,0.725,74
harmful,0.012,32,468,1,1,0.094,0.75,0.291,500
bottomless,0.012,13,198,1,1,0.31,0.47,0.368,211
foreign,0.011,90,1293,1,1,0.573,0.681,0.385,1383
cent,0.01,12,184,1,1,0.439,0.367,0.402,196
direction,0.01,178,2547,1,1,0.719,0.33,0.684,2725
subside,0.009,7,113,1,1,0.375,0.308,0.209,120
acute,0.009,15,227,1,1,0.427,0.652,0.534,242
evident,0.009,15,227,1,1,0.633,0.444,0.664,242
rudeness,0.009,3,56,1,1,0.28,0.819,0.692,59
degraded,0.009,3,56,1,1,0.167,0.433,0.205,59
ramp,0.009,3,56,1,1,0.49,0.517,0.357,59
civility,0.009,3,56,1,1,0.76,0.306,0.679,59
nationality,0.009,3,56,1,1,0.642,0.4,0.772,59
jackpot,0.009,3,56,1,1,0.95,0.75,0.786,59
colt,0.009,3,56,1,1,0.561,0.587,0.543,59
subscription,0.009,11,170,1,1,0.583,0.333,0.651,181
rectify,0.009,3,56,1,1,0.625,0.48,0.634,59
deficiency,0.009,3,56,1,1,0.073,0.373,0.179,59
med,0.008,18,270,1,1,0.375,0.429,0.606,288
sports,0.008,82,1183,1,1,0.833,0.683,0.587,1265
afraid,0.008,1147,16377,1,1,0.01,0.775,0.245,17524
dwarf,0.008,14,213,1,1,0.37,0.34,0.288,227
answer,0.008,550,7862,1,1,0.537,0.373,0.661,8412
offspring,0.007,10,156,1,1,0.656,0.435,0.6,166
compassionate,0.007,32,470,1,1,0.857,0.404,0.411,502
occupy,0.007,32,470,1,1,0.396,0.52,0.589,502
thing,0.007,3720,53132,1,1,0.449,0.222,0.26,56852
deny,0.007,80,1156,1,1,0.316,0.667,0.321,1236
pose,0.006,19,285,1,1,0.427,0.33,0.361,304
existence,0.005,533,7637,1,1,0.76,0.513,0.771,8170
carpet,0.005,15,228,1,1,0.52,0.17,0.339,243
downhill,0.005,15,228,1,1,0.292,0.573,0.279,243
meaning,0.005,453,6497,1,1,0.663,0.395,0.625,6950
level,0.004,616,8832,1,1,0.622,0.277,0.491,9448
table,0.004,250,3593,1,1,0.551,0.17,0.284,3843
soundtrack,0.004,74,1073,1,1,0.63,0.559,0.518,1147
organization,0.004,24,357,1,1,0.81,0.535,0.851,381
lively,0.004,27,400,1,1,0.847,0.81,0.642,427
silver,0.004,98,1417,1,1,0.684,0.451,0.615,1515
situation,0.004,393,5644,1,1,0.531,0.387,0.6,6037
punched,0.003,11,171,1,1,0.188,0.634,0.452,182
briefing,0.003,2,42,1,1,0.612,0.333,0.702,44
lung,0.003,8,128,1,1,0.51,0.292,0.629,136
deformed,0.003,2,42,1,1,0.198,0.435,0.308,44
longtime,0.003,5,85,1,1,0.362,0.442,0.546,90
surname,0.003,2,42,1,1,0.67,0.25,0.493,44
plow,0.003,2,42,1,1,0.531,0.56,0.456,44
bearer,0.003,2,42,1,1,0.571,0.547,0.676,44
circus,0.003,26,386,1,1,0.724,0.637,0.432,412
telegraph,0.003,2,42,1,1,0.594,0.423,0.4,44
automated,0.003,5,85,1,1,0.578,0.402,0.632,90
ailment,0.003,2,42,1,1,0.146,0.734,0.277,44
partition,0.003,2,42,1,1,0.615,0.469,0.567,44
buffer,0.003,2,42,1,1,0.52,0.474,0.35,44
yucky,0.003,2,42,1,1,0.142,0.806,0.237,44
dogged,0.003,2,42,1,1,0.255,0.75,0.594,44
interface,0.003,2,42,1,1,0.643,0.357,0.6,44
manufacturing,0.003,2,42,1,1,0.653,0.613,0.804,44
fail,0.003,151,2178,1,1,0.177,0.578,0.154,2329
empathy,0.003,106,1533,1,1,0.729,0.349,0.545,1639
laughs,0.002,108,1563,1,1,0.812,0.846,0.425,1671
closet,0.002,78,1133,1,1,0.531,0.204,0.33,1211
psalms,0.002,13,200,1,1,0.602,0.252,0.534,213
election,0.002,55,803,1,1,0.625,0.519,0.651,858
enthusiast,0.001,10,157,1,1,0.867,0.81,0.875,167
positive,0.001,389,5602,1,1,0.959,0.51,0.855,5991
bell,0,58,847,1,1,0.552,0.51,0.505,905
container,0,7,114,1,1,0.551,0.396,0.561,121
arrogant,0,36,531,1,1,0.115,0.755,0.58,567
pull,-0,312,4500,1,1,0.45,0.685,0.473,4812
positivity,-0,59,862,1,1,0.959,0.549,0.87,921
marijuana,-0,12,186,1,1,0.312,0.779,0.558,198
humiliation,-0.001,17,258,1,1,0.048,0.712,0.31,275
hatred,-0.001,168,2431,1,1,0.037,0.847,0.424,2599
downside,-0.001,22,330,1,1,0.19,0.4,0.246,352
shady,-0.001,22,330,1,1,0.323,0.509,0.375,352
chill,-0.001,354,5109,1,1,0.837,0.206,0.482,5463
entertaining,-0.001,67,978,1,1,0.833,0.658,0.66,1045
amnesia,-0.001,9,143,1,1,0.296,0.33,0.308,152
label,-0.001,34,503,1,1,0.582,0.245,0.423,537
cabbage,-0.001,4,71,1,1,0.398,0.225,0.264,75
raggedy,-0.001,4,71,1,1,0.198,0.531,0.314,75
squat,-0.001,4,71,1,1,0.33,0.55,0.453,75
hometown,-0.001,39,575,1,1,0.858,0.333,0.605,614
vampire,-0.002,78,1137,1,1,0.271,0.802,0.545,1215
bonding,-0.002,26,388,1,1,0.594,0.442,0.509,414
unbelievable,-0.002,26,388,1,1,0.771,0.79,0.717,414
jump,-0.002,146,2117,1,1,0.625,0.865,0.611,2263
purple,-0.002,89,1296,1,1,0.7,0.298,0.33,1385
chatty,-0.002,16,244,1,1,0.594,0.548,0.345,260
forsake,-0.002,16,244,1,1,0.102,0.567,0.223,260
amused,-0.003,11,172,1,1,0.942,0.847,0.596,183
global,-0.003,63,922,1,1,0.583,0.52,0.713,985
chime,-0.003,6,100,1,1,0.573,0.541,0.464,106
postcard,-0.003,6,100,1,1,0.822,0.292,0.39,106
biggie,-0.003,6,100,1,1,0.531,0.481,0.5,106
husk,-0.003,6,100,1,1,0.378,0.173,0.147,106
binary,-0.005,8,129,1,1,0.49,0.356,0.42,137
naked,-0.005,224,3249,1,1,0.323,0.885,0.288,3473
siege,-0.005,8,129,1,1,0.271,0.75,0.567,137
nuts,-0.005,53,779,1,1,0.594,0.25,0.291,832
bench,-0.005,73,1068,1,1,0.571,0.289,0.544,1141
used,-0.005,2073,29963,1,1,0.354,0.306,0.287,32036
milk,-0.005,79,1155,1,1,0.817,0.27,0.327,1234
tech,-0.005,70,1025,1,1,0.684,0.491,0.732,1095
cane,-0.005,10,158,1,1,0.459,0.298,0.398,168
whoop,-0.005,10,158,1,1,0.559,0.481,0.443,168
orgasm,-0.005,21,317,1,1,0.844,0.863,0.676,338
questioning,-0.005,45,664,1,1,0.438,0.696,0.509,709
melt,-0.005,45,664,1,1,0.448,0.615,0.312,709
note,-0.006,223,3238,1,1,0.594,0.163,0.416,3461
presidency,-0.006,12,187,1,1,0.776,0.686,0.918,199
blank,-0.006,68,997,1,1,0.531,0.229,0.25,1065
surviving,-0.006,35,520,1,1,0.646,0.836,0.721,555
urge,-0.007,117,1707,1,1,0.418,0.68,0.653,1824
presentation,-0.007,22,332,1,1,0.792,0.604,0.553,354
pound,-0.007,22,332,1,1,0.57,0.337,0.443,354
chocolate,-0.007,157,2287,1,1,0.885,0.48,0.418,2444
moving,-0.007,481,6979,1,1,0.479,0.673,0.358,7460
rainbow,-0.007,55,810,1,1,0.878,0.35,0.462,865
major,-0.008,183,2665,1,1,0.684,0.538,0.874,2848
rob,-0.008,54,796,1,1,0.112,0.84,0.5,850
reflux,-0.008,1,28,1,1,0.281,0.559,0.347,29
snotty,-0.008,1,28,1,1,0.18,0.382,0.2,29
headband,-0.008,1,28,1,1,0.67,0.469,0.527,29
granddad,-0.008,1,28,1,1,0.74,0.248,0.461,29
senseless,-0.008,11,173,1,1,0.125,0.388,0.136,184
placebo,-0.008,3,57,1,1,0.52,0.306,0.365,60
wharf,-0.008,1,28,1,1,0.469,0.24,0.472,29
dint,-0.008,5,86,1,1,0.378,0.48,0.492,91
slave,-0.008,51,753,1,1,0.171,0.795,0.151,804
sponsorship,-0.008,1,28,1,1,0.854,0.608,0.696,29
baggy,-0.008,1,28,1,1,0.521,0.278,0.452,29
victimized,-0.008,3,57,1,1,0.115,0.644,0.273,60
fend,-0.008,11,173,1,1,0.646,0.731,0.537,184
sleigh,-0.008,1,28,1,1,0.742,0.551,0.396,29
pedantic,-0.008,1,28,1,1,0.229,0.608,0.253,29
attacker,-0.008,1,28,1,1,0.185,0.962,0.629,29
eyeball,-0.008,1,28,1,1,0.526,0.422,0.42,29
initiate,-0.008,17,260,1,1,0.719,0.48,0.553,277
ostrich,-0.008,1,28,1,1,0.592,0.382,0.241,29
ploy,-0.008,5,86,1,1,0.458,0.559,0.741,91
inkling,-0.008,5,86,1,1,0.448,0.551,0.57,91
pacify,-0.008,1,28,1,1,0.812,0.283,0.629,29
overthinker,-0.008,1,28,1,1,0.43,0.606,0.552,29
binder,-0.008,1,28,1,1,0.438,0.25,0.308,29
pricey,-0.008,1,28,1,1,0.34,0.567,0.43,29
ancestry,-0.008,1,28,1,1,0.708,0.519,0.717,29
induction,-0.008,1,28,1,1,0.392,0.593,0.627,29
vaginal,-0.008,1,28,1,1,0.449,0.765,0.42,29
seasoning,-0.008,1,28,1,1,0.633,0.388,0.479,29
superstore,-0.008,1,28,1,1,0.719,0.6,0.64,29
tether,-0.008,1,28,1,1,0.323,0.62,0.407,29
defamation,-0.008,1,28,1,1,0.11,0.67,0.481,29
procedure,-0.008,3,57,1,1,0.625,0.548,0.654,60
infer,-0.008,1,28,1,1,0.449,0.49,0.453,29
laundering,-0.008,1,28,1,1,0.439,0.327,0.444,29
inexperienced,-0.008,3,57,1,1,0.281,0.473,0.231,60
mutually,-0.008,13,202,1,1,0.844,0.49,0.582,215
honeysuckle,-0.008,1,28,1,1,0.597,0.451,0.517,29
pouch,-0.008,1,28,1,1,0.438,0.23,0.271,29
grumble,-0.008,1,28,1,1,0.101,0.75,0.333,29
bison,-0.008,1,28,1,1,0.573,0.433,0.557,29
believable,-0.008,5,86,1,1,0.866,0.39,0.676,91
demonstrating,-0.008,3,57,1,1,0.698,0.571,0.693,60
morsel,-0.008,1,28,1,1,0.49,0.296,0.4,29
speciality,-0.008,1,28,1,1,0.854,0.47,0.885,29
ostensibly,-0.008,1,28,1,1,0.473,0.529,0.509,29
saltwater,-0.008,1,28,1,1,0.327,0.33,0.364,29
exact,-0.009,100,1464,1,1,0.719,0.354,0.685,1564
nude,-0.009,157,2291,1,1,0.49,0.915,0.2,2448
directly,-0.009,72,1058,1,1,0.747,0.4,0.702,1130
boat,-0.009,166,2422,1,1,0.516,0.42,0.554,2588
fallout,-0.009,34,507,1,1,0.428,0.356,0.373,541
basic,-0.01,97,1422,1,1,0.643,0.102,0.395,1519
battle,-0.01,269,3920,1,1,0.365,0.945,0.868,4189
window,-0.01,238,3470,1,1,0.542,0.276,0.385,3708
effect,-0.01,140,2047,1,1,0.57,0.518,0.608,2187
flashing,-0.01,16,246,1,1,0.604,0.574,0.438,262
difficulties,-0.011,31,464,1,1,0.082,0.784,0.357,495
advise,-0.011,27,406,1,1,0.76,0.393,0.705,433
haze,-0.011,12,188,1,1,0.427,0.327,0.217,200
rampant,-0.011,12,188,1,1,0.49,0.788,0.526,200
rusty,-0.011,12,188,1,1,0.271,0.345,0.231,200
majority,-0.011,136,1991,1,1,0.684,0.56,0.93,2127
giddy,-0.012,10,159,1,1,0.438,0.847,0.611,169
finance,-0.012,10,159,1,1,0.753,0.431,0.843,169
install,-0.012,10,159,1,1,0.63,0.583,0.736,169
tunnel,-0.012,39,581,1,1,0.312,0.49,0.412,620
massive,-0.012,117,1716,1,1,0.569,0.66,0.75,1833
sense,-0.012,1204,17538,1,1,0.781,0.417,0.474,18742
songwriter,-0.012,8,130,1,1,0.844,0.558,0.713,138
cut,-0.012,454,6623,1,1,0.49,0.49,0.393,7077
hideous,-0.013,15,232,1,1,0.091,0.75,0.328,247
two,-0.013,2482,36168,1,1,0.52,0.2,0.404,38650
jasmine,-0.013,13,203,1,1,0.765,0.23,0.286,216
oppose,-0.013,6,101,1,1,0.431,0.8,0.473,107
mocking,-0.014,25,378,1,1,0.082,0.755,0.394,403
bless,-0.014,271,3966,1,1,0.929,0.269,0.588,4237
rejects,-0.014,16,247,1,1,0.083,0.637,0.422,263
censorship,-0.015,4,72,1,1,0.219,0.698,0.421,76
motherly,-0.015,4,72,1,1,0.927,0.324,0.71,76
eventful,-0.015,4,72,1,1,0.543,0.837,0.51,76
conjure,-0.015,4,72,1,1,0.385,0.679,0.645,76
rumble,-0.015,4,72,1,1,0.367,0.745,0.613,76
hull,-0.015,4,72,1,1,0.542,0.265,0.353,76
expected,-0.015,119,1751,1,1,0.729,0.412,0.545,1870
payback,-0.015,4,72,1,1,0.459,0.5,0.567,76
commander,-0.015,9,145,1,1,0.531,0.615,0.906,154
sacrifices,-0.016,30,452,1,1,0.281,0.717,0.538,482
carefully,-0.016,61,905,1,1,0.698,0.33,0.544,966
spice,-0.017,23,350,1,1,0.594,0.439,0.384,373
reassured,-0.017,7,116,1,1,0.854,0.186,0.519,123
reckon,-0.017,23,350,1,1,0.643,0.42,0.472,373
bonkers,-0.017,7,116,1,1,0.306,0.847,0.278,123
mental,-0.017,939,13752,1,1,0.49,0.49,0.585,14691
excite,-0.018,10,160,1,1,0.823,0.95,0.668,170
workaholic,-0.018,10,160,1,1,0.344,0.657,0.557,170
publicly,-0.018,35,526,1,1,0.74,0.481,0.632,561
mermaid,-0.018,16,248,1,1,0.765,0.623,0.452,264
unlike,-0.019,91,1347,1,1,0.439,0.439,0.418,1438
walk,-0.019,1339,19640,1,1,0.643,0.412,0.45,20979
immediately,-0.019,163,2403,1,1,0.552,0.78,0.707,2566
lining,-0.02,14,219,1,1,0.571,0.363,0.472,233
odor,-0.02,2,43,1,1,0.337,0.363,0.404,45
slur,-0.02,2,43,1,1,0.115,0.814,0.427,45
pant,-0.02,2,43,1,1,0.448,0.463,0.409,45
petulant,-0.02,5,87,1,1,0.247,0.685,0.491,92
hyperactive,-0.02,2,43,1,1,0.5,0.921,0.66,45
hilarity,-0.02,2,43,1,1,0.745,0.48,0.575,45
squeal,-0.02,2,43,1,1,0.25,0.731,0.375,45
deflection,-0.02,2,43,1,1,0.188,0.5,0.382,45
chateau,-0.02,2,43,1,1,0.615,0.464,0.702,45
intercourse,-0.02,5,87,1,1,0.551,0.608,0.557,92
tenfold,-0.02,2,43,1,1,0.469,0.418,0.5,45
fore,-0.02,5,87,1,1,0.667,0.417,0.654,92
melodramatic,-0.02,5,87,1,1,0.235,0.692,0.368,92
ear,-0.02,125,1847,1,1,0.469,0.216,0.231,1972
dandy,-0.02,5,87,1,1,0.673,0.52,0.63,92
mileage,-0.02,2,43,1,1,0.51,0.458,0.562,45
wheels,-0.02,17,263,1,1,0.667,0.471,0.386,280
dealership,-0.02,2,43,1,1,0.541,0.43,0.629,45
bargain,-0.02,5,87,1,1,0.653,0.533,0.67,92
responsive,-0.02,2,43,1,1,0.816,0.569,0.573,45
ponytail,-0.02,2,43,1,1,0.541,0.337,0.302,45
comply,-0.02,2,43,1,1,0.806,0.37,0.638,45
judicial,-0.02,2,43,1,1,0.378,0.667,0.833,45
blockbuster,-0.02,2,43,1,1,0.73,0.676,0.883,45
drama,-0.02,237,3491,1,1,0.43,0.755,0.481,3728
cling,-0.02,45,674,1,1,0.417,0.62,0.588,719
unrealistic,-0.021,21,322,1,1,0.229,0.5,0.245,343
goodness,-0.021,81,1203,1,1,0.969,0.321,0.715,1284
prove,-0.021,138,2040,1,1,0.583,0.52,0.566,2178
nervous,-0.021,116,1717,1,1,0.235,0.82,0.213,1833
ache,-0.021,120,1776,1,1,0.146,0.76,0.312,1896
countdown,-0.022,12,190,1,1,0.438,0.692,0.49,202
dopamine,-0.022,12,190,1,1,0.548,0.469,0.426,202
sadistic,-0.022,9,146,1,1,0.031,0.906,0.618,155
ridiculed,-0.022,9,146,1,1,0.112,0.806,0.212,155
basketball,-0.023,30,455,1,1,0.814,0.764,0.435,485
glee,-0.023,13,205,1,1,0.698,0.58,0.464,218
employer,-0.023,6,102,1,1,0.663,0.518,0.767,108
grumpy,-0.023,48,720,1,1,0.198,0.808,0.559,768
suppose,-0.023,176,2604,1,1,0.551,0.343,0.348,2780
ride,-0.024,318,4696,1,1,0.806,0.465,0.472,5014
serenade,-0.024,10,161,1,1,0.875,0.57,0.491,171
regime,-0.024,10,161,1,1,0.29,0.668,0.773,171
wistful,-0.024,10,161,1,1,0.323,0.451,0.312,171
strong,-0.024,819,12080,1,1,0.912,0.745,0.895,12899
demo,-0.024,14,220,1,1,0.51,0.314,0.423,234
rude,-0.025,143,2121,1,1,0.061,0.821,0.402,2264
careless,-0.025,18,279,1,1,0.255,0.431,0.125,297
irrational,-0.025,22,338,1,1,0.125,0.648,0.394,360
long,-0.025,3737,55111,1,1,0.541,0.353,0.543,58848
loveee,-0.025,7,117,1,1,0.927,0.592,0.693,124
burnt,-0.025,35,530,1,1,0.082,0.713,0.356,565
bullock,-0.025,3,58,1,1,0.281,0.402,0.375,61
steamy,-0.025,3,58,1,1,0.479,0.538,0.445,61
rewind,-0.025,11,176,1,1,0.46,0.551,0.431,187
skirts,-0.025,3,58,1,1,0.622,0.538,0.241,61
offence,-0.025,11,176,1,1,0.312,0.798,0.446,187
consensual,-0.025,3,58,1,1,0.663,0.417,0.655,61
leeches,-0.025,3,58,1,1,0.115,0.698,0.295,61
hedge,-0.025,3,58,1,1,0.604,0.602,0.569,61
optimist,-0.025,3,58,1,1,0.875,0.539,0.787,61
ripple,-0.025,3,58,1,1,0.5,0.453,0.37,61
intimidation,-0.025,3,58,1,1,0.177,0.791,0.644,61
royalty,-0.025,7,117,1,1,0.832,0.571,0.833,124
good,-0.026,7387,108995,1,1,0.938,0.368,0.534,116382
market,-0.026,79,1180,1,1,0.724,0.48,0.521,1259
juicy,-0.027,12,191,1,1,0.823,0.529,0.49,203
vinyl,-0.027,25,383,1,1,0.49,0.241,0.44,408
log,-0.027,62,930,1,1,0.591,0.371,0.395,992
suspect,-0.028,54,812,1,1,0.133,0.75,0.509,866
neighborhood,-0.028,50,753,1,1,0.385,0.469,0.373,803
faux,-0.028,13,206,1,1,0.291,0.49,0.204,219
pile,-0.028,51,768,1,1,0.461,0.32,0.539,819
weed,-0.029,152,2263,1,1,0.459,0.294,0.364,2415
pluck,-0.029,4,73,1,1,0.375,0.583,0.474,77
indescribable,-0.029,14,221,1,1,0.448,0.529,0.648,235
yummy,-0.029,9,147,1,1,0.878,0.55,0.658,156
celibate,-0.029,19,295,1,1,0.419,0.387,0.391,314
intrusive,-0.029,9,147,1,1,0.461,0.607,0.538,156
glue,-0.029,14,221,1,1,0.45,0.345,0.349,235
bring,-0.03,980,14535,1,1,0.635,0.46,0.462,15515
newly,-0.03,21,325,1,1,0.688,0.422,0.552,346
open,-0.031,1095,16247,1,1,0.62,0.48,0.569,17342
scenario,-0.031,39,592,1,1,0.667,0.51,0.683,631
turned,-0.031,417,6199,1,1,0.63,0.538,0.583,6616
rum,-0.031,17,266,1,1,0.561,0.377,0.451,283
cabinet,-0.031,17,266,1,1,0.552,0.306,0.465,283
holocaust,-0.031,5,88,1,1,0.062,0.918,0.618,93
hollow,-0.031,73,1097,1,1,0.3,0.337,0.222,1170
directed,-0.031,36,548,1,1,0.542,0.49,0.541,584
captain,-0.031,67,1008,1,1,0.552,0.653,0.966,1075
overcoming,-0.032,25,385,1,1,0.842,0.765,0.855,410
sale,-0.032,51,771,1,1,0.647,0.602,0.573,822
constantly,-0.032,567,8432,1,1,0.663,0.561,0.7,8999
knee,-0.032,26,400,1,1,0.52,0.245,0.396,426
shift,-0.032,142,2123,1,1,0.479,0.61,0.491,2265
approve,-0.033,13,207,1,1,0.875,0.548,0.741,220
veteran,-0.033,20,311,1,1,0.56,0.431,0.759,331
refer,-0.033,29,445,1,1,0.506,0.358,0.558,474
estate,-0.034,38,579,1,1,0.653,0.385,0.647,617
nowadays,-0.034,142,2126,1,1,0.68,0.346,0.4,2268
ether,-0.034,7,118,1,1,0.49,0.306,0.412,125
needless,-0.034,15,237,1,1,0.327,0.385,0.2,252
swearing,-0.034,7,118,1,1,0.333,0.559,0.586,125
immigration,-0.034,15,237,1,1,0.39,0.667,0.454,252
mating,-0.035,8,133,1,1,0.755,0.84,0.759,141
scarf,-0.035,8,133,1,1,0.75,0.224,0.224,141
egotistical,-0.035,8,133,1,1,0.156,0.667,0.363,141
voting,-0.036,49,744,1,1,0.615,0.602,0.768,793
south,-0.036,161,2413,1,1,0.562,0.265,0.429,2574
memories,-0.036,514,7674,1,1,0.963,0.487,0.51,8188
adolescent,-0.036,10,163,1,1,0.781,0.68,0.509,173
discarded,-0.036,10,163,1,1,0.229,0.46,0.308,173
applaud,-0.036,10,163,1,1,0.865,0.824,0.464,173
trick,-0.037,70,1058,1,1,0.542,0.7,0.409,1128
rut,-0.037,11,178,1,1,0.333,0.31,0.392,189
ken,-0.037,24,372,1,1,0.438,0.409,0.36,396
second,-0.037,624,9325,1,1,0.49,0.21,0.25,9949
trustworthy,-0.038,13,208,1,1,0.969,0.315,0.824,221
culture,-0.038,225,3373,1,1,0.753,0.304,0.675,3598
drift,-0.038,65,985,1,1,0.316,0.52,0.375,1050
principle,-0.039,18,283,1,1,0.75,0.306,0.629,301
passenger,-0.039,19,298,1,1,0.717,0.413,0.481,317
will,-0.039,11853,177293,1,1,0.698,0.408,0.735,189146
intimidating,-0.039,22,343,1,1,0.229,0.79,0.708,365
court,-0.041,78,1182,1,1,0.479,0.769,0.827,1260
ruin,-0.041,161,2426,1,1,0.125,0.588,0.192,2587
squad,-0.041,111,1677,1,1,0.552,0.711,0.806,1788
polo,-0.042,3,59,1,1,0.582,0.36,0.415,62
munchkin,-0.042,1,29,1,1,0.49,0.466,0.374,30
matinee,-0.042,1,29,1,1,0.694,0.578,0.447,30
corral,-0.042,1,29,1,1,0.606,0.662,0.422,30
padre,-0.042,3,59,1,1,0.684,0.407,0.647,62
unfailing,-0.042,1,29,1,1,0.625,0.635,0.594,30
drool,-0.042,3,59,1,1,0.385,0.398,0.204,62
marsh,-0.042,4,74,1,1,0.302,0.358,0.277,78
ciao,-0.042,4,74,1,1,0.542,0.426,0.409,78
snip,-0.042,1,29,1,1,0.417,0.327,0.268,30
bypass,-0.042,3,59,1,1,0.429,0.418,0.353,62
quarantine,-0.042,3,59,1,1,0.16,0.577,0.589,62
resistant,-0.042,3,59,1,1,0.592,0.585,0.815,62
maverick,-0.042,4,74,1,1,0.354,0.676,0.409,78
pavement,-0.042,6,104,1,1,0.46,0.353,0.475,110
peg,-0.042,5,89,1,1,0.52,0.357,0.393,94
unbeatable,-0.042,1,29,1,1,0.735,0.719,0.681,30
orangutan,-0.042,1,29,1,1,0.43,0.56,0.471,30
magnifying,-0.042,2,44,1,1,0.594,0.265,0.406,46
playtime,-0.042,3,59,1,1,0.76,0.596,0.566,62
renegade,-0.042,2,44,1,1,0.14,0.64,0.509,46
brick,-0.042,27,419,1,1,0.217,0.418,0.368,446
arousal,-0.042,1,29,1,1,0.791,0.943,0.731,30
transformer,-0.042,2,44,1,1,0.582,0.582,0.723,46
baboon,-0.042,1,29,1,1,0.357,0.41,0.429,30
tint,-0.042,2,44,1,1,0.582,0.292,0.273,46
corpse,-0.042,18,284,1,1,0.094,0.657,0.232,302
buoy,-0.042,1,29,1,1,0.562,0.28,0.284,30
landslide,-0.042,4,74,1,1,0.25,0.864,0.53,78
frostbite,-0.042,1,29,1,1,0.203,0.38,0.566,30
plummet,-0.042,1,29,1,1,0.302,0.75,0.36,30
bodyguard,-0.042,4,74,1,1,0.51,0.71,0.754,78
flamingo,-0.042,3,59,1,1,0.667,0.451,0.482,62
hyphen,-0.042,1,29,1,1,0.552,0.356,0.381,30
personnel,-0.042,3,59,1,1,0.729,0.344,0.587,62
relevancy,-0.042,2,44,1,1,0.724,0.481,0.673,46
rook,-0.042,1,29,1,1,0.38,0.4,0.51,30
wrongdoing,-0.042,1,29,1,1,0.112,0.745,0.451,30
monstrosity,-0.042,1,29,1,1,0.094,0.933,0.611,30
lightweight,-0.042,3,59,1,1,0.67,0.3,0.358,62
vulgar,-0.042,5,89,1,1,0.083,0.82,0.445,94
hotdog,-0.042,2,44,1,1,0.72,0.438,0.373,46
ovation,-0.042,1,29,1,1,0.719,0.758,0.75,30
investigative,-0.042,1,29,1,1,0.562,0.6,0.704,30
lapse,-0.042,8,134,1,1,0.42,0.316,0.281,142
controller,-0.042,9,149,1,1,0.469,0.712,0.868,158
editorial,-0.042,2,44,1,1,0.583,0.33,0.57,46
cupboard,-0.042,8,134,1,1,0.553,0.2,0.304,142
sunglasses,-0.042,7,119,1,1,0.844,0.443,0.364,126
clod,-0.042,1,29,1,1,0.375,0.404,0.365,30
cuckoo,-0.042,3,59,1,1,0.42,0.459,0.284,62
scalp,-0.042,2,44,1,1,0.347,0.346,0.302,46
exalt,-0.042,1,29,1,1,0.656,0.75,0.745,30
educate,-0.042,19,299,1,1,0.76,0.38,0.728,318
front,-0.042,387,5820,1,1,0.677,0.35,0.623,6207
change,-0.043,1134,17031,1,1,0.625,0.575,0.606,18165
apply,-0.043,68,1035,1,1,0.612,0.321,0.667,1103
feet,-0.044,252,3801,1,1,0.51,0.24,0.292,4053
unfortunately,-0.044,162,2449,1,1,0.104,0.494,0.281,2611
entire,-0.045,532,8012,1,1,0.689,0.462,0.698,8544
arms,-0.046,391,5898,1,1,0.464,0.395,0.483,6289
throwback,-0.046,19,300,1,1,0.28,0.454,0.356,319
hour,-0.047,722,10891,1,1,0.552,0.265,0.336,11613
overwhelming,-0.047,204,3088,1,1,0.327,0.83,0.64,3292
stink,-0.047,13,210,1,1,0.042,0.481,0.18,223
vine,-0.047,13,210,1,1,0.531,0.292,0.405,223
heroine,-0.047,12,195,1,1,0.729,0.755,0.833,207
scandal,-0.047,12,195,1,1,0.122,0.821,0.557,207
affecting,-0.048,24,376,1,1,0.35,0.574,0.394,400
receiving,-0.048,48,738,1,1,0.719,0.562,0.623,786
lights,-0.048,256,3875,1,1,0.75,0.48,0.575,4131
legs,-0.048,95,1447,1,1,0.479,0.407,0.228,1542
drone,-0.048,11,180,1,1,0.429,0.686,0.596,191
prescription,-0.048,11,180,1,1,0.302,0.337,0.568,191
chit,-0.048,11,180,1,1,0.49,0.352,0.321,191
reasons,-0.048,346,5233,1,1,0.583,0.46,0.571,5579
shivering,-0.048,10,165,1,1,0.122,0.663,0.373,175
holy,-0.048,324,4904,1,1,0.812,0.112,0.69,5228
freezer,-0.049,9,150,1,1,0.396,0.406,0.407,159
scarier,-0.049,9,150,1,1,0.156,0.846,0.472,159
undefined,-0.05,8,135,1,1,0.26,0.418,0.35,143
fictional,-0.05,41,634,1,1,0.43,0.49,0.34,675
expect,-0.05,298,4520,1,1,0.469,0.327,0.377,4818
welfare,-0.051,15,241,1,1,0.802,0.378,0.679,256
musk,-0.051,7,120,1,1,0.469,0.454,0.453,127
bind,-0.051,15,241,1,1,0.398,0.462,0.448,256
rust,-0.051,7,120,1,1,0.281,0.265,0.321,127
worldwide,-0.051,22,347,1,1,0.79,0.462,0.851,369
nick,-0.051,68,1043,1,1,0.554,0.388,0.387,1111
small,-0.051,980,14846,1,1,0.542,0.205,0.12,15826
surprisingly,-0.051,36,559,1,1,0.847,0.793,0.819,595
arguments,-0.051,35,544,1,1,0.541,0.602,0.657,579
inept,-0.052,13,211,1,1,0.156,0.418,0.209,224
overtime,-0.052,13,211,1,1,0.447,0.504,0.529,224
improved,-0.052,20,317,1,1,0.919,0.48,0.679,337
controversial,-0.052,13,211,1,1,0.271,0.858,0.538,224
blog,-0.053,55,848,1,1,0.639,0.39,0.432,903
trading,-0.053,30,469,1,1,0.635,0.602,0.705,499
way,-0.053,5123,77695,1,1,0.48,0.275,0.42,82818
epitome,-0.053,23,363,1,1,0.51,0.5,0.667,386
cook,-0.053,112,1713,1,1,0.847,0.5,0.412,1825
minority,-0.054,33,515,1,1,0.31,0.332,0.211,548
tar,-0.056,4,75,1,1,0.438,0.44,0.57,79
schoolwork,-0.056,4,75,1,1,0.479,0.5,0.481,79
recipient,-0.056,4,75,1,1,0.604,0.324,0.679,79
rephrase,-0.056,4,75,1,1,0.547,0.451,0.549,79
line,-0.056,518,7889,1,1,0.541,0.18,0.353,8407
shade,-0.057,58,897,1,1,0.388,0.265,0.278,955
infatuated,-0.057,8,136,1,1,0.729,0.764,0.417,144
tearful,-0.057,8,136,1,1,0.208,0.5,0.184,144
dare,-0.057,129,1978,1,1,0.677,0.788,0.684,2107
house,-0.057,1956,29791,1,1,0.587,0.135,0.533,31747
screw,-0.057,43,669,1,1,0.385,0.46,0.377,712
undesirable,-0.058,12,197,1,1,0.177,0.644,0.26,209
business,-0.058,469,7160,1,1,0.688,0.569,0.755,7629
mentor,-0.058,24,380,1,1,0.719,0.455,0.777,404
trophy,-0.059,27,426,1,1,0.947,0.643,0.676,453
surplus,-0.059,3,60,1,1,0.602,0.68,0.63,63
perish,-0.059,23,365,1,1,0.296,0.57,0.415,388
explosive,-0.059,3,60,1,1,0.156,0.943,0.663,63
dealer,-0.059,11,182,1,1,0.799,0.615,0.683,193
faceless,-0.059,7,121,1,1,0.23,0.406,0.173,128
galaxy,-0.059,50,777,1,1,0.75,0.571,0.75,827
mirror,-0.06,203,3113,1,1,0.677,0.31,0.438,3316
ptsd,-0.06,43,671,1,1,0.373,0.52,0.346,714
yawn,-0.06,10,167,1,1,0.385,0.12,0.139,177
outright,-0.06,10,167,1,1,0.767,0.396,0.755,177
times,-0.06,2650,40489,1,1,0.49,0.279,0.439,43139
psychiatrist,-0.061,17,274,1,1,0.489,0.627,0.765,291
common,-0.061,255,3911,1,1,0.6,0.127,0.318,4166
swollen,-0.061,6,106,1,1,0.236,0.51,0.277,112
suspected,-0.061,6,106,1,1,0.173,0.755,0.452,112
yey,-0.061,6,106,1,1,0.677,0.53,0.29,112
specific,-0.062,100,1544,1,1,0.656,0.388,0.691,1644
incorrect,-0.063,12,198,1,1,0.14,0.569,0.255,210
shoes,-0.063,93,1438,1,1,0.729,0.324,0.21,1531
bury,-0.063,50,780,1,1,0.077,0.571,0.346,830
title,-0.063,127,1960,1,1,0.708,0.356,0.574,2087
suffering,-0.064,459,7048,1,1,0.02,0.719,0.235,7507
widen,-0.064,2,45,1,1,0.562,0.538,0.527,47
resembling,-0.064,2,45,1,1,0.592,0.25,0.529,47
inspector,-0.064,2,45,1,1,0.418,0.58,0.852,47
incite,-0.064,2,45,1,1,0.449,0.736,0.642,47
deficient,-0.064,2,45,1,1,0.24,0.464,0.132,47
christmastime,-0.064,2,45,1,1,0.837,0.588,0.515,47
lancer,-0.064,2,45,1,1,0.417,0.528,0.519,47
mick,-0.064,8,137,1,1,0.449,0.451,0.382,145
wacky,-0.064,5,91,1,1,0.153,0.72,0.321,96
glorified,-0.064,5,91,1,1,0.865,0.57,0.886,96
swamped,-0.064,2,45,1,1,0.156,0.48,0.27,47
sully,-0.064,2,45,1,1,0.378,0.55,0.37,47
uncalled,-0.064,2,45,1,1,0.344,0.294,0.222,47
perk,-0.064,8,137,1,1,0.903,0.519,0.682,145
raid,-0.064,11,183,1,1,0.35,0.726,0.56,194
due,-0.064,399,6133,1,1,0.562,0.34,0.467,6532
worth,-0.065,979,15030,1,1,0.872,0.51,0.889,16009
fortunate,-0.065,37,582,1,1,0.927,0.639,0.836,619
life,-0.065,12677,194591,1,1,0.918,0.615,0.824,207268
wasted,-0.065,104,1611,1,1,0.188,0.558,0.259,1715
patient,-0.066,119,1842,1,1,0.583,0.193,0.34,1961
nuisance,-0.066,10,168,1,1,0.198,0.817,0.227,178
wright,-0.066,10,168,1,1,0.54,0.528,0.389,178
naming,-0.066,10,168,1,1,0.667,0.41,0.559,178
sore,-0.066,32,506,1,1,0.094,0.65,0.224,538
outline,-0.066,10,168,1,1,0.542,0.365,0.509,178
population,-0.067,75,1167,1,1,0.615,0.423,0.667,1242
valid,-0.067,72,1121,1,1,0.693,0.353,0.565,1193
toll,-0.067,53,829,1,1,0.296,0.422,0.453,882
crop,-0.067,7,122,1,1,0.615,0.26,0.5,129
collusion,-0.067,7,122,1,1,0.365,0.51,0.4,129
fist,-0.068,25,399,1,1,0.333,0.686,0.481,424
inmate,-0.069,4,76,1,1,0.235,0.663,0.398,80
sheen,-0.069,4,76,1,1,0.812,0.51,0.712,80
contributor,-0.069,4,76,1,1,0.844,0.51,0.76,80
mislead,-0.069,4,76,1,1,0.167,0.765,0.412,80
hairy,-0.069,14,230,1,1,0.542,0.38,0.343,244
sector,-0.069,14,230,1,1,0.594,0.19,0.569,244
enraged,-0.069,4,76,1,1,0.083,0.962,0.636,80
bumpy,-0.069,4,76,1,1,0.306,0.683,0.419,80
fourteen,-0.069,4,76,1,1,0.552,0.279,0.308,80
junk,-0.069,46,723,1,1,0.115,0.481,0.118,769
mortality,-0.069,26,415,1,1,0.229,0.726,0.518,441
murder,-0.069,75,1170,1,1,0.061,0.942,0.615,1245
aka,-0.069,140,2172,1,1,0.459,0.358,0.351,2312
flawed,-0.069,16,261,1,1,0.133,0.49,0.194,277
fantasy,-0.07,139,2157,1,1,0.88,0.627,0.474,2296
embodiment,-0.07,11,184,1,1,0.562,0.69,0.663,195
assured,-0.07,18,292,1,1,0.878,0.327,0.754,310
masquerade,-0.07,6,107,1,1,0.431,0.633,0.446,113
persuade,-0.07,6,107,1,1,0.62,0.618,0.709,113
swinging,-0.07,13,215,1,1,0.656,0.51,0.312,228
feature,-0.071,43,678,1,1,0.667,0.314,0.679,721
addiction,-0.071,124,1928,1,1,0.18,0.806,0.42,2052
angle,-0.071,29,462,1,1,0.541,0.33,0.455,491
injury,-0.071,22,354,1,1,0.049,0.769,0.287,376
cards,-0.071,86,1342,1,1,0.568,0.317,0.32,1428
headaches,-0.071,15,246,1,1,0.104,0.72,0.259,261
jersey,-0.071,31,493,1,1,0.594,0.317,0.411,524
vanished,-0.071,24,385,1,1,0.208,0.566,0.255,409
entertained,-0.071,33,524,1,1,0.902,0.644,0.712,557
hive,-0.071,8,138,1,1,0.471,0.452,0.544,146
huff,-0.071,8,138,1,1,0.388,0.491,0.315,146
camera,-0.072,87,1359,1,1,0.64,0.288,0.379,1446
serial,-0.072,32,509,1,1,0.469,0.35,0.472,541
carol,-0.072,23,370,1,1,0.673,0.412,0.436,393
motivate,-0.072,23,370,1,1,0.812,0.776,0.873,393
football,-0.073,101,1576,1,1,0.755,0.76,0.582,1677
looming,-0.073,12,200,1,1,0.367,0.75,0.528,212
sinner,-0.073,12,200,1,1,0.237,0.667,0.356,212
cautious,-0.073,14,231,1,1,0.47,0.445,0.517,245
gray,-0.073,93,1453,1,1,0.335,0.153,0.189,1546
crushed,-0.074,43,680,1,1,0.167,0.647,0.3,723
drunken,-0.074,30,479,1,1,0.155,0.849,0.25,509
increase,-0.075,74,1161,1,1,0.81,0.657,0.886,1235
reality,-0.075,568,8815,1,1,0.786,0.365,0.787,9383
conversation,-0.075,478,7421,1,1,0.75,0.51,0.609,7899
downcast,-0.075,1,30,1,1,0.071,0.5,0.222,31
squirm,-0.075,1,30,1,1,0.235,0.824,0.373,31
pharaoh,-0.075,1,30,1,1,0.656,0.491,0.798,31
schoolgirl,-0.075,1,30,1,1,0.76,0.521,0.415,31
giving,-0.075,605,9392,1,1,0.795,0.333,0.585,9997
unsolved,-0.075,3,61,1,1,0.146,0.39,0.235,64
riot,-0.075,11,185,1,1,0.061,0.946,0.586,196
rhyming,-0.075,1,30,1,1,0.729,0.41,0.5,31
landlady,-0.075,1,30,1,1,0.677,0.303,0.417,31
gazillion,-0.075,1,30,1,1,0.531,0.534,0.538,31
woodpecker,-0.075,7,123,1,1,0.52,0.482,0.445,130
outburst,-0.075,3,61,1,1,0.209,0.802,0.528,64
stooge,-0.075,1,30,1,1,0.438,0.406,0.163,31
organizer,-0.075,1,30,1,1,0.604,0.577,0.846,31
pepperoni,-0.075,5,92,1,1,0.796,0.472,0.358,97
topical,-0.075,1,30,1,1,0.561,0.34,0.5,31
pear,-0.075,3,61,1,1,0.677,0.158,0.241,64
tuxedo,-0.075,1,30,1,1,0.694,0.354,0.519,31
proportional,-0.075,3,61,1,1,0.729,0.38,0.621,64
distressing,-0.075,5,92,1,1,0.075,0.75,0.375,97
terrorize,-0.075,1,30,1,1,0.041,0.907,0.577,31
cooperate,-0.075,3,61,1,1,0.898,0.451,0.582,64
indefensible,-0.075,1,30,1,1,0.173,0.647,0.484,31
pinkie,-0.075,1,30,1,1,0.663,0.265,0.269,31
succubus,-0.075,5,92,1,1,0.417,0.647,0.509,97
cussed,-0.075,1,30,1,1,0.156,0.625,0.454,31
costly,-0.075,5,92,1,1,0.316,0.65,0.642,97
insomniac,-0.075,13,216,1,1,0.231,0.367,0.329,229
remorseful,-0.075,1,30,1,1,0.347,0.429,0.25,31
vibes,-0.075,177,2759,1,1,0.635,0.688,0.574,2936
scare,-0.076,73,1147,1,1,0.122,0.91,0.264,1220
code,-0.076,92,1442,1,1,0.583,0.308,0.491,1534
affect,-0.076,82,1287,1,1,0.458,0.569,0.578,1369
manipulation,-0.077,20,325,1,1,0.188,0.775,0.536,345
drove,-0.077,60,946,1,1,0.541,0.528,0.623,1006
cringe,-0.077,35,558,1,1,0.245,0.84,0.377,593
admitting,-0.077,35,558,1,1,0.62,0.5,0.546,593
windy,-0.077,16,263,1,1,0.33,0.541,0.528,279
version,-0.077,257,4007,1,1,0.604,0.423,0.538,4264
smallest,-0.078,25,403,1,1,0.281,0.34,0.129,428
migraine,-0.078,10,170,1,1,0.135,0.783,0.318,180
autistic,-0.078,41,652,1,1,0.367,0.337,0.404,693
easily,-0.078,312,4866,1,1,0.885,0.279,0.453,5178
hazard,-0.079,8,139,1,1,0.112,0.884,0.757,147
confirm,-0.079,35,559,1,1,0.802,0.439,0.806,594
fulfill,-0.079,51,808,1,1,0.784,0.461,0.577,859
floor,-0.079,198,3096,1,1,0.43,0.23,0.25,3294
careful,-0.079,123,1929,1,1,0.625,0.538,0.53,2052
nice,-0.08,1754,27342,1,1,0.93,0.442,0.65,29096
insignificant,-0.08,30,482,1,1,0.083,0.306,0.114,512
liquor,-0.081,28,451,1,1,0.603,0.702,0.433,479
upper,-0.081,33,529,1,1,0.74,0.529,0.868,562
snack,-0.081,26,420,1,1,0.646,0.407,0.345,446
cheeky,-0.081,9,155,1,1,0.434,0.679,0.41,164
giver,-0.081,9,155,1,1,0.688,0.415,0.658,164
constellation,-0.081,4,77,1,1,0.719,0.533,0.775,81
citizen,-0.081,24,389,1,1,0.631,0.25,0.586,413
insufficient,-0.081,4,77,1,1,0.188,0.38,0.093,81
praising,-0.081,9,155,1,1,0.906,0.557,0.623,164
grandson,-0.081,9,155,1,1,0.778,0.333,0.5,164
footage,-0.081,14,233,1,1,0.625,0.235,0.364,247
crutch,-0.081,9,155,1,1,0.302,0.294,0.302,164
moderately,-0.081,4,77,1,1,0.604,0.264,0.5,81
masochist,-0.081,4,77,1,1,0.164,0.784,0.353,81
county,-0.082,56,889,1,1,0.479,0.368,0.545,945
tantrum,-0.082,12,202,1,1,0.219,0.817,0.404,214
wrong,-0.083,1493,23337,1,1,0.042,0.582,0.48,24830
fact,-0.083,1039,16247,1,1,0.683,0.333,0.618,17286
act,-0.083,474,7420,1,1,0.656,0.704,0.735,7894
part,-0.083,1717,26842,1,1,0.663,0.278,0.36,28559
adjective,-0.083,7,124,1,1,0.57,0.316,0.569,131
advocate,-0.083,23,374,1,1,0.551,0.53,0.818,397
piece,-0.084,481,7535,1,1,0.646,0.245,0.367,8016
client,-0.084,21,343,1,1,0.583,0.45,0.618,364
bass,-0.084,32,515,1,1,0.427,0.206,0.268,547
screen,-0.084,145,2282,1,1,0.67,0.3,0.417,2427
riding,-0.084,90,1422,1,1,0.694,0.654,0.62,1512
threatening,-0.084,24,390,1,1,0.071,0.875,0.652,414
elders,-0.084,27,437,1,1,0.602,0.26,0.441,464
van,-0.084,64,1016,1,1,0.561,0.378,0.425,1080
willow,-0.085,16,265,1,1,0.604,0.245,0.4,281
snail,-0.085,16,265,1,1,0.48,0.104,0.296,281
massage,-0.085,36,578,1,1,0.708,0.356,0.413,614
pressure,-0.085,180,2833,1,1,0.36,0.65,0.623,3013
allegiance,-0.086,2,46,1,1,0.917,0.398,0.75,48
rivalry,-0.086,2,46,1,1,0.192,0.765,0.538,48
grump,-0.086,2,46,1,1,0.26,0.469,0.425,48
sesame,-0.086,2,46,1,1,0.673,0.25,0.382,48
doughnut,-0.086,2,46,1,1,0.663,0.38,0.279,48
beau,-0.086,8,140,1,1,0.612,0.44,0.432,148
suv,-0.086,2,46,1,1,0.552,0.431,0.446,48
ergo,-0.086,2,46,1,1,0.385,0.4,0.385,48
pledged,-0.086,2,46,1,1,0.719,0.63,0.658,48
beluga,-0.086,2,46,1,1,0.51,0.333,0.482,48
gizmo,-0.086,2,46,1,1,0.51,0.49,0.337,48
milky,-0.086,11,187,1,1,0.517,0.283,0.311,198
logistics,-0.086,2,46,1,1,0.633,0.5,0.73,48
spoof,-0.086,2,46,1,1,0.49,0.594,0.381,48
dashing,-0.086,2,46,1,1,0.612,0.627,0.799,48
mortgage,-0.086,5,93,1,1,0.255,0.408,0.537,98
misleading,-0.086,8,140,1,1,0.07,0.66,0.272,148
degenerate,-0.086,11,187,1,1,0.069,0.724,0.264,198
opponent,-0.086,8,140,1,1,0.08,0.741,0.716,148
null,-0.086,2,46,1,1,0.253,0.147,0.152,48
measurement,-0.086,2,46,1,1,0.622,0.418,0.491,48
sumo,-0.086,2,46,1,1,0.48,0.394,0.564,48
malaria,-0.086,2,46,1,1,0.125,0.653,0.304,48
convention,-0.086,17,281,1,1,0.622,0.622,0.704,298
reactionary,-0.086,2,46,1,1,0.406,0.573,0.69,48
globe,-0.086,23,375,1,1,0.76,0.315,0.364,398
narrow,-0.087,34,548,1,1,0.26,0.368,0.356,582
anniversary,-0.087,63,1003,1,1,0.88,0.77,0.723,1066
track,-0.088,204,3217,1,1,0.448,0.433,0.526,3421
racial,-0.088,9,156,1,1,0.292,0.519,0.513,165
happen,-0.088,509,8006,1,1,0.677,0.67,0.551,8515
founder,-0.088,19,313,1,1,0.76,0.465,0.891,332
swing,-0.088,46,737,1,1,0.602,0.51,0.481,783
shelter,-0.088,88,1397,1,1,0.704,0.229,0.569,1485
celebrate,-0.088,198,3125,1,1,0.917,0.857,0.859,3323
beating,-0.088,85,1350,1,1,0.153,0.833,0.481,1435
border,-0.089,44,706,1,1,0.406,0.382,0.424,750
sweep,-0.089,13,219,1,1,0.448,0.385,0.383,232
homosexuality,-0.089,6,109,1,1,0.367,0.696,0.429,115
disguise,-0.089,45,722,1,1,0.573,0.694,0.431,767
potatoes,-0.089,17,282,1,1,0.69,0.271,0.309,299
event,-0.089,179,2829,1,1,0.745,0.673,0.664,3008
meeting,-0.09,268,4230,1,1,0.75,0.569,0.613,4498
curse,-0.09,245,3870,1,1,0.033,0.72,0.375,4115
research,-0.09,168,2659,1,1,0.633,0.663,0.741,2827
future,-0.091,668,10535,1,1,0.888,0.644,0.786,11203
blond,-0.091,11,188,1,1,0.59,0.49,0.49,199
tasty,-0.091,11,188,1,1,0.959,0.786,0.555,199
nightclub,-0.091,3,62,1,1,0.802,0.894,0.528,65
dissociation,-0.091,3,62,1,1,0.135,0.555,0.471,65
speedy,-0.091,3,62,1,1,0.625,0.625,0.793,65
vertigo,-0.091,3,62,1,1,0.292,0.655,0.445,65
touching,-0.091,67,1070,1,1,0.76,0.439,0.491,1137
patrol,-0.092,12,204,1,1,0.427,0.664,0.736,216
emotional,-0.092,535,8453,1,1,0.779,0.714,0.526,8988
clothes,-0.093,118,1876,1,1,0.833,0.27,0.414,1994
season,-0.093,613,9685,1,1,0.792,0.41,0.519,10298
whiskey,-0.093,57,914,1,1,0.612,0.706,0.441,971
pathological,-0.093,8,141,1,1,0.22,0.602,0.58,149
pep,-0.093,8,141,1,1,0.51,0.51,0.364,149
ambitious,-0.093,17,283,1,1,0.484,0.821,0.717,300
alienate,-0.093,8,141,1,1,0.247,0.5,0.523,149
jail,-0.093,148,2350,1,1,0.094,0.898,0.48,2498
ranking,-0.093,13,220,1,1,0.54,0.592,0.68,233
bartender,-0.094,18,299,1,1,0.573,0.698,0.585,317
plastic,-0.094,47,757,1,1,0.49,0.269,0.32,804
released,-0.094,121,1926,1,1,0.844,0.49,0.651,2047
diseased,-0.094,4,78,1,1,0.123,0.51,0.134,82
blackmail,-0.094,4,78,1,1,0.094,0.802,0.482,82
knob,-0.094,4,78,1,1,0.34,0.36,0.272,82
engraved,-0.094,4,78,1,1,0.542,0.375,0.473,82
hay,-0.094,24,394,1,1,0.469,0.212,0.343,418
related,-0.094,125,1990,1,1,0.677,0.365,0.519,2115
letter,-0.095,135,2149,1,1,0.635,0.279,0.342,2284
thriller,-0.095,15,252,1,1,0.49,0.796,0.645,267
software,-0.095,10,173,1,1,0.561,0.28,0.57,183
peaked,-0.095,10,173,1,1,0.677,0.704,0.857,183
irony,-0.095,65,1043,1,1,0.39,0.587,0.508,1108
arrangement,-0.095,10,173,1,1,0.625,0.382,0.683,183
awards,-0.096,27,442,1,1,0.958,0.736,0.652,469
shower,-0.096,184,2927,1,1,0.669,0.346,0.336,3111
guilt,-0.096,144,2294,1,1,0.208,0.567,0.206,2438
overpowering,-0.096,5,94,1,1,0.392,0.779,0.589,99
cocky,-0.096,11,189,1,1,0.26,0.784,0.519,200
pariah,-0.096,5,94,1,1,0.397,0.478,0.293,99
ford,-0.096,23,379,1,1,0.521,0.34,0.382,402
condone,-0.096,5,94,1,1,0.571,0.441,0.619,99
lack,-0.096,488,7742,1,1,0.25,0.365,0.242,8230
bright,-0.097,226,3594,1,1,0.89,0.527,0.812,3820
goose,-0.097,18,300,1,1,0.479,0.283,0.265,318
starvation,-0.098,13,221,1,1,0.24,0.592,0.284,234
economic,-0.098,28,459,1,1,0.561,0.408,0.639,487
skate,-0.098,14,237,1,1,0.74,0.653,0.508,251
summary,-0.098,14,237,1,1,0.729,0.26,0.427,251
disagree,-0.099,75,1205,1,1,0.133,0.59,0.345,1280
gravy,-0.099,7,126,1,1,0.608,0.45,0.339,133
switch,-0.099,122,1952,1,1,0.5,0.538,0.509,2074
gas,-0.1,62,1000,1,1,0.396,0.408,0.519,1062
admission,-0.1,8,142,1,1,0.802,0.415,0.732,150
utterly,-0.1,71,1143,1,1,0.633,0.44,0.673,1214
entertain,-0.1,112,1795,1,1,0.918,0.684,0.598,1907
crooked,-0.1,18,301,1,1,0.146,0.594,0.305,319
lose,-0.1,665,10585,1,1,0.115,0.538,0.176,11250
stitch,-0.101,9,158,1,1,0.306,0.538,0.357,167
attach,-0.101,19,317,1,1,0.52,0.363,0.559,336
minded,-0.101,70,1128,1,1,0.656,0.394,0.627,1198
stayed,-0.102,189,3023,1,1,0.497,0.27,0.395,3212
facility,-0.102,12,206,1,1,0.625,0.5,0.654,218
paragraph,-0.102,12,206,1,1,0.51,0.164,0.269,218
guitar,-0.102,90,1448,1,1,0.844,0.542,0.469,1538
age,-0.102,712,11354,1,1,0.561,0.226,0.498,12066
struggle,-0.103,356,5688,1,1,0.365,0.82,0.741,6044
celebrating,-0.103,94,1513,1,1,0.927,0.86,0.773,1607
country,-0.103,560,8940,1,1,0.698,0.394,0.693,9500
realist,-0.103,17,286,1,1,0.72,0.572,0.809,303
flu,-0.104,19,318,1,1,0.23,0.547,0.25,337
winner,-0.104,64,1036,1,1,0.96,0.81,0.886,1100
stress,-0.104,422,6749,1,1,0.173,0.843,0.317,7171
shipping,-0.104,23,382,1,1,0.622,0.327,0.443,405
cruel,-0.104,152,2441,1,1,0.122,0.866,0.391,2593
including,-0.105,170,2731,1,1,0.7,0.378,0.518,2901
ahead,-0.106,238,3818,1,1,0.708,0.52,0.673,4056
alienation,-0.106,51,830,1,1,0.378,0.53,0.462,881
other,-0.106,4650,74355,1,1,0.472,0.23,0.259,79005
piano,-0.106,79,1278,1,1,0.704,0.343,0.438,1357
flinch,-0.107,2,47,1,1,0.35,0.804,0.555,49
aftertaste,-0.107,1,31,1,1,0.354,0.362,0.455,32
grub,-0.107,2,47,1,1,0.602,0.406,0.355,49
disused,-0.107,1,31,1,1,0.25,0.302,0.186,32
rig,-0.107,4,79,1,1,0.542,0.382,0.746,83
rundown,-0.107,1,31,1,1,0.52,0.296,0.465,32
inflammatory,-0.107,1,31,1,1,0.177,0.642,0.404,32
tickle,-0.107,5,95,1,1,0.76,0.727,0.342,100
khan,-0.107,18,303,1,1,0.463,0.476,0.529,321
melodrama,-0.107,7,127,1,1,0.378,0.83,0.446,134
vixen,-0.107,2,47,1,1,0.367,0.615,0.414,49
mailing,-0.107,2,47,1,1,0.688,0.324,0.375,49
polite,-0.107,26,431,1,1,0.927,0.378,0.562,457
aga,-0.107,1,31,1,1,0.542,0.327,0.398,32
bluegrass,-0.107,1,31,1,1,0.573,0.441,0.395,32
damsel,-0.107,3,63,1,1,0.719,0.475,0.4,66
tickled,-0.107,2,47,1,1,0.755,0.707,0.364,49
mantis,-0.107,1,31,1,1,0.48,0.355,0.421,32
boutique,-0.107,1,31,1,1,0.745,0.49,0.441,32
headstone,-0.107,1,31,1,1,0.24,0.378,0.349,32
calico,-0.107,1,31,1,1,0.406,0.338,0.491,32
unprofessional,-0.107,1,31,1,1,0.042,0.37,0.17,32
antics,-0.107,7,127,1,1,0.448,0.74,0.236,134
potted,-0.107,1,31,1,1,0.469,0.336,0.375,32
jumbo,-0.107,1,31,1,1,0.68,0.552,0.447,32
tsunami,-0.107,3,63,1,1,0.042,0.944,0.684,66
viking,-0.107,4,79,1,1,0.541,0.755,0.605,83
jumper,-0.107,5,95,1,1,0.615,0.336,0.481,100
contagion,-0.107,1,31,1,1,0.208,0.63,0.535,32
technician,-0.107,1,31,1,1,0.592,0.51,0.713,32
cupping,-0.107,1,31,1,1,0.49,0.61,0.402,32
goodie,-0.107,3,63,1,1,0.854,0.327,0.6,66
sender,-0.107,5,95,1,1,0.542,0.449,0.509,100
flaky,-0.107,1,31,1,1,0.363,0.509,0.279,32
handbag,-0.107,1,31,1,1,0.562,0.24,0.336,32
mustard,-0.107,4,79,1,1,0.5,0.346,0.275,83
bail,-0.107,11,191,1,1,0.373,0.52,0.561,202
anemic,-0.107,1,31,1,1,0.167,0.279,0.155,32
fetus,-0.107,4,79,1,1,0.479,0.519,0.395,83
midterm,-0.107,3,63,1,1,0.427,0.337,0.425,66
bagel,-0.107,8,143,1,1,0.531,0.363,0.34,151
incompatible,-0.107,3,63,1,1,0.196,0.5,0.31,66
imbalance,-0.107,6,111,1,1,0.115,0.538,0.264,117
roc,-0.107,2,47,1,1,0.427,0.51,0.415,49
fireman,-0.107,1,31,1,1,0.583,0.745,0.755,32
slump,-0.107,8,143,1,1,0.194,0.438,0.13,151
chap,-0.107,15,255,1,1,0.55,0.41,0.345,270
cruelly,-0.107,2,47,1,1,0.146,0.79,0.471,49
unfairness,-0.107,1,31,1,1,0.17,0.817,0.336,32
whopping,-0.107,1,31,1,1,0.541,0.74,0.755,32
assistant,-0.107,22,367,1,1,0.625,0.39,0.536,389
growls,-0.107,1,31,1,1,0.125,0.675,0.442,32
streak,-0.107,16,271,1,1,0.44,0.608,0.511,287
monsoon,-0.107,3,63,1,1,0.358,0.6,0.481,66
polka,-0.107,1,31,1,1,0.604,0.451,0.426,32
lag,-0.107,6,111,1,1,0.22,0.375,0.246,117
prominent,-0.107,8,143,1,1,0.676,0.627,0.779,151
indirect,-0.107,7,127,1,1,0.385,0.402,0.33,134
frustrate,-0.107,2,47,1,1,0.1,0.809,0.243,49
handler,-0.107,2,47,1,1,0.439,0.593,0.861,49
raise,-0.107,116,1872,1,1,0.885,0.685,0.765,1988
wolf,-0.107,230,3697,1,1,0.448,0.712,0.63,3927
half,-0.108,669,10729,1,1,0.5,0.274,0.276,11398
emotion,-0.108,168,2706,1,1,0.693,0.873,0.696,2874
children,-0.109,617,9906,1,1,0.857,0.538,0.435,10523
impress,-0.109,29,480,1,1,0.816,0.744,0.895,509
use,-0.11,1161,18642,1,1,0.438,0.358,0.409,19803
joint,-0.11,37,609,1,1,0.615,0.392,0.566,646
berlin,-0.11,18,304,1,1,0.592,0.423,0.571,322
rank,-0.11,18,304,1,1,0.531,0.38,0.686,322
hotel,-0.11,235,3788,1,1,0.74,0.37,0.407,4023
creature,-0.111,145,2345,1,1,0.669,0.625,0.62,2490
cutting,-0.111,100,1622,1,1,0.448,0.375,0.536,1722
envious,-0.111,27,449,1,1,0.11,0.754,0.341,476
reunite,-0.111,13,224,1,1,0.656,0.55,0.657,237
glamorous,-0.112,12,208,1,1,0.918,0.63,0.791,220
colored,-0.112,12,208,1,1,0.806,0.317,0.275,220
invent,-0.112,12,208,1,1,0.719,0.689,0.833,220
dinosaur,-0.112,12,208,1,1,0.448,0.63,0.596,220
searching,-0.112,260,4196,1,1,0.534,0.657,0.466,4456
screening,-0.112,11,192,1,1,0.562,0.57,0.709,203
trivia,-0.112,11,192,1,1,0.69,0.49,0.473,203
ward,-0.113,30,498,1,1,0.469,0.255,0.254,528
unable,-0.113,142,2301,1,1,0.132,0.459,0.193,2443
validation,-0.113,100,1625,1,1,0.655,0.46,0.72,1725
transfer,-0.113,19,321,1,1,0.702,0.49,0.519,340
beat,-0.113,282,4556,1,1,0.279,0.647,0.492,4838
supposed,-0.113,374,6038,1,1,0.296,0.378,0.379,6412
engineer,-0.113,18,305,1,1,0.719,0.5,0.875,323
knot,-0.114,8,144,1,1,0.541,0.221,0.408,152
pointless,-0.114,61,998,1,1,0.055,0.353,0.111,1059
conspiracy,-0.114,42,692,1,1,0.125,0.787,0.652,734
overall,-0.114,82,1337,1,1,0.583,0.37,0.67,1419
contents,-0.115,7,128,1,1,0.656,0.375,0.55,135
mockery,-0.115,7,128,1,1,0.094,0.806,0.181,135
wrestle,-0.115,7,128,1,1,0.388,0.89,0.765,135
lamb,-0.115,15,257,1,1,0.646,0.284,0.321,272
frank,-0.115,99,1612,1,1,0.625,0.358,0.604,1711
exciting,-0.115,118,1919,1,1,0.95,0.792,0.789,2037
nostalgic,-0.115,43,709,1,1,0.458,0.351,0.184,752
epiphany,-0.117,18,306,1,1,0.625,0.596,0.526,324
communicate,-0.117,119,1938,1,1,0.823,0.41,0.696,2057
marriage,-0.118,231,3751,1,1,0.844,0.684,0.75,3982
holiday,-0.118,392,6355,1,1,0.948,0.431,0.593,6747
anatomy,-0.118,16,274,1,1,0.562,0.39,0.571,290
shaking,-0.118,50,824,1,1,0.275,0.849,0.255,874
principal,-0.118,10,177,1,1,0.65,0.353,0.709,187
diva,-0.118,10,177,1,1,0.66,0.657,0.596,187
happening,-0.119,216,3514,1,1,0.646,0.529,0.555,3730
perpetually,-0.119,24,404,1,1,0.51,0.473,0.868,428
conceited,-0.119,4,80,1,1,0.194,0.667,0.473,84
tome,-0.119,4,80,1,1,0.429,0.316,0.492,84
mixer,-0.119,4,80,1,1,0.562,0.5,0.556,84
depravity,-0.119,4,80,1,1,0.115,0.854,0.453,84
retriever,-0.119,4,80,1,1,0.459,0.5,0.464,84
quiz,-0.12,18,307,1,1,0.462,0.61,0.527,325
predator,-0.12,18,307,1,1,0.143,0.76,0.777,325
soda,-0.12,13,226,1,1,0.688,0.314,0.364,239
parasite,-0.121,8,145,1,1,0.092,0.442,0.324,153
model,-0.121,82,1346,1,1,0.607,0.388,0.723,1428
twenty,-0.122,61,1006,1,1,0.52,0.292,0.286,1067
official,-0.122,64,1055,1,1,0.646,0.565,0.833,1119
intensive,-0.122,3,64,1,1,0.57,0.842,0.776,67
comma,-0.122,3,64,1,1,0.344,0.269,0.242,67
digit,-0.122,3,64,1,1,0.447,0.286,0.333,67
lethargy,-0.122,7,129,1,1,0.194,0.302,0.316,136
receipts,-0.122,3,64,1,1,0.32,0.333,0.381,67
indicative,-0.122,3,64,1,1,0.51,0.51,0.591,67
mobility,-0.122,11,194,1,1,0.7,0.596,0.654,205
coffin,-0.122,11,194,1,1,0.073,0.432,0.343,205
hump,-0.122,7,129,1,1,0.296,0.462,0.25,136
saddle,-0.122,3,64,1,1,0.51,0.509,0.306,67
caused,-0.123,123,2015,1,1,0.344,0.52,0.382,2138
muted,-0.123,29,487,1,1,0.26,0.167,0.162,516
pigeon,-0.124,10,178,1,1,0.688,0.224,0.276,188
gasp,-0.124,10,178,1,1,0.44,0.754,0.298,188
rape,-0.124,56,927,1,1,0.062,0.856,0.527,983
disrespect,-0.124,38,634,1,1,0.062,0.637,0.302,672
wildfire,-0.125,6,113,1,1,0.14,0.929,0.552,119
boomer,-0.125,13,227,1,1,0.48,0.539,0.441,240
reaper,-0.125,23,390,1,1,0.34,0.565,0.464,413
lots,-0.125,484,7901,1,1,0.604,0.417,0.424,8385
treatment,-0.125,57,944,1,1,0.663,0.386,0.62,1001
guiding,-0.125,16,276,1,1,0.667,0.52,0.714,292
stopping,-0.125,53,879,1,1,0.388,0.382,0.473,932
dumps,-0.125,9,162,1,1,0.302,0.583,0.365,171
articles,-0.125,29,488,1,1,0.552,0.324,0.565,517
judge,-0.126,173,2837,1,1,0.51,0.604,0.857,3010
penny,-0.126,28,472,1,1,0.615,0.302,0.324,500
matter,-0.126,1182,19296,1,1,0.487,0.353,0.562,20478
candidate,-0.126,18,309,1,1,0.596,0.49,0.804,327
gist,-0.127,5,97,1,1,0.622,0.45,0.519,102
crucify,-0.127,2,48,1,1,0.146,0.878,0.573,50
fiasco,-0.127,2,48,1,1,0.167,0.6,0.2,50
frustrates,-0.127,2,48,1,1,0.146,0.653,0.34,50
standup,-0.127,2,48,1,1,0.633,0.583,0.55,50
spinal,-0.127,2,48,1,1,0.312,0.491,0.296,50
gad,-0.127,2,48,1,1,0.51,0.47,0.408,50
depraved,-0.127,8,146,1,1,0.031,0.837,0.395,154
tomatoes,-0.127,5,97,1,1,0.615,0.24,0.272,102
page,-0.128,181,2974,1,1,0.677,0.224,0.278,3155
cynical,-0.128,22,375,1,1,0.156,0.76,0.474,397
shop,-0.128,180,2958,1,1,0.725,0.632,0.565,3138
elf,-0.129,30,506,1,1,0.46,0.457,0.315,536
complicated,-0.129,75,1242,1,1,0.211,0.66,0.455,1317
forgiving,-0.129,13,228,1,1,0.885,0.317,0.556,241
neighbor,-0.129,71,1177,1,1,0.657,0.448,0.434,1248
wear,-0.13,151,2488,1,1,0.312,0.37,0.255,2639
prediction,-0.13,7,130,1,1,0.562,0.635,0.585,137
trendy,-0.13,7,130,1,1,0.713,0.52,0.536,137
belt,-0.13,20,343,1,1,0.541,0.322,0.445,363
gig,-0.13,33,556,1,1,0.816,0.755,0.594,589
first,-0.131,2723,44642,1,1,0.625,0.5,0.788,47365
stubborn,-0.131,32,540,1,1,0.157,0.702,0.575,572
associate,-0.131,42,704,1,1,0.812,0.409,0.625,746
presents,-0.131,62,1032,1,1,0.781,0.394,0.526,1094
terrified,-0.131,82,1360,1,1,0.09,0.902,0.387,1442
carbon,-0.132,9,163,1,1,0.604,0.36,0.35,172
stocking,-0.132,4,81,1,1,0.594,0.324,0.688,85
disgraced,-0.132,4,81,1,1,0.071,0.661,0.25,85
citizenship,-0.132,4,81,1,1,0.786,0.404,0.723,85
backseat,-0.132,9,163,1,1,0.388,0.33,0.237,172
request,-0.132,64,1065,1,1,0.625,0.471,0.618,1129
monstrous,-0.132,4,81,1,1,0.094,0.942,0.649,85
childlike,-0.132,4,81,1,1,0.656,0.372,0.293,85
bonus,-0.132,43,721,1,1,0.857,0.62,0.682,764
denial,-0.132,43,721,1,1,0.194,0.435,0.318,764
column,-0.132,16,278,1,1,0.48,0.25,0.67,294
winning,-0.132,79,1312,1,1,0.955,0.712,0.972,1391
airport,-0.133,67,1116,1,1,0.729,0.684,0.682,1183
crossed,-0.133,67,1116,1,1,0.431,0.49,0.508,1183
spout,-0.133,6,114,1,1,0.438,0.357,0.309,120
sailor,-0.133,20,344,1,1,0.5,0.588,0.5,364
bitterly,-0.133,6,114,1,1,0.194,0.685,0.362,120
privileged,-0.134,22,377,1,1,0.867,0.49,0.853,399
dentist,-0.134,8,147,1,1,0.479,0.62,0.642,155
investigation,-0.136,14,246,1,1,0.531,0.592,0.82,260
sidewalk,-0.136,14,246,1,1,0.479,0.192,0.348,260
issue,-0.136,273,4511,1,1,0.316,0.819,0.351,4784
subscribe,-0.136,16,279,1,1,0.66,0.344,0.591,295
warrior,-0.136,75,1251,1,1,0.458,0.863,0.915,1326
fell,-0.137,327,5407,1,1,0.255,0.462,0.25,5734
pandemonium,-0.138,1,32,1,1,0.229,0.885,0.5,33
fir,-0.138,9,164,1,1,0.521,0.275,0.306,173
myopic,-0.138,1,32,1,1,0.344,0.396,0.218,33
inane,-0.138,3,65,1,1,0.271,0.35,0.268,68
reversal,-0.138,1,32,1,1,0.38,0.51,0.591,33
unidentified,-0.138,1,32,1,1,0.385,0.361,0.199,33
pneumonia,-0.138,1,32,1,1,0.208,0.608,0.324,33
profanity,-0.138,1,32,1,1,0.115,0.79,0.491,33
stylist,-0.138,1,32,1,1,0.76,0.445,0.5,33
goner,-0.138,1,32,1,1,0.41,0.461,0.274,33
prohibited,-0.138,1,32,1,1,0.115,0.77,0.482,33
stardom,-0.138,3,65,1,1,0.844,0.786,0.689,68
sifting,-0.138,1,32,1,1,0.571,0.469,0.474,33
caricature,-0.138,1,32,1,1,0.604,0.373,0.383,33
morgue,-0.138,1,32,1,1,0.022,0.539,0.241,33
barrel,-0.138,13,230,1,1,0.429,0.298,0.474,243
aristocrat,-0.138,1,32,1,1,0.583,0.413,0.811,33
degrading,-0.138,7,131,1,1,0.031,0.583,0.232,138
trickle,-0.138,1,32,1,1,0.5,0.196,0.231,33
plausible,-0.138,3,65,1,1,0.714,0.404,0.51,68
clitoris,-0.138,1,32,1,1,0.625,0.844,0.464,33
vise,-0.138,1,32,1,1,0.533,0.391,0.451,33
validate,-0.138,25,428,1,1,0.76,0.431,0.745,453
fiver,-0.138,1,32,1,1,0.458,0.469,0.517,33
bleu,-0.138,1,32,1,1,0.46,0.354,0.379,33
retro,-0.138,9,164,1,1,0.65,0.276,0.321,173
rife,-0.138,3,65,1,1,0.57,0.561,0.692,68
consultation,-0.138,3,65,1,1,0.66,0.463,0.625,68
madam,-0.138,13,230,1,1,0.58,0.308,0.571,243
capitalism,-0.138,34,577,1,1,0.448,0.686,0.848,611
hiatus,-0.139,32,544,1,1,0.479,0.294,0.352,576
belly,-0.139,30,511,1,1,0.51,0.388,0.387,541
explain,-0.139,252,4178,1,1,0.719,0.517,0.736,4430
mobile,-0.139,49,825,1,1,0.615,0.569,0.481,874
speed,-0.139,68,1139,1,1,0.719,0.849,0.658,1207
betty,-0.14,14,247,1,1,0.542,0.358,0.381,261
caps,-0.14,12,214,1,1,0.51,0.221,0.368,226
wearing,-0.141,128,2134,1,1,0.646,0.52,0.461,2262
tv,-0.141,422,7001,1,1,0.622,0.38,0.393,7423
buffet,-0.141,8,148,1,1,0.656,0.546,0.519,156
one,-0.141,17092,282993,1,1,0.542,0.292,0.37,300085
slightly,-0.141,133,2218,1,1,0.47,0.274,0.255,2351
kind,-0.141,1789,29642,1,1,0.918,0.24,0.618,31431
apartment,-0.141,332,5514,1,1,0.719,0.393,0.58,5846
prevent,-0.142,59,993,1,1,0.635,0.481,0.575,1052
crazed,-0.142,6,115,1,1,0.153,0.877,0.417,121
trucker,-0.142,6,115,1,1,0.494,0.609,0.5,121
noticeable,-0.142,6,115,1,1,0.89,0.562,0.75,121
success,-0.142,264,4391,1,1,0.959,0.88,0.981,4655
jam,-0.142,75,1259,1,1,0.51,0.548,0.318,1334
unacceptable,-0.143,11,198,1,1,0.133,0.479,0.33,209
trauma,-0.143,104,1741,1,1,0.112,0.792,0.453,1845
stuffy,-0.144,4,82,1,1,0.323,0.615,0.406,86
raccoon,-0.144,9,165,1,1,0.541,0.435,0.32,174
opinionated,-0.144,4,82,1,1,0.156,0.8,0.491,86
tractor,-0.144,4,82,1,1,0.449,0.58,0.619,86
income,-0.144,29,497,1,1,0.75,0.51,0.728,526
counselor,-0.144,14,248,1,1,0.873,0.365,0.706,262
decoration,-0.144,4,82,1,1,0.878,0.553,0.526,86
evolutionary,-0.144,4,82,1,1,0.796,0.673,0.825,86
sabotage,-0.145,12,215,1,1,0.135,0.906,0.5,227
cotton,-0.145,12,215,1,1,0.639,0.071,0.24,227
bowl,-0.145,57,963,1,1,0.625,0.377,0.358,1020
lacking,-0.145,57,963,1,1,0.229,0.375,0.121,1020
drinker,-0.145,7,132,1,1,0.365,0.735,0.441,139
uncaring,-0.145,7,132,1,1,0.177,0.245,0.321,139
rambling,-0.145,15,265,1,1,0.448,0.51,0.528,280
bullshit,-0.145,223,3723,1,1,0.042,0.676,0.183,3946
factor,-0.146,51,864,1,1,0.635,0.365,0.678,915
moot,-0.146,10,182,1,1,0.344,0.5,0.615,192
train,-0.147,292,4878,1,1,0.666,0.705,0.62,5170
rock,-0.147,287,4797,1,1,0.623,0.236,0.557,5084
ailing,-0.148,2,49,1,1,0.094,0.518,0.153,51
brainwash,-0.148,2,49,1,1,0.198,0.647,0.481,51
generic,-0.148,11,199,1,1,0.52,0.357,0.422,210
caster,-0.148,2,49,1,1,0.604,0.67,0.647,51
tactics,-0.148,11,199,1,1,0.583,0.676,0.774,210
canned,-0.148,2,49,1,1,0.398,0.357,0.298,51
offshore,-0.148,2,49,1,1,0.417,0.484,0.441,51
gaff,-0.148,2,49,1,1,0.333,0.418,0.429,51
sniper,-0.148,5,99,1,1,0.167,0.87,0.853,104
muck,-0.148,2,49,1,1,0.347,0.423,0.272,51
pokes,-0.148,5,99,1,1,0.365,0.48,0.538,104
hereditary,-0.148,2,49,1,1,0.531,0.6,0.737,51
sleeplessness,-0.148,2,49,1,1,0.104,0.604,0.202,51
hesitating,-0.148,2,49,1,1,0.265,0.528,0.24,51
imbecile,-0.148,5,99,1,1,0.082,0.569,0.26,104
onstage,-0.148,2,49,1,1,0.719,0.673,0.583,51
coordinator,-0.148,2,49,1,1,0.75,0.51,0.85,51
mast,-0.148,2,49,1,1,0.542,0.39,0.58,51
cranberry,-0.148,2,49,1,1,0.793,0.33,0.363,51
ahhhhhhhh,-0.148,2,49,1,1,0.552,0.649,0.288,51
spook,-0.148,2,49,1,1,0.327,0.887,0.322,51
heartsick,-0.148,2,49,1,1,0.24,0.388,0.208,51
lovelife,-0.148,5,99,1,1,0.837,0.61,0.592,104
tandem,-0.148,2,49,1,1,0.552,0.406,0.485,51
teacup,-0.148,2,49,1,1,0.633,0.135,0.277,51
recruits,-0.148,2,49,1,1,0.396,0.653,0.593,51
proactive,-0.148,5,99,1,1,0.792,0.723,0.857,104
newt,-0.148,5,99,1,1,0.458,0.38,0.541,104
hunch,-0.148,2,49,1,1,0.561,0.63,0.567,51
showdown,-0.148,2,49,1,1,0.302,0.95,0.692,51
franchise,-0.148,8,149,1,1,0.663,0.4,0.56,157
compass,-0.148,14,249,1,1,0.541,0.307,0.529,263
congrats,-0.148,71,1200,1,1,0.93,0.726,0.775,1271
ironic,-0.149,56,950,1,1,0.435,0.55,0.5,1006
lethal,-0.149,18,316,1,1,0.156,0.8,0.745,334
resentment,-0.149,28,483,1,1,0.163,0.745,0.528,511
representing,-0.149,12,216,1,1,0.796,0.464,0.833,228
wage,-0.149,12,216,1,1,0.635,0.48,0.565,228
plant,-0.149,61,1034,1,1,0.73,0.18,0.371,1095
educated,-0.15,29,500,1,1,0.816,0.297,0.625,529
ban,-0.15,26,450,1,1,0.146,0.689,0.587,476
lay,-0.15,284,4761,1,1,0.521,0.336,0.491,5045
sessions,-0.15,44,751,1,1,0.646,0.578,0.65,795
homey,-0.15,6,116,1,1,0.769,0.278,0.5,122
wire,-0.15,13,233,1,1,0.48,0.33,0.245,246
manage,-0.151,99,1671,1,1,0.56,0.53,0.719,1770
describe,-0.151,147,2474,1,1,0.542,0.472,0.555,2621
rotten,-0.151,21,367,1,1,0.104,0.59,0.327,388
aggressive,-0.151,36,618,1,1,0.125,0.949,0.648,654
softly,-0.152,106,1790,1,1,0.517,0.206,0.304,1896
cheese,-0.152,76,1288,1,1,0.74,0.28,0.281,1364
gasping,-0.153,3,66,1,1,0.208,0.704,0.379,69
afterthought,-0.153,3,66,1,1,0.396,0.392,0.349,69
scissors,-0.153,3,66,1,1,0.458,0.462,0.302,69
fetal,-0.153,3,66,1,1,0.388,0.308,0.364,69
navy,-0.153,15,267,1,1,0.531,0.76,0.764,282
kappa,-0.153,3,66,1,1,0.469,0.375,0.366,69
unprotected,-0.153,3,66,1,1,0.15,0.582,0.197,69
disliking,-0.153,3,66,1,1,0.163,0.637,0.366,69
brawl,-0.153,3,66,1,1,0.104,0.938,0.603,69
aggressively,-0.153,15,267,1,1,0.25,0.926,0.688,282
named,-0.153,144,2428,1,1,0.562,0.396,0.565,2572
fellow,-0.153,188,3167,1,1,0.745,0.298,0.57,3355
board,-0.154,85,1441,1,1,0.592,0.255,0.385,1526
punch,-0.154,47,804,1,1,0.229,0.787,0.608,851
undying,-0.154,8,150,1,1,0.708,0.5,0.773,158
banner,-0.154,17,301,1,1,0.521,0.408,0.474,318
hand,-0.154,861,14463,1,1,0.542,0.314,0.434,15324
magazine,-0.155,27,469,1,1,0.615,0.332,0.377,496
happier,-0.155,177,2987,1,1,0.99,0.76,0.806,3164
basket,-0.155,23,402,1,1,0.458,0.227,0.336,425
yon,-0.156,4,83,1,1,0.479,0.365,0.393,87
oppressed,-0.156,14,251,1,1,0.119,0.64,0.259,265
squash,-0.156,4,83,1,1,0.531,0.667,0.41,87
slug,-0.156,4,83,1,1,0.276,0.37,0.16,87
charismatic,-0.156,9,167,1,1,0.938,0.684,0.849,176
assure,-0.156,24,419,1,1,0.91,0.46,0.839,443
cord,-0.156,9,167,1,1,0.388,0.378,0.358,176
fair,-0.156,193,3260,1,1,0.812,0.557,0.643,3453
fitting,-0.156,36,621,1,1,0.612,0.441,0.638,657
assuming,-0.156,47,806,1,1,0.74,0.39,0.526,853
doubt,-0.156,251,4236,1,1,0.395,0.351,0.231,4487
gin,-0.157,21,369,1,1,0.449,0.551,0.518,390
hostage,-0.157,10,184,1,1,0.163,0.923,0.325,194
judged,-0.157,38,655,1,1,0.281,0.686,0.722,693
punk,-0.157,33,571,1,1,0.429,0.63,0.358,604
mediocre,-0.158,23,403,1,1,0.188,0.481,0.149,426
luggage,-0.158,5,100,1,1,0.561,0.226,0.319,105
creeper,-0.158,5,100,1,1,0.429,0.558,0.366,105
chic,-0.158,5,100,1,1,0.87,0.624,0.38,105
biscuit,-0.158,11,201,1,1,0.888,0.26,0.231,212
convenient,-0.158,29,504,1,1,0.846,0.491,0.574,533
judgmental,-0.158,11,201,1,1,0.33,0.602,0.579,212
obsession,-0.158,48,824,1,1,0.229,0.847,0.571,872
rely,-0.158,99,1683,1,1,0.812,0.429,0.616,1782
loss,-0.158,298,5036,1,1,0.062,0.567,0.211,5334
delusion,-0.159,19,336,1,1,0.344,0.647,0.4,355
crew,-0.159,68,1162,1,1,0.604,0.598,0.735,1230
crouch,-0.159,6,117,1,1,0.281,0.606,0.312,123
grave,-0.159,84,1432,1,1,0.153,0.385,0.386,1516
gaming,-0.159,63,1078,1,1,0.896,0.633,0.491,1141
community,-0.159,649,10961,1,1,0.75,0.35,0.659,11610
coming,-0.159,1144,19310,1,1,0.653,0.417,0.5,20454
rainbows,-0.16,14,252,1,1,0.875,0.517,0.402,266
fine,-0.16,1218,20566,1,1,0.823,0.24,0.647,21784
sporting,-0.16,7,134,1,1,0.917,0.656,0.675,141
freeway,-0.16,7,134,1,1,0.531,0.644,0.648,141
kit,-0.161,17,303,1,1,0.583,0.344,0.42,320
conclusion,-0.161,100,1705,1,1,0.615,0.377,0.659,1805
ethics,-0.162,9,168,1,1,0.658,0.296,0.731,177
grief,-0.162,212,3599,1,1,0.07,0.64,0.474,3811
pain,-0.162,1872,31679,1,1,0.012,0.765,0.395,33551
alive,-0.163,413,7003,1,1,0.816,0.637,0.731,7416
poke,-0.163,12,219,1,1,0.365,0.713,0.475,231
legitimate,-0.163,12,219,1,1,0.792,0.363,0.841,231
expose,-0.164,29,507,1,1,0.344,0.643,0.537,536
equality,-0.164,14,253,1,1,0.898,0.305,0.716,267
spider,-0.164,36,626,1,1,0.229,0.569,0.43,662
performance,-0.164,96,1643,1,1,0.75,0.52,0.672,1739
devastating,-0.164,39,677,1,1,0.104,0.856,0.419,716
broad,-0.165,22,389,1,1,0.762,0.365,0.637,411
lot,-0.165,2801,47526,1,1,0.531,0.215,0.37,50327
head,-0.165,1273,21612,1,1,0.53,0.472,0.558,22885
vodka,-0.165,29,508,1,1,0.51,0.632,0.491,537
arc,-0.166,31,542,1,1,0.552,0.388,0.396,573
would,-0.166,6081,103242,1,1,0.493,0.412,0.427,109323
press,-0.166,82,1408,1,1,0.552,0.52,0.491,1490
handful,-0.166,41,712,1,1,0.521,0.481,0.4,753
deficit,-0.167,3,67,1,1,0.358,0.5,0.269,70
frugal,-0.167,1,33,1,1,0.48,0.355,0.355,34
packaging,-0.167,2,50,1,1,0.604,0.393,0.549,52
reiterate,-0.167,2,50,1,1,0.422,0.451,0.655,52
bitty,-0.167,2,50,1,1,0.469,0.271,0.257,52
ropes,-0.167,4,84,1,1,0.458,0.304,0.402,88
soft,-0.167,352,6000,1,1,0.76,0.179,0.232,6352
geographical,-0.167,1,33,1,1,0.5,0.317,0.637,34
fodder,-0.167,2,50,1,1,0.316,0.358,0.43,52
outpouring,-0.167,1,33,1,1,0.562,0.685,0.552,34
quid,-0.167,3,67,1,1,0.479,0.378,0.327,70
cadet,-0.167,2,50,1,1,0.504,0.393,0.664,52
gatorade,-0.167,1,33,1,1,0.719,0.529,0.519,34
contestant,-0.167,1,33,1,1,0.76,0.53,0.602,34
disaffected,-0.167,3,67,1,1,0.176,0.41,0.291,70
cargo,-0.167,3,67,1,1,0.408,0.444,0.455,70
apologist,-0.167,2,50,1,1,0.406,0.429,0.526,52
unarmed,-0.167,1,33,1,1,0.427,0.42,0.241,34
acorn,-0.167,1,33,1,1,0.448,0.198,0.192,34
matrimony,-0.167,2,50,1,1,0.85,0.637,0.843,52
volleyball,-0.167,5,101,1,1,0.64,0.7,0.458,106
scavenger,-0.167,3,67,1,1,0.177,0.578,0.408,70
beige,-0.167,2,50,1,1,0.49,0.222,0.224,52
deteriorating,-0.167,5,101,1,1,0.104,0.459,0.112,106
wilted,-0.167,1,33,1,1,0.245,0.375,0.186,34
damper,-0.167,1,33,1,1,0.459,0.378,0.473,34
lithium,-0.167,1,33,1,1,0.417,0.33,0.43,34
cannon,-0.167,6,118,1,1,0.529,0.676,0.811,124
popsicle,-0.167,1,33,1,1,0.667,0.3,0.364,34
nonsensical,-0.167,5,101,1,1,0.173,0.268,0.193,106
dawned,-0.167,6,118,1,1,0.694,0.471,0.473,124
butter,-0.167,29,509,1,1,0.65,0.292,0.202,538
rotation,-0.167,8,152,1,1,0.67,0.52,0.55,160
unforgiving,-0.167,8,152,1,1,0.406,0.63,0.793,160
bozo,-0.167,2,50,1,1,0.388,0.364,0.298,52
credence,-0.167,1,33,1,1,0.76,0.46,0.737,34
kaiser,-0.167,1,33,1,1,0.47,0.509,0.69,34
overdrive,-0.167,3,67,1,1,0.303,0.715,0.732,70
pork,-0.167,7,135,1,1,0.37,0.45,0.333,142
repressed,-0.167,13,237,1,1,0.188,0.337,0.311,250
idolizing,-0.167,1,33,1,1,0.676,0.712,0.643,34
effects,-0.168,80,1377,1,1,0.47,0.578,0.379,1457
wanting,-0.169,761,12967,1,1,0.76,0.433,0.593,13728
match,-0.169,159,2722,1,1,0.599,0.573,0.5,2881
multiple,-0.169,137,2348,1,1,0.66,0.51,0.578,2485
pushing,-0.169,165,2825,1,1,0.396,0.644,0.731,2990
ending,-0.169,243,4154,1,1,0.344,0.365,0.492,4397
contribute,-0.169,30,527,1,1,0.806,0.35,0.795,557
basis,-0.17,76,1311,1,1,0.602,0.26,0.426,1387
sucker,-0.17,24,425,1,1,0.265,0.393,0.204,449
convince,-0.17,97,1669,1,1,0.708,0.539,0.763,1766
rational,-0.17,21,374,1,1,0.775,0.347,0.632,395
temporary,-0.171,182,3122,1,1,0.458,0.415,0.324,3304
lick,-0.172,26,460,1,1,0.47,0.482,0.33,486
proceeds,-0.172,12,221,1,1,0.677,0.47,0.585,233
fish,-0.172,151,2595,1,1,0.51,0.28,0.25,2746
eat,-0.172,777,13288,1,1,0.731,0.5,0.464,14065
thanksgiving,-0.172,36,631,1,1,0.927,0.449,0.637,667
moth,-0.172,11,204,1,1,0.323,0.35,0.196,215
mistake,-0.172,187,3211,1,1,0.208,0.585,0.102,3398
factory,-0.173,22,392,1,1,0.5,0.5,0.683,414
background,-0.173,135,2323,1,1,0.399,0.357,0.498,2458
lama,-0.173,10,187,1,1,0.56,0.32,0.4,197
bong,-0.173,10,187,1,1,0.333,0.566,0.375,197
cardboard,-0.173,9,170,1,1,0.5,0.173,0.309,179
documentary,-0.173,38,666,1,1,0.622,0.213,0.596,704
clue,-0.173,77,1333,1,1,0.653,0.38,0.412,1410
pastor,-0.174,28,495,1,1,0.698,0.236,0.746,523
whole,-0.175,1548,26521,1,1,0.653,0.357,0.572,28069
cool,-0.175,816,13990,1,1,0.885,0.54,0.781,14806
lease,-0.175,7,136,1,1,0.52,0.463,0.545,143
dissertation,-0.175,7,136,1,1,0.312,0.575,0.575,143
attorney,-0.175,7,136,1,1,0.6,0.594,0.754,143
refuse,-0.175,135,2328,1,1,0.18,0.52,0.331,2463
participate,-0.175,30,530,1,1,0.755,0.58,0.684,560
puts,-0.175,130,2243,1,1,0.428,0.407,0.369,2373
arm,-0.175,81,1404,1,1,0.552,0.285,0.469,1485
snippet,-0.176,6,119,1,1,0.612,0.41,0.368,125
romance,-0.177,181,3122,1,1,0.98,0.682,0.587,3303
chaser,-0.177,5,102,1,1,0.375,0.83,0.645,107
elbow,-0.177,5,102,1,1,0.448,0.133,0.254,107
deceiving,-0.177,5,102,1,1,0.099,0.636,0.426,107
ketchup,-0.177,5,102,1,1,0.653,0.338,0.282,107
flake,-0.177,11,205,1,1,0.385,0.388,0.289,216
case,-0.178,372,6407,1,1,0.427,0.275,0.441,6779
likely,-0.178,273,4707,1,1,0.633,0.356,0.454,4980
crown,-0.178,53,927,1,1,0.708,0.572,0.737,980
ruby,-0.179,20,360,1,1,0.663,0.408,0.544,380
nonsense,-0.179,77,1340,1,1,0.214,0.531,0.155,1417
knowing,-0.179,664,11434,1,1,0.833,0.353,0.658,12098
decrepit,-0.179,4,85,1,1,0.156,0.49,0.225,89
sprite,-0.179,4,85,1,1,0.561,0.438,0.625,89
tennis,-0.179,19,343,1,1,0.622,0.519,0.431,362
puffy,-0.179,4,85,1,1,0.333,0.54,0.387,89
wavy,-0.179,4,85,1,1,0.52,0.284,0.345,89
harsh,-0.179,84,1461,1,1,0.25,0.65,0.623,1545
onion,-0.179,14,257,1,1,0.378,0.367,0.382,271
giggle,-0.179,14,257,1,1,0.719,0.618,0.36,271
testosterone,-0.179,4,85,1,1,0.573,0.84,0.775,89
jock,-0.179,4,85,1,1,0.592,0.656,0.473,89
biological,-0.179,14,257,1,1,0.59,0.41,0.615,271
devastation,-0.18,8,154,1,1,0.09,0.904,0.472,162
smiley,-0.18,8,154,1,1,0.865,0.47,0.571,162
wagon,-0.18,8,154,1,1,0.49,0.461,0.474,162
eating,-0.181,576,9939,1,1,0.847,0.491,0.615,10515
fever,-0.181,42,740,1,1,0.194,0.674,0.364,782
sitting,-0.181,915,15785,1,1,0.561,0.146,0.353,16700
back,-0.181,5595,96448,1,1,0.438,0.353,0.336,102043
bark,-0.181,20,361,1,1,0.36,0.602,0.395,381
ruff,-0.182,3,68,1,1,0.365,0.51,0.375,71
spotless,-0.182,3,68,1,1,0.792,0.327,0.726,71
sidekick,-0.182,3,68,1,1,0.602,0.439,0.509,71
printer,-0.182,3,68,1,1,0.479,0.345,0.471,71
passport,-0.182,7,137,1,1,0.653,0.457,0.682,144
immoral,-0.182,7,137,1,1,0.143,0.622,0.385,144
package,-0.183,30,534,1,1,0.571,0.433,0.443,564
sec,-0.183,29,517,1,1,0.49,0.385,0.38,546
forehead,-0.183,36,638,1,1,0.47,0.308,0.556,674
perverted,-0.183,10,189,1,1,0.062,0.918,0.436,199
widowed,-0.184,17,310,1,1,0.205,0.439,0.333,327
dreaming,-0.184,116,2021,1,1,0.854,0.32,0.336,2137
surprised,-0.184,150,2609,1,1,0.784,0.855,0.539,2759
garlic,-0.184,6,120,1,1,0.46,0.323,0.277,126
reed,-0.184,6,120,1,1,0.49,0.35,0.307,126
engaged,-0.185,86,1504,1,1,0.837,0.596,0.849,1590
type,-0.185,591,10242,1,1,0.5,0.284,0.364,10833
concerned,-0.185,77,1349,1,1,0.292,0.698,0.35,1426
smirk,-0.185,12,224,1,1,0.792,0.596,0.583,236
sofa,-0.186,27,484,1,1,0.583,0.106,0.263,511
headache,-0.186,39,692,1,1,0.168,0.755,0.273,731
middle,-0.187,474,8230,1,1,0.458,0.157,0.3,8704
dance,-0.187,437,7589,1,1,0.894,0.84,0.551,8026
toaster,-0.187,5,103,1,1,0.542,0.337,0.387,108
radiance,-0.187,2,51,1,1,0.796,0.625,0.719,53
arranged,-0.187,11,207,1,1,0.698,0.531,0.728,218
napkin,-0.187,2,51,1,1,0.469,0.142,0.209,53
mainstream,-0.187,20,363,1,1,0.653,0.527,0.66,383
bookshop,-0.187,5,103,1,1,0.688,0.291,0.389,108
auditions,-0.187,2,51,1,1,0.74,0.765,0.596,53
pub,-0.187,47,831,1,1,0.592,0.637,0.446,878
blackout,-0.187,11,207,1,1,0.126,0.53,0.349,218
tiller,-0.187,2,51,1,1,0.448,0.41,0.29,53
achy,-0.187,2,51,1,1,0.167,0.84,0.373,53
tutor,-0.187,5,103,1,1,0.75,0.346,0.826,108
monogamous,-0.187,2,51,1,1,0.51,0.335,0.402,53
infidelity,-0.187,5,103,1,1,0.062,0.777,0.392,108
campaigning,-0.187,5,103,1,1,0.531,0.663,0.741,108
hose,-0.187,2,51,1,1,0.469,0.288,0.263,53
joker,-0.187,17,311,1,1,0.771,0.76,0.416,328
bootleg,-0.187,2,51,1,1,0.357,0.519,0.466,53
defend,-0.188,48,849,1,1,0.698,0.722,0.67,897
reassurance,-0.188,22,398,1,1,0.875,0.127,0.593,420
close,-0.188,1036,17990,1,1,0.292,0.26,0.263,19026
compliment,-0.188,33,589,1,1,0.82,0.49,0.651,622
endgame,-0.188,30,537,1,1,0.449,0.538,0.526,567
booze,-0.188,27,485,1,1,0.265,0.745,0.431,512
biz,-0.189,10,190,1,1,0.5,0.473,0.473,200
dreams,-0.189,675,11738,1,1,0.865,0.415,0.53,12413
hockey,-0.189,18,329,1,1,0.565,0.786,0.548,347
curling,-0.189,7,138,1,1,0.583,0.592,0.4,145
divorce,-0.189,68,1198,1,1,0.042,0.7,0.385,1266
huge,-0.19,368,6412,1,1,0.573,0.625,0.783,6780
traitor,-0.19,25,451,1,1,0.112,0.796,0.491,476
rapture,-0.19,38,677,1,1,0.439,0.883,0.567,715
double,-0.19,116,2034,1,1,0.677,0.378,0.569,2150
congratulations,-0.191,67,1182,1,1,0.96,0.755,0.719,1249
stricken,-0.191,4,86,1,1,0.163,0.72,0.368,90
materialistic,-0.191,14,260,1,1,0.42,0.506,0.589,274
tequila,-0.191,19,347,1,1,0.612,0.71,0.536,366
grr,-0.191,4,86,1,1,0.229,0.538,0.333,90
vague,-0.191,19,347,1,1,0.271,0.335,0.083,366
rifle,-0.191,4,86,1,1,0.329,0.9,0.718,90
sheep,-0.191,100,1757,1,1,0.604,0.206,0.161,1857
diabetes,-0.192,11,208,1,1,0.051,0.472,0.279,219
remembered,-0.192,122,2142,1,1,0.916,0.333,0.588,2264
repeat,-0.192,161,2822,1,1,0.49,0.529,0.552,2983
displaced,-0.192,6,121,1,1,0.281,0.472,0.291,127
shark,-0.192,20,365,1,1,0.26,0.845,0.596,385
caterpillar,-0.192,6,121,1,1,0.461,0.286,0.33,127
jasper,-0.192,6,121,1,1,0.48,0.425,0.402,127
fence,-0.193,22,400,1,1,0.5,0.198,0.398,422
sport,-0.193,56,993,1,1,0.865,0.7,0.657,1049
pineapple,-0.193,8,156,1,1,0.677,0.316,0.245,164
susceptible,-0.193,8,156,1,1,0.438,0.449,0.304,164
position,-0.194,137,2407,1,1,0.604,0.451,0.538,2544
responsible,-0.194,59,1046,1,1,0.837,0.527,0.833,1105
devil,-0.194,121,2128,1,1,0.161,0.9,0.611,2249
summertime,-0.194,10,191,1,1,0.837,0.5,0.455,201
freaked,-0.194,10,191,1,1,0.135,0.917,0.34,201
olive,-0.194,12,226,1,1,0.571,0.231,0.406,238
earlier,-0.195,152,2672,1,1,0.562,0.352,0.339,2824
red,-0.195,411,7198,1,1,0.427,0.385,0.377,7609
faded,-0.195,43,768,1,1,0.302,0.275,0.194,811
champagne,-0.195,26,471,1,1,0.76,0.6,0.454,497
nominee,-0.196,3,69,1,1,0.662,0.625,0.765,72
fondle,-0.196,1,34,1,1,0.823,0.485,0.355,35
seduce,-0.196,9,174,1,1,0.462,0.864,0.689,183
outrageous,-0.196,9,174,1,1,0.153,0.945,0.713,183
ratchet,-0.196,5,104,1,1,0.449,0.52,0.343,109
questionnaire,-0.196,1,34,1,1,0.385,0.327,0.606,35
oriental,-0.196,1,34,1,1,0.592,0.409,0.598,35
systematic,-0.196,1,34,1,1,0.617,0.444,0.594,35
figurine,-0.196,1,34,1,1,0.76,0.283,0.258,35
skirt,-0.196,7,139,1,1,0.602,0.463,0.226,146
hourly,-0.196,3,69,1,1,0.469,0.418,0.491,72
aboard,-0.196,7,139,1,1,0.698,0.284,0.481,146
innings,-0.196,1,34,1,1,0.573,0.487,0.443,35
hummingbird,-0.196,1,34,1,1,0.75,0.37,0.273,35
intermission,-0.196,1,34,1,1,0.49,0.36,0.402,35
nape,-0.196,1,34,1,1,0.427,0.268,0.298,35
obituary,-0.196,1,34,1,1,0.188,0.33,0.423,35
grate,-0.196,1,34,1,1,0.333,0.25,0.419,35
galore,-0.196,3,69,1,1,0.823,0.574,0.729,72
accuser,-0.196,1,34,1,1,0.122,0.779,0.615,35
vase,-0.196,3,69,1,1,0.638,0.225,0.215,72
manly,-0.196,9,174,1,1,0.698,0.633,0.846,183
drumming,-0.196,1,34,1,1,0.594,0.75,0.426,35
apartments,-0.196,13,244,1,1,0.704,0.337,0.443,257
homicide,-0.196,1,34,1,1,0.01,0.973,0.518,35
substantial,-0.196,5,104,1,1,0.59,0.49,0.69,109
abate,-0.196,1,34,1,1,0.255,0.696,0.604,35
firearms,-0.196,1,34,1,1,0.22,0.943,0.821,35
reggae,-0.196,7,139,1,1,0.698,0.52,0.5,146
geeky,-0.196,3,69,1,1,0.479,0.431,0.454,72
symptom,-0.196,21,384,1,1,0.38,0.529,0.434,405
thunderbolt,-0.196,3,69,1,1,0.418,0.719,0.642,72
branching,-0.196,1,34,1,1,0.52,0.422,0.472,35
plain,-0.197,62,1102,1,1,0.5,0.167,0.311,1164
singer,-0.198,49,875,1,1,0.802,0.735,0.628,924
realistic,-0.198,27,490,1,1,0.7,0.52,0.783,517
homosexual,-0.199,12,227,1,1,0.333,0.78,0.431,239
bottle,-0.199,156,2753,1,1,0.469,0.236,0.336,2909
ness,-0.199,21,385,1,1,0.396,0.48,0.392,406
chicken,-0.199,98,1736,1,1,0.594,0.306,0.394,1834
ace,-0.199,39,701,1,1,0.643,0.481,0.546,740
ahhh,-0.199,59,1052,1,1,0.562,0.517,0.241,1111
legal,-0.199,37,666,1,1,0.653,0.387,0.887,703
new,-0.199,3621,63576,1,1,0.917,0.49,0.582,67197
qualify,-0.2,8,157,1,1,0.73,0.594,0.52,165
fetch,-0.2,8,157,1,1,0.479,0.363,0.491,165
paralyzed,-0.2,8,157,1,1,0.194,0.48,0.198,165
unconditional,-0.2,29,526,1,1,0.76,0.493,0.715,555
inception,-0.201,6,122,1,1,0.604,0.425,0.561,128
vary,-0.201,6,122,1,1,0.521,0.373,0.413,128
clone,-0.201,16,298,1,1,0.406,0.471,0.524,314
keeping,-0.202,348,6140,1,1,0.592,0.28,0.723,6488
bread,-0.202,81,1442,1,1,0.66,0.314,0.342,1523
ticket,-0.202,86,1530,1,1,0.684,0.387,0.434,1616
sympathize,-0.202,14,263,1,1,0.77,0.627,0.644,277
kidnapped,-0.202,14,263,1,1,0.044,0.923,0.455,277
gracias,-0.202,4,87,1,1,0.833,0.356,0.6,91
likable,-0.202,4,87,1,1,0.865,0.48,0.663,91
juvenile,-0.202,4,87,1,1,0.678,0.49,0.526,91
amends,-0.202,4,87,1,1,0.64,0.366,0.517,91
impersonal,-0.202,4,87,1,1,0.316,0.356,0.472,91
trouble,-0.203,149,2640,1,1,0.135,0.811,0.452,2789
leg,-0.203,51,915,1,1,0.51,0.373,0.313,966
covered,-0.203,83,1479,1,1,0.562,0.34,0.644,1562
plate,-0.203,44,792,1,1,0.583,0.245,0.366,836
childhood,-0.204,204,3612,1,1,0.865,0.413,0.307,3816
mask,-0.204,119,2114,1,1,0.51,0.49,0.537,2233
lend,-0.204,26,475,1,1,0.52,0.461,0.508,501
blues,-0.204,75,1339,1,1,0.469,0.22,0.287,1414
broadcast,-0.204,18,334,1,1,0.615,0.587,0.355,352
mother,-0.204,500,8833,1,1,0.931,0.408,0.725,9333
radio,-0.204,174,3085,1,1,0.573,0.402,0.358,3259
landing,-0.204,32,581,1,1,0.552,0.696,0.596,613
alarm,-0.204,35,634,1,1,0.241,0.882,0.698,669
topic,-0.205,77,1376,1,1,0.52,0.276,0.427,1453
swerve,-0.206,2,52,1,1,0.276,0.612,0.357,54
fern,-0.206,2,52,1,1,0.602,0.24,0.29,54
grappling,-0.206,2,52,1,1,0.448,0.676,0.516,54
liven,-0.206,2,52,1,1,0.708,0.713,0.673,54
missile,-0.206,2,52,1,1,0.24,0.83,0.764,54
filing,-0.206,2,52,1,1,0.62,0.42,0.7,54
accuracy,-0.206,5,105,1,1,0.604,0.481,0.802,110
braid,-0.206,2,52,1,1,0.427,0.222,0.216,54
alcohol,-0.206,139,2473,1,1,0.323,0.667,0.377,2612
criminal,-0.206,51,918,1,1,0.021,0.83,0.529,969
quick,-0.206,212,3764,1,1,0.704,0.755,0.75,3976
jacket,-0.207,30,547,1,1,0.656,0.302,0.382,577
tag,-0.207,123,2191,1,1,0.612,0.353,0.375,2314
pot,-0.207,34,618,1,1,0.5,0.186,0.294,652
guarantee,-0.208,42,760,1,1,0.949,0.337,0.805,802
thinking,-0.208,1907,33776,1,1,0.72,0.308,0.595,35683
sounding,-0.208,37,672,1,1,0.69,0.5,0.558,709
meet,-0.208,1115,19765,1,1,0.76,0.51,0.58,20880
scrub,-0.209,6,123,1,1,0.417,0.42,0.5,129
outlet,-0.209,34,619,1,1,0.61,0.396,0.245,653
dissatisfied,-0.209,6,123,1,1,0.042,0.561,0.291,129
encouraging,-0.209,38,690,1,1,0.823,0.583,0.755,728
standard,-0.209,42,761,1,1,0.673,0.143,0.605,803
grab,-0.209,96,1718,1,1,0.448,0.706,0.538,1814
aurora,-0.209,17,318,1,1,0.817,0.306,0.537,335
screaming,-0.209,166,2959,1,1,0.245,0.901,0.46,3125
cinnamon,-0.209,10,194,1,1,0.6,0.25,0.292,204
drawer,-0.209,10,194,1,1,0.429,0.196,0.292,204
incentive,-0.211,3,70,1,1,0.812,0.618,0.718,73
wot,-0.211,3,70,1,1,0.52,0.48,0.357,73
limelight,-0.211,7,141,1,1,0.667,0.639,0.694,148
infrastructure,-0.211,7,141,1,1,0.604,0.46,0.694,148
workload,-0.211,3,70,1,1,0.231,0.792,0.49,73
shockingly,-0.211,3,70,1,1,0.51,0.924,0.721,73
supremely,-0.211,3,70,1,1,0.833,0.725,0.897,73
appalled,-0.211,3,70,1,1,0.194,0.792,0.562,73
hole,-0.211,235,4190,1,1,0.531,0.31,0.33,4425
appointments,-0.212,12,230,1,1,0.745,0.677,0.625,242
alien,-0.212,69,1243,1,1,0.41,0.615,0.491,1312
mix,-0.212,164,2932,1,1,0.542,0.49,0.472,3096
irresponsible,-0.212,8,159,1,1,0.177,0.68,0.241,167
unread,-0.213,14,266,1,1,0.458,0.24,0.214,280
podium,-0.213,4,88,1,1,0.627,0.365,0.702,92
oldie,-0.213,4,88,1,1,0.363,0.363,0.342,92
handshake,-0.213,4,88,1,1,0.816,0.654,0.492,92
provision,-0.213,4,88,1,1,0.75,0.45,0.692,92
immaturity,-0.213,4,88,1,1,0.146,0.567,0.221,92
denominator,-0.213,4,88,1,1,0.45,0.41,0.613,92
runner,-0.214,55,996,1,1,0.459,0.747,0.632,1051
can,-0.214,18016,320858,1,1,0.662,0.36,0.454,338874
move,-0.214,898,16013,1,1,0.656,0.647,0.67,16911
spiders,-0.214,26,480,1,1,0.26,0.696,0.368,506
lust,-0.214,65,1175,1,1,0.469,0.944,0.518,1240
creator,-0.215,84,1514,1,1,0.865,0.592,0.856,1598
mew,-0.215,5,106,1,1,0.418,0.481,0.38,111
shocking,-0.215,23,427,1,1,0.378,0.853,0.833,450
confusing,-0.216,73,1319,1,1,0.229,0.69,0.222,1392
cell,-0.216,210,3763,1,1,0.541,0.375,0.465,3973
ended,-0.216,244,4370,1,1,0.302,0.5,0.5,4614
obnoxious,-0.216,18,338,1,1,0.088,0.602,0.256,356
telephone,-0.216,18,338,1,1,0.694,0.52,0.425,356
nonexistent,-0.216,12,231,1,1,0.208,0.429,0.149,243
spiral,-0.216,32,588,1,1,0.49,0.624,0.361,620
persona,-0.216,39,713,1,1,0.741,0.48,0.743,752
grape,-0.217,6,124,1,1,0.729,0.122,0.295,130
dysfunction,-0.217,6,124,1,1,0.156,0.41,0.386,130
accusing,-0.217,6,124,1,1,0.156,0.745,0.324,130
platform,-0.217,75,1357,1,1,0.602,0.34,0.718,1432
ditch,-0.217,30,553,1,1,0.357,0.364,0.322,583
acknowledge,-0.218,86,1555,1,1,0.786,0.37,0.661,1641
babysit,-0.218,8,160,1,1,0.719,0.587,0.398,168
listing,-0.218,8,160,1,1,0.438,0.273,0.432,168
twist,-0.22,43,787,1,1,0.375,0.469,0.337,830
reminder,-0.22,198,3563,1,1,0.552,0.423,0.589,3761
pessimistic,-0.22,11,214,1,1,0.088,0.394,0.236,225
mock,-0.22,24,447,1,1,0.36,0.606,0.618,471
officer,-0.22,24,447,1,1,0.542,0.43,0.877,471
punching,-0.22,12,232,1,1,0.332,0.915,0.623,244
shame,-0.221,264,4750,1,1,0.06,0.67,0.155,5014
lovable,-0.221,13,250,1,1,0.948,0.335,0.565,263
outcast,-0.221,43,788,1,1,0.153,0.449,0.353,831
fatigue,-0.221,29,537,1,1,0.173,0.378,0.265,566
fundamentally,-0.221,15,286,1,1,0.653,0.441,0.759,301
chop,-0.221,16,304,1,1,0.25,0.655,0.467,320
sweaty,-0.222,17,322,1,1,0.281,0.54,0.304,339
justify,-0.222,37,681,1,1,0.612,0.473,0.615,718
fried,-0.222,21,394,1,1,0.479,0.482,0.336,415
verge,-0.223,27,502,1,1,0.5,0.337,0.305,529
hack,-0.223,27,502,1,1,0.135,0.717,0.534,529
problem,-0.223,657,11822,1,1,0.062,0.644,0.415,12479
go,-0.224,7429,133693,1,1,0.51,0.441,0.444,141122
confessional,-0.225,1,35,1,1,0.458,0.392,0.629,36
hapless,-0.225,1,35,1,1,0.271,0.442,0.193,36
keynote,-0.225,4,89,1,1,0.63,0.431,0.545,93
radioactive,-0.225,4,89,1,1,0.19,0.798,0.741,93
armchair,-0.225,8,161,1,1,0.646,0.164,0.339,169
borough,-0.225,2,53,1,1,0.429,0.343,0.38,55
startling,-0.225,3,71,1,1,0.75,0.768,0.83,74
motherland,-0.225,1,35,1,1,0.677,0.375,0.731,36
arseholes,-0.225,2,53,1,1,0.188,0.545,0.351,55
cracker,-0.225,6,125,1,1,0.604,0.343,0.346,131
gunshot,-0.225,1,35,1,1,0.042,0.953,0.673,36
afflict,-0.225,1,35,1,1,0.302,0.555,0.293,36
eyeliner,-0.225,1,35,1,1,0.688,0.349,0.347,36
promotional,-0.225,1,35,1,1,0.84,0.646,0.679,36
groupie,-0.225,2,53,1,1,0.521,0.583,0.393,55
severity,-0.225,2,53,1,1,0.26,0.712,0.661,55
recon,-0.225,1,35,1,1,0.5,0.447,0.4,36
nicotine,-0.225,5,107,1,1,0.235,0.608,0.447,112
council,-0.225,23,431,1,1,0.875,0.279,0.635,454
bake,-0.225,24,449,1,1,0.867,0.418,0.519,473
yeast,-0.225,1,35,1,1,0.5,0.35,0.327,36
babysitter,-0.225,4,89,1,1,0.656,0.415,0.408,93
donor,-0.225,3,71,1,1,0.714,0.49,0.653,74
yayyyy,-0.225,1,35,1,1,0.677,0.613,0.363,36
crock,-0.225,1,35,1,1,0.385,0.412,0.421,36
shrill,-0.225,3,71,1,1,0.312,0.721,0.64,74
athletics,-0.225,1,35,1,1,0.831,0.691,0.74,36
burke,-0.225,2,53,1,1,0.466,0.441,0.451,55
fracture,-0.225,1,35,1,1,0.135,0.74,0.375,36
accused,-0.225,18,341,1,1,0.13,0.67,0.42,359
professionalism,-0.225,1,35,1,1,0.781,0.541,0.944,36
virginity,-0.225,13,251,1,1,0.691,0.676,0.576,264
euphemism,-0.225,1,35,1,1,0.418,0.453,0.491,36
let,-0.225,4437,79908,1,1,0.427,0.373,0.307,84345
verse,-0.226,55,1008,1,1,0.667,0.269,0.336,1063
cheering,-0.226,40,738,1,1,0.815,0.824,0.642,778
twin,-0.226,78,1423,1,1,0.688,0.363,0.453,1501
push,-0.226,298,5391,1,1,0.417,0.608,0.524,5689
blue,-0.227,484,8746,1,1,0.646,0.137,0.291,9230
blunt,-0.227,68,1244,1,1,0.551,0.68,0.925,1312
mighty,-0.228,49,902,1,1,0.855,0.837,0.936,951
sample,-0.228,14,270,1,1,0.521,0.187,0.452,284
t-shirt,-0.228,14,270,1,1,0.815,0.286,0.284,284
wave,-0.228,157,2854,1,1,0.622,0.491,0.49,3011
impulsive,-0.229,12,234,1,1,0.365,0.864,0.607,246
sideways,-0.229,12,234,1,1,0.788,0.245,0.291,246
poster,-0.229,36,668,1,1,0.542,0.275,0.365,704
dread,-0.229,71,1301,1,1,0.153,0.792,0.368,1372
actress,-0.229,22,415,1,1,0.633,0.556,0.596,437
summer,-0.23,566,10256,1,1,0.812,0.373,0.55,10822
cologne,-0.23,10,198,1,1,0.677,0.413,0.552,208
touched,-0.23,83,1519,1,1,0.592,0.38,0.404,1602
license,-0.23,19,361,1,1,0.5,0.394,0.702,380
abandoned,-0.231,186,3385,1,1,0.046,0.481,0.13,3571
entrepreneur,-0.231,26,488,1,1,0.885,0.704,0.92,514
turtle,-0.231,26,488,1,1,0.291,0.102,0.271,514
woody,-0.231,8,162,1,1,0.469,0.26,0.396,170
maniac,-0.231,8,162,1,1,0.12,0.849,0.431,170
cricket,-0.231,16,307,1,1,0.423,0.539,0.37,323
heaviness,-0.232,7,144,1,1,0.219,0.549,0.318,151
roar,-0.232,39,724,1,1,0.427,0.816,0.675,763
decrease,-0.232,14,271,1,1,0.125,0.36,0.267,285
autism,-0.232,29,543,1,1,0.235,0.5,0.447,572
scum,-0.232,28,525,1,1,0.357,0.38,0.218,553
have,-0.232,21682,393365,1,1,0.757,0.389,0.593,415047
crate,-0.233,6,126,1,1,0.427,0.173,0.274,132
predatory,-0.233,6,126,1,1,0.083,0.865,0.731,132
graphic,-0.233,12,235,1,1,0.602,0.494,0.491,247
coping,-0.233,89,1633,1,1,0.562,0.63,0.613,1722
maid,-0.233,18,344,1,1,0.406,0.324,0.3,362
constituents,-0.234,5,108,1,1,0.573,0.414,0.833,113
tall,-0.234,77,1416,1,1,0.725,0.591,0.538,1493
stale,-0.234,11,217,1,1,0.235,0.461,0.286,228
relieve,-0.234,35,653,1,1,0.813,0.183,0.536,688
folk,-0.234,74,1362,1,1,0.663,0.433,0.432,1436
tiring,-0.234,73,1344,1,1,0.153,0.51,0.176,1417
thirst,-0.235,43,799,1,1,0.298,0.519,0.307,842
monster,-0.235,125,2290,1,1,0.133,0.935,0.596,2415
intelligent,-0.235,64,1181,1,1,0.917,0.541,0.868,1245
news,-0.235,326,5946,1,1,0.633,0.58,0.61,6272
subway,-0.235,20,381,1,1,0.418,0.3,0.464,401
binge,-0.235,70,1291,1,1,0.304,0.65,0.5,1361
regulars,-0.236,4,90,1,1,0.729,0.327,0.508,94
trillion,-0.236,4,90,1,1,0.592,0.42,0.623,94
casual,-0.236,47,873,1,1,0.643,0.224,0.385,920
despair,-0.237,268,4899,1,1,0.115,0.794,0.245,5167
doubtful,-0.237,8,163,1,1,0.25,0.465,0.241,171
argh,-0.237,8,163,1,1,0.26,0.538,0.328,171
mike,-0.237,66,1220,1,1,0.542,0.365,0.423,1286
truck,-0.237,57,1056,1,1,0.531,0.368,0.546,1113
portray,-0.238,16,309,1,1,0.656,0.529,0.457,325
tear,-0.238,129,2371,1,1,0.404,0.62,0.327,2500
ping,-0.238,7,145,1,1,0.541,0.49,0.391,152
font,-0.238,3,72,1,1,0.615,0.336,0.576,75
legislation,-0.238,3,72,1,1,0.531,0.418,0.808,75
hyped,-0.238,23,437,1,1,0.708,0.582,0.679,460
veggie,-0.238,3,72,1,1,0.602,0.245,0.409,75
steak,-0.238,23,437,1,1,0.625,0.359,0.315,460
workplace,-0.239,22,419,1,1,0.592,0.431,0.583,441
dripping,-0.239,14,273,1,1,0.302,0.257,0.267,287
motivation,-0.24,94,1735,1,1,0.854,0.784,0.802,1829
stage,-0.24,214,3930,1,1,0.592,0.306,0.473,4144
touchy,-0.24,6,127,1,1,0.323,0.51,0.343,133
neck,-0.24,100,1846,1,1,0.541,0.245,0.345,1946
prey,-0.241,40,749,1,1,0.378,0.5,0.306,789
welsh,-0.241,9,182,1,1,0.49,0.385,0.5,191
cocktail,-0.242,12,237,1,1,0.74,0.48,0.381,249
shepherd,-0.242,25,475,1,1,0.656,0.304,0.61,500
oral,-0.242,15,292,1,1,0.53,0.448,0.375,307
free,-0.242,1509,27663,1,1,0.896,0.5,0.544,29172
hobby,-0.242,80,1483,1,1,0.827,0.56,0.471,1563
peak,-0.242,113,2088,1,1,0.5,0.345,0.431,2201
anarchist,-0.243,2,54,1,1,0.204,0.7,0.759,56
yap,-0.243,2,54,1,1,0.51,0.458,0.37,56
specialist,-0.243,5,109,1,1,0.76,0.562,0.877,114
causal,-0.243,2,54,1,1,0.562,0.367,0.491,56
corona,-0.243,2,54,1,1,0.818,0.439,0.745,56
defenseless,-0.243,5,109,1,1,0.143,0.357,0.105,114
presenter,-0.243,2,54,1,1,0.673,0.607,0.735,56
remarry,-0.243,2,54,1,1,0.653,0.791,0.54,56
cobra,-0.243,2,54,1,1,0.312,0.712,0.6,56
probe,-0.243,2,54,1,1,0.398,0.444,0.512,56
spare,-0.243,87,1613,1,1,0.552,0.398,0.411,1700
decent,-0.244,100,1852,1,1,0.823,0.296,0.653,1952
family,-0.244,2409,44216,1,1,0.968,0.383,0.643,46625
hopes,-0.244,125,2311,1,1,0.917,0.5,0.702,2436
beck,-0.244,19,366,1,1,0.58,0.375,0.418,385
day,-0.244,7718,141645,1,1,0.719,0.269,0.389,149363
calls,-0.244,288,5304,1,1,0.608,0.431,0.551,5592
cowardly,-0.244,13,256,1,1,0.102,0.385,0.127,269
dismiss,-0.245,10,201,1,1,0.167,0.541,0.509,211
remedy,-0.245,63,1175,1,1,0.625,0.283,0.491,1238
wrestling,-0.246,20,385,1,1,0.449,0.868,0.774,405
changed,-0.246,303,5588,1,1,0.594,0.375,0.491,5891
virtual,-0.247,59,1103,1,1,0.598,0.532,0.463,1162
scan,-0.247,4,91,1,1,0.479,0.423,0.47,95
ninja,-0.247,14,275,1,1,0.542,0.844,0.682,289
petting,-0.247,9,183,1,1,0.812,0.462,0.48,192
clutch,-0.247,9,183,1,1,0.383,0.5,0.491,192
combination,-0.247,83,1545,1,1,0.708,0.48,0.726,1628
rod,-0.247,16,312,1,1,0.479,0.319,0.355,328
twins,-0.247,35,662,1,1,0.76,0.473,0.602,697
powerless,-0.247,23,441,1,1,0.125,0.5,0.328,464
profit,-0.248,18,349,1,1,0.93,0.462,0.721,367
east,-0.248,103,1915,1,1,0.51,0.25,0.317,2018
overwhelmed,-0.248,128,2376,1,1,0.341,0.68,0.348,2504
forgive,-0.248,123,2284,1,1,0.781,0.408,0.562,2407
timeless,-0.248,27,515,1,1,0.408,0.468,0.583,542
exploit,-0.248,13,257,1,1,0.312,0.878,0.66,270
curry,-0.248,13,257,1,1,0.633,0.345,0.302,270
profession,-0.248,27,515,1,1,0.68,0.529,0.786,542
worm,-0.249,15,294,1,1,0.13,0.418,0.219,309
hypocrite,-0.249,19,368,1,1,0.082,0.673,0.306,387
increased,-0.249,39,737,1,1,0.684,0.66,0.773,776
drag,-0.25,89,1660,1,1,0.388,0.606,0.348,1749
people,-0.25,15296,282315,1,1,0.604,0.4,0.5,297611
split,-0.25,46,867,1,1,0.344,0.618,0.41,913
harassment,-0.25,16,313,1,1,0.083,0.896,0.42,329
bar,-0.25,249,4617,1,1,0.5,0.531,0.481,4866
normal,-0.251,395,7317,1,1,0.74,0.127,0.38,7712
horse,-0.251,95,1774,1,1,0.635,0.51,0.529,1869
sign,-0.252,305,5659,1,1,0.62,0.481,0.397,5964
ferret,-0.252,3,73,1,1,0.385,0.391,0.398,76
pretzel,-0.252,1,36,1,1,0.519,0.323,0.358,37
shameful,-0.252,21,406,1,1,0.04,0.68,0.264,427
wreak,-0.252,3,73,1,1,0.375,0.622,0.498,76
inaccurate,-0.252,3,73,1,1,0.135,0.45,0.25,76
dispatch,-0.252,3,73,1,1,0.317,0.417,0.555,76
impunity,-0.252,1,36,1,1,0.313,0.721,0.602,37
obscenity,-0.252,1,36,1,1,0.083,0.843,0.418,37
potty,-0.252,3,73,1,1,0.367,0.373,0.317,76
flaunt,-0.252,3,73,1,1,0.438,0.611,0.525,76
heretic,-0.252,1,36,1,1,0.09,0.71,0.447,37
churchyard,-0.252,1,36,1,1,0.296,0.444,0.347,37
flaccid,-0.252,1,36,1,1,0.156,0.4,0.151,37
seam,-0.252,1,36,1,1,0.427,0.25,0.414,37
powerhouse,-0.252,1,36,1,1,0.63,0.755,0.787,37
escalator,-0.252,1,36,1,1,0.5,0.53,0.518,37
goofball,-0.252,1,36,1,1,0.561,0.55,0.382,37
wobble,-0.252,1,36,1,1,0.375,0.62,0.35,37
yahoo,-0.252,3,73,1,1,0.643,0.583,0.522,76
turnip,-0.252,1,36,1,1,0.561,0.183,0.254,37
bony,-0.252,1,36,1,1,0.445,0.462,0.33,37
visa,-0.252,5,110,1,1,0.735,0.367,0.66,115
innocent,-0.253,81,1517,1,1,0.729,0.206,0.34,1598
bitterness,-0.253,65,1221,1,1,0.115,0.633,0.27,1286
story,-0.253,839,15554,1,1,0.653,0.406,0.704,16393
home,-0.253,3914,72535,1,1,0.854,0.27,0.545,76449
trench,-0.254,14,277,1,1,0.429,0.76,0.429,291
thrill,-0.254,29,555,1,1,0.888,0.837,0.711,584
unrelated,-0.254,12,240,1,1,0.302,0.27,0.264,252
medical,-0.254,51,963,1,1,0.583,0.373,0.616,1014
clique,-0.254,12,240,1,1,0.427,0.43,0.391,252
rat,-0.254,56,1056,1,1,0.271,0.567,0.255,1112
warned,-0.254,21,407,1,1,0.302,0.604,0.547,428
cruising,-0.255,8,166,1,1,0.886,0.58,0.56,174
pick,-0.256,340,6330,1,1,0.5,0.464,0.525,6670
munch,-0.256,6,129,1,1,0.541,0.277,0.434,135
amplify,-0.256,6,129,1,1,0.677,0.735,0.827,135
op,-0.256,27,519,1,1,0.48,0.402,0.349,546
badass,-0.256,25,482,1,1,0.255,0.775,0.745,507
drive,-0.256,450,8378,1,1,0.625,0.689,0.713,8828
nephew,-0.257,28,538,1,1,0.719,0.337,0.412,566
episode,-0.257,229,4274,1,1,0.719,0.367,0.509,4503
syrup,-0.257,4,92,1,1,0.62,0.223,0.318,96
hearing,-0.259,194,3631,1,1,0.669,0.49,0.595,3825
obsess,-0.259,10,204,1,1,0.112,0.846,0.509,214
zeppelin,-0.26,13,260,1,1,0.542,0.55,0.472,273
program,-0.26,50,950,1,1,0.561,0.323,0.713,1000
face,-0.261,1179,22016,1,1,0.571,0.173,0.453,23195
bug,-0.261,43,820,1,1,0.286,0.5,0.246,863
tofu,-0.261,2,55,1,1,0.521,0.33,0.283,57
spencer,-0.261,8,167,1,1,0.51,0.394,0.367,175
canary,-0.261,2,55,1,1,0.582,0.276,0.265,57
stab,-0.261,20,391,1,1,0.167,0.882,0.595,411
wrestler,-0.261,2,55,1,1,0.52,0.863,0.911,57
macaroni,-0.261,5,111,1,1,0.816,0.41,0.382,116
spanking,-0.261,2,55,1,1,0.194,0.736,0.392,57
raptors,-0.261,2,55,1,1,0.28,0.565,0.591,57
arouse,-0.261,2,55,1,1,0.74,0.491,0.58,57
bale,-0.261,2,55,1,1,0.437,0.363,0.412,57
wireless,-0.261,2,55,1,1,0.635,0.444,0.537,57
virus,-0.261,11,223,1,1,0.277,0.74,0.443,234
visit,-0.262,462,8648,1,1,0.771,0.443,0.445,9110
height,-0.263,29,560,1,1,0.677,0.608,0.648,589
famous,-0.263,126,2374,1,1,0.916,0.775,0.882,2500
shorts,-0.263,16,317,1,1,0.622,0.481,0.287,333
ray,-0.263,54,1028,1,1,0.55,0.67,0.538,1082
wee,-0.263,72,1365,1,1,0.663,0.452,0.315,1437
wag,-0.264,13,261,1,1,0.448,0.49,0.481,274
bribe,-0.264,6,130,1,1,0.112,0.69,0.472,136
store,-0.264,150,2826,1,1,0.646,0.538,0.407,2976
psychology,-0.264,28,542,1,1,0.561,0.396,0.726,570
collar,-0.264,10,205,1,1,0.656,0.442,0.446,215
added,-0.264,106,2003,1,1,0.562,0.405,0.509,2109
graduate,-0.265,34,655,1,1,0.898,0.549,0.778,689
demeaning,-0.265,3,74,1,1,0.104,0.645,0.308,77
unreliable,-0.265,3,74,1,1,0.108,0.48,0.24,77
lifeless,-0.265,23,449,1,1,0.042,0.333,0.163,472
receipt,-0.265,3,74,1,1,0.542,0.23,0.415,77
misled,-0.265,3,74,1,1,0.177,0.606,0.353,77
gent,-0.265,3,74,1,1,0.573,0.494,0.464,77
buzzed,-0.265,7,149,1,1,0.583,0.549,0.448,156
birdie,-0.265,3,74,1,1,0.594,0.394,0.407,77
dairy,-0.265,7,149,1,1,0.633,0.255,0.462,156
prince,-0.266,122,2306,1,1,0.888,0.464,0.87,2428
gap,-0.266,50,956,1,1,0.396,0.451,0.357,1006
curl,-0.266,42,806,1,1,0.385,0.452,0.351,848
shameless,-0.266,12,243,1,1,0.274,0.713,0.407,255
reach,-0.266,567,10660,1,1,0.719,0.625,0.69,11227
suggestion,-0.267,21,412,1,1,0.646,0.365,0.558,433
magician,-0.267,8,168,1,1,0.714,0.657,0.551,176
sell,-0.267,99,1877,1,1,0.618,0.608,0.605,1976
lap,-0.267,51,976,1,1,0.583,0.51,0.412,1027
stay,-0.268,1906,35841,1,1,0.604,0.275,0.516,37747
onset,-0.268,4,93,1,1,0.673,0.497,0.5,97
trough,-0.268,9,187,1,1,0.5,0.308,0.34,196
narcissism,-0.268,14,281,1,1,0.214,0.639,0.54,295
holler,-0.268,4,93,1,1,0.276,0.825,0.406,97
rover,-0.269,16,319,1,1,0.51,0.538,0.421,335
dream,-0.269,640,12066,1,1,0.844,0.157,0.328,12706
flipping,-0.27,11,225,1,1,0.553,0.551,0.345,236
peel,-0.27,5,112,1,1,0.439,0.25,0.279,117
professional,-0.27,66,1261,1,1,0.833,0.447,0.943,1327
pin,-0.27,24,470,1,1,0.438,0.346,0.39,494
hooked,-0.271,25,489,1,1,0.61,0.661,0.454,514
lin,-0.271,6,131,1,1,0.416,0.362,0.343,137
eventual,-0.271,6,131,1,1,0.633,0.459,0.413,137
riddled,-0.271,6,131,1,1,0.281,0.861,0.422,137
stressing,-0.271,28,546,1,1,0.163,0.866,0.462,574
morals,-0.271,21,414,1,1,0.646,0.43,0.611,435
instability,-0.272,7,150,1,1,0.177,0.76,0.353,157
screwed,-0.272,24,471,1,1,0.302,0.52,0.464,495
cheesecake,-0.273,8,169,1,1,0.86,0.276,0.238,177
aching,-0.273,45,868,1,1,0.053,0.88,0.348,913
delivery,-0.273,29,566,1,1,0.704,0.461,0.786,595
climax,-0.273,9,188,1,1,0.735,0.853,0.667,197
brave,-0.273,159,3023,1,1,0.837,0.75,0.917,3182
fits,-0.274,159,3024,1,1,0.571,0.363,0.58,3183
give,-0.274,2630,49747,1,1,0.75,0.346,0.5,52377
argue,-0.274,68,1304,1,1,0.093,0.798,0.525,1372
data,-0.274,58,1115,1,1,0.5,0.25,0.426,1173
bird,-0.274,207,3934,1,1,0.729,0.357,0.364,4141
main,-0.274,269,5107,1,1,0.667,0.51,0.811,5376
politician,-0.275,12,245,1,1,0.323,0.551,0.863,257
facing,-0.275,108,2062,1,1,0.604,0.406,0.55,2170
immune,-0.277,24,473,1,1,0.629,0.472,0.78,497
medication,-0.277,25,492,1,1,0.615,0.439,0.5,517
turn,-0.277,756,14354,1,1,0.531,0.398,0.482,15110
think,-0.277,6491,123116,1,1,0.786,0.408,0.618,129607
hero,-0.278,147,2810,1,1,0.94,0.806,0.881,2957
wimp,-0.279,2,56,1,1,0.184,0.49,0.125,58
impressionable,-0.279,4,94,1,1,0.827,0.72,0.645,98
storming,-0.279,6,132,1,1,0.265,0.91,0.669,138
marbles,-0.279,3,75,1,1,0.714,0.345,0.241,78
marmalade,-0.279,2,56,1,1,0.729,0.37,0.288,58
warp,-0.279,2,56,1,1,0.344,0.417,0.373,58
bombard,-0.279,1,37,1,1,0.156,0.961,0.777,38
exaggerate,-0.279,2,56,1,1,0.193,0.76,0.529,58
publicity,-0.279,9,189,1,1,0.59,0.622,0.679,198
headless,-0.279,1,37,1,1,0.136,0.582,0.235,38
merchandise,-0.279,2,56,1,1,0.594,0.46,0.621,58
orphaned,-0.279,6,132,1,1,0.062,0.43,0.228,138
marshal,-0.279,1,37,1,1,0.469,0.61,0.819,38
scoot,-0.279,1,37,1,1,0.51,0.49,0.412,38
slipper,-0.279,1,37,1,1,0.635,0.298,0.245,38
airhead,-0.279,1,37,1,1,0.271,0.481,0.276,38
saber,-0.279,3,75,1,1,0.551,0.62,0.553,78
frisk,-0.279,2,56,1,1,0.49,0.547,0.377,58
shithead,-0.279,4,94,1,1,0.12,0.645,0.302,98
drastic,-0.279,6,132,1,1,0.194,0.839,0.657,138
unethical,-0.279,2,56,1,1,0.104,0.433,0.269,58
colon,-0.279,1,37,1,1,0.449,0.394,0.384,38
ginger,-0.279,15,303,1,1,0.406,0.375,0.316,318
tod,-0.279,2,56,1,1,0.469,0.33,0.384,58
cushion,-0.279,5,113,1,1,0.653,0.221,0.292,118
chunky,-0.279,2,56,1,1,0.52,0.517,0.509,58
whiff,-0.279,1,37,1,1,0.459,0.4,0.331,38
scourge,-0.279,3,75,1,1,0.214,0.64,0.302,78
touch,-0.28,565,10765,1,1,0.646,0.477,0.455,11330
today,-0.28,3209,61065,1,1,0.806,0.306,0.362,64274
orange,-0.28,82,1578,1,1,0.646,0.132,0.296,1660
optimistic,-0.281,22,437,1,1,0.979,0.58,0.821,459
article,-0.282,128,2457,1,1,0.594,0.28,0.481,2585
third,-0.283,137,2632,1,1,0.551,0.187,0.304,2769
person,-0.283,3662,69903,1,1,0.646,0.363,0.596,73565
discussion,-0.283,54,1049,1,1,0.333,0.842,0.536,1103
panic,-0.283,97,1870,1,1,0.062,0.938,0.4,1967
facts,-0.284,143,2749,1,1,0.688,0.471,0.693,2892
assume,-0.284,135,2597,1,1,0.698,0.401,0.464,2732
selfish,-0.284,248,4756,1,1,0.061,0.637,0.495,5004
crack,-0.284,65,1260,1,1,0.302,0.625,0.4,1325
dramatic,-0.284,80,1547,1,1,0.367,0.78,0.443,1627
midnight,-0.285,243,4663,1,1,0.562,0.47,0.545,4906
swan,-0.285,16,324,1,1,0.781,0.225,0.357,340
strategy,-0.285,49,955,1,1,0.704,0.667,0.858,1004
appalling,-0.285,7,152,1,1,0.16,0.827,0.415,159
accuse,-0.285,7,152,1,1,0.133,0.752,0.5,159
aquarium,-0.286,6,133,1,1,0.663,0.327,0.393,139
rookie,-0.286,6,133,1,1,0.583,0.37,0.198,139
steer,-0.286,13,267,1,1,0.469,0.49,0.527,280
chemistry,-0.287,19,382,1,1,0.625,0.52,0.694,401
rapper,-0.287,25,497,1,1,0.55,0.755,0.482,522
oversized,-0.287,5,114,1,1,0.552,0.54,0.679,119
excessively,-0.287,5,114,1,1,0.449,0.882,0.716,119
chandler,-0.287,5,114,1,1,0.51,0.452,0.454,119
claim,-0.288,102,1974,1,1,0.255,0.76,0.473,2076
save,-0.288,519,9970,1,1,0.77,0.439,0.682,10489
agency,-0.288,33,651,1,1,0.46,0.296,0.583,684
lowering,-0.288,10,210,1,1,0.286,0.363,0.236,220
honest,-0.289,328,6312,1,1,0.927,0.254,0.75,6640
impact,-0.289,121,2341,1,1,0.469,0.884,0.776,2462
white,-0.289,625,12017,1,1,0.729,0.173,0.42,12642
convinced,-0.289,105,2034,1,1,0.75,0.5,0.63,2139
truthful,-0.289,9,191,1,1,0.708,0.467,0.807,200
pix,-0.289,4,95,1,1,0.521,0.373,0.364,99
speechless,-0.289,14,287,1,1,0.459,0.32,0.315,301
friendliness,-0.289,4,95,1,1,0.981,0.27,0.611,99
microphone,-0.289,4,95,1,1,0.551,0.431,0.462,99
dagger,-0.289,4,95,1,1,0.224,0.797,0.613,99
roll,-0.29,121,2343,1,1,0.469,0.51,0.172,2464
listen,-0.29,1214,23346,1,1,0.771,0.36,0.445,24560
slot,-0.29,8,172,1,1,0.469,0.337,0.337,180
replacement,-0.291,16,326,1,1,0.385,0.519,0.5,342
grind,-0.291,67,1307,1,1,0.48,0.276,0.397,1374
scar,-0.291,24,480,1,1,0.146,0.5,0.397,504
ton,-0.291,65,1269,1,1,0.56,0.418,0.604,1334
nap,-0.292,104,2020,1,1,0.66,0.098,0.342,2124
burner,-0.292,7,153,1,1,0.296,0.816,0.446,160
wrist,-0.292,15,307,1,1,0.706,0.34,0.265,322
wheelchair,-0.292,7,153,1,1,0.24,0.337,0.245,160
illegally,-0.292,3,76,1,1,0.133,0.788,0.402,79
algorithm,-0.292,7,153,1,1,0.448,0.394,0.559,160
nun,-0.292,45,885,1,1,0.5,0.15,0.406,930
summon,-0.293,17,346,1,1,0.521,0.56,0.664,363
couple,-0.293,628,12125,1,1,0.806,0.605,0.607,12753
catastrophic,-0.294,6,134,1,1,0.071,0.934,0.598,140
uphill,-0.294,6,134,1,1,0.396,0.723,0.572,140
bite,-0.294,63,1234,1,1,0.219,0.796,0.51,1297
fixed,-0.294,49,964,1,1,0.684,0.167,0.509,1013
regret,-0.295,220,4268,1,1,0.23,0.623,0.331,4488
troubled,-0.296,42,830,1,1,0.167,0.627,0.385,872
mention,-0.296,155,3014,1,1,0.562,0.365,0.562,3169
wait,-0.296,1200,23211,1,1,0.224,0.167,0.264,24411
babble,-0.296,5,115,1,1,0.552,0.441,0.204,120
traction,-0.296,2,57,1,1,0.429,0.585,0.648,59
insider,-0.296,2,57,1,1,0.625,0.562,0.75,59
mayday,-0.296,5,115,1,1,0.344,0.643,0.423,120
blind,-0.296,116,2261,1,1,0.156,0.36,0.184,2377
growling,-0.296,2,57,1,1,0.119,0.887,0.475,59
equity,-0.296,2,57,1,1,0.792,0.304,0.614,59
wench,-0.296,2,57,1,1,0.469,0.519,0.352,59
motherfucking,-0.296,11,231,1,1,0.071,0.823,0.373,242
minion,-0.296,2,57,1,1,0.49,0.43,0.167,59
soccer,-0.297,19,386,1,1,0.698,0.837,0.644,405
trap,-0.297,75,1470,1,1,0.104,0.61,0.391,1545
shatter,-0.298,10,212,1,1,0.108,0.821,0.464,222
sod,-0.298,7,154,1,1,0.427,0.383,0.333,161
auto,-0.298,15,309,1,1,0.571,0.569,0.5,324
mixed,-0.298,116,2266,1,1,0.51,0.346,0.444,2382
trainer,-0.299,12,251,1,1,0.698,0.719,0.824,263
tooth,-0.299,12,251,1,1,0.439,0.25,0.367,263
busy,-0.299,715,13882,1,1,0.402,0.5,0.474,14597
sure,-0.299,1675,32507,1,1,0.724,0.27,0.793,34182
yesterday,-0.299,375,7293,1,1,0.5,0.286,0.253,7668
drivel,-0.3,4,96,1,1,0.398,0.469,0.463,100
blob,-0.3,4,96,1,1,0.5,0.376,0.298,100
coherent,-0.3,4,96,1,1,0.698,0.281,0.5,100
risky,-0.3,19,387,1,1,0.224,0.922,0.7,406
hog,-0.3,4,96,1,1,0.317,0.509,0.271,100
contagious,-0.3,23,465,1,1,0.184,0.725,0.4,488
special,-0.301,506,9849,1,1,0.844,0.602,0.73,10355
pickle,-0.301,6,135,1,1,0.593,0.449,0.288,141
envy,-0.302,81,1593,1,1,0.24,0.704,0.427,1674
chord,-0.302,8,174,1,1,0.729,0.394,0.539,182
excluded,-0.302,28,563,1,1,0.061,0.54,0.134,591
unproductive,-0.302,10,213,1,1,0.1,0.324,0.237,223
hulk,-0.303,14,291,1,1,0.46,0.74,0.75,305
brighter,-0.303,39,778,1,1,0.918,0.698,0.833,817
betrayal,-0.304,59,1168,1,1,0.083,0.719,0.418,1227
aging,-0.304,32,642,1,1,0.214,0.255,0.284,674
ago,-0.304,732,14282,1,1,0.317,0.28,0.404,15014
year,-0.305,2503,48822,1,1,0.542,0.284,0.415,51325
robber,-0.305,1,38,1,1,0.135,0.772,0.481,39
frisky,-0.305,1,38,1,1,0.7,0.632,0.525,39
deluxe,-0.305,7,155,1,1,0.792,0.612,0.755,162
playbook,-0.305,1,38,1,1,0.673,0.582,0.5,39
unwittingly,-0.305,1,38,1,1,0.312,0.51,0.264,39
voyeur,-0.305,1,38,1,1,0.479,0.615,0.466,39
skid,-0.305,1,38,1,1,0.357,0.64,0.44,39
prop,-0.305,7,155,1,1,0.51,0.427,0.436,162
gruesome,-0.305,3,77,1,1,0.094,0.837,0.474,80
tumor,-0.305,3,77,1,1,0.102,0.664,0.324,80
cesspool,-0.305,3,77,1,1,0.167,0.46,0.409,80
plume,-0.305,3,77,1,1,0.469,0.323,0.375,80
sundae,-0.305,1,38,1,1,0.743,0.414,0.404,39
showbiz,-0.305,1,38,1,1,0.661,0.713,0.598,39
dreamer,-0.305,19,389,1,1,0.82,0.394,0.455,408
enthusiastic,-0.305,7,155,1,1,0.885,0.868,0.848,162
bystander,-0.305,1,38,1,1,0.48,0.462,0.491,39
gargoyle,-0.305,1,38,1,1,0.286,0.536,0.525,39
lynx,-0.305,1,38,1,1,0.51,0.59,0.567,39
offices,-0.305,15,311,1,1,0.469,0.312,0.534,326
broom,-0.305,3,77,1,1,0.385,0.154,0.302,80
drink,-0.305,468,9145,1,1,0.65,0.552,0.474,9613
apple,-0.305,58,1150,1,1,0.811,0.3,0.264,1208
record,-0.305,109,2145,1,1,0.552,0.421,0.5,2254
helplessness,-0.306,24,487,1,1,0.087,0.48,0.25,511
miserably,-0.306,16,331,1,1,0.28,0.545,0.15,347
astronaut,-0.306,16,331,1,1,0.792,0.601,0.761,347
grandchildren,-0.306,16,331,1,1,0.796,0.545,0.426,347
picky,-0.306,46,917,1,1,0.257,0.729,0.598,963
attached,-0.307,105,2070,1,1,0.562,0.35,0.439,2175
doubting,-0.307,10,214,1,1,0.224,0.56,0.189,224
thought,-0.307,1866,36496,1,1,0.78,0.315,0.571,38362
shiny,-0.307,19,390,1,1,0.885,0.604,0.787,409
showing,-0.307,189,3714,1,1,0.622,0.54,0.491,3903
actual,-0.307,216,4242,1,1,0.729,0.4,0.716,4458
bloody,-0.307,73,1446,1,1,0.031,0.91,0.518,1519
maroon,-0.307,8,175,1,1,0.469,0.358,0.336,183
casino,-0.307,8,175,1,1,0.542,0.684,0.568,183
solve,-0.308,92,1818,1,1,0.656,0.53,0.688,1910
folder,-0.308,6,136,1,1,0.49,0.279,0.375,142
peach,-0.308,20,410,1,1,0.704,0.48,0.272,430
financial,-0.308,60,1193,1,1,0.667,0.5,0.722,1253
shooting,-0.309,56,1115,1,1,0.276,0.931,0.602,1171
soup,-0.309,33,665,1,1,0.602,0.245,0.269,698
affectionate,-0.309,21,430,1,1,0.949,0.422,0.55,451
brutal,-0.309,48,959,1,1,0.122,0.882,0.643,1007
daft,-0.31,9,195,1,1,0.255,0.436,0.157,204
purr,-0.31,4,97,1,1,0.604,0.46,0.302,101
twisted,-0.31,55,1097,1,1,0.071,0.736,0.311,1152
system,-0.31,203,4000,1,1,0.615,0.346,0.764,4203
buffalo,-0.311,12,254,1,1,0.469,0.528,0.527,266
pants,-0.311,67,1333,1,1,0.673,0.32,0.333,1400
zombie,-0.311,20,411,1,1,0.214,0.648,0.415,431
void,-0.311,327,6435,1,1,0.135,0.163,0.13,6762
sleeve,-0.311,15,313,1,1,0.531,0.27,0.273,328
snakes,-0.312,32,647,1,1,0.176,0.662,0.606,679
slack,-0.312,10,215,1,1,0.521,0.283,0.446,225
joined,-0.312,104,2061,1,1,0.667,0.394,0.6,2165
corner,-0.312,309,6087,1,1,0.4,0.296,0.366,6396
hood,-0.312,33,667,1,1,0.357,0.459,0.306,700
understandable,-0.312,22,451,1,1,0.776,0.363,0.566,473
argument,-0.313,54,1080,1,1,0.51,0.464,0.698,1134
cashmere,-0.313,2,58,1,1,0.653,0.452,0.439,60
brothel,-0.313,2,58,1,1,0.255,0.886,0.418,60
debit,-0.313,2,58,1,1,0.333,0.4,0.474,60
unprepared,-0.313,2,58,1,1,0.204,0.45,0.152,60
explosions,-0.313,2,58,1,1,0.123,0.86,0.594,60
predicting,-0.313,2,58,1,1,0.463,0.647,0.679,60
smudge,-0.313,2,58,1,1,0.327,0.429,0.245,60
sneezing,-0.313,2,58,1,1,0.434,0.57,0.345,60
teal,-0.313,2,58,1,1,0.54,0.293,0.321,60
addict,-0.313,26,530,1,1,0.075,0.696,0.327,556
peice,-0.313,2,58,1,1,0.479,0.422,0.398,60
yam,-0.313,2,58,1,1,0.5,0.206,0.152,60
disappointment,-0.314,77,1534,1,1,0.115,0.49,0.336,1611
unsure,-0.314,34,688,1,1,0.143,0.58,0.217,722
legend,-0.314,51,1023,1,1,0.837,0.519,0.75,1074
rhetoric,-0.314,12,255,1,1,0.417,0.429,0.504,267
kiddo,-0.314,12,255,1,1,0.674,0.393,0.419,267
romantic,-0.315,247,4884,1,1,0.936,0.531,0.598,5131
tuck,-0.315,9,196,1,1,0.367,0.473,0.361,205
wing,-0.315,43,866,1,1,0.562,0.255,0.389,909
role,-0.315,139,2758,1,1,0.552,0.26,0.464,2897
introduce,-0.315,37,748,1,1,0.592,0.559,0.648,785
son,-0.316,374,7396,1,1,0.792,0.365,0.528,7770
hanging,-0.317,265,5249,1,1,0.378,0.471,0.389,5514
department,-0.317,26,532,1,1,0.708,0.358,0.642,558
chrome,-0.317,3,78,1,1,0.582,0.373,0.421,81
vacuous,-0.317,3,78,1,1,0.354,0.267,0.304,81
parlor,-0.317,3,78,1,1,0.5,0.327,0.366,81
stays,-0.318,104,2073,1,1,0.633,0.363,0.564,2177
dark,-0.318,1390,27481,1,1,0.198,0.398,0.426,28871
severe,-0.318,53,1066,1,1,0.164,0.735,0.635,1119
crap,-0.318,118,2351,1,1,0.083,0.644,0.167,2469
counter,-0.319,30,612,1,1,0.439,0.478,0.75,642
newborn,-0.319,8,177,1,1,0.918,0.58,0.372,185
terminal,-0.319,13,276,1,1,0.316,0.434,0.483,289
dub,-0.319,13,276,1,1,0.51,0.48,0.387,289
lie,-0.32,513,10175,1,1,0.13,0.725,0.272,10688
digs,-0.32,4,98,1,1,0.448,0.67,0.635,102
misread,-0.32,4,98,1,1,0.115,0.558,0.315,102
peer,-0.32,29,593,1,1,0.458,0.321,0.569,622
pawn,-0.32,4,98,1,1,0.39,0.321,0.187,102
verify,-0.32,4,98,1,1,0.761,0.481,0.704,102
saving,-0.32,106,2118,1,1,0.663,0.23,0.621,2224
load,-0.321,42,851,1,1,0.385,0.417,0.528,893
santa,-0.321,49,990,1,1,0.735,0.286,0.509,1039
regretting,-0.321,16,336,1,1,0.255,0.567,0.273,352
sterling,-0.322,5,118,1,1,0.529,0.481,0.615,123
lemon,-0.322,17,356,1,1,0.596,0.317,0.316,373
dress,-0.322,77,1546,1,1,0.76,0.3,0.345,1623
info,-0.322,59,1190,1,1,0.75,0.33,0.642,1249
congratulate,-0.323,6,138,1,1,0.927,0.724,0.784,144
crusade,-0.323,6,138,1,1,0.592,0.72,0.709,144
alpha,-0.323,28,575,1,1,0.708,0.34,0.755,603
realize,-0.323,1012,20123,1,1,0.757,0.462,0.647,21135
administration,-0.323,14,297,1,1,0.625,0.404,0.786,311
discouraging,-0.324,7,158,1,1,0.167,0.469,0.281,165
pumpkin,-0.324,24,496,1,1,0.539,0.177,0.355,520
attack,-0.324,149,2982,1,1,0.286,0.948,0.67,3131
response,-0.325,125,2506,1,1,0.615,0.5,0.472,2631
distressed,-0.325,10,218,1,1,0.143,0.771,0.324,228
ocd,-0.326,11,238,1,1,0.333,0.472,0.37,249
obvious,-0.326,101,2031,1,1,0.625,0.336,0.585,2132
nail,-0.326,25,517,1,1,0.469,0.397,0.282,542
empathize,-0.326,13,278,1,1,0.802,0.591,0.66,291
honesty,-0.326,112,2251,1,1,0.938,0.411,0.728,2363
choir,-0.327,14,298,1,1,0.704,0.298,0.473,312
vote,-0.327,129,2591,1,1,0.582,0.5,0.649,2720
stranger,-0.327,197,3948,1,1,0.33,0.449,0.302,4145
staff,-0.327,78,1575,1,1,0.745,0.274,0.627,1653
picked,-0.327,99,1994,1,1,0.74,0.518,0.67,2093
mid,-0.328,43,877,1,1,0.5,0.315,0.356,920
caption,-0.328,22,458,1,1,0.814,0.292,0.379,480
bull,-0.329,36,738,1,1,0.521,0.64,0.644,774
bleeding,-0.329,39,798,1,1,0.135,0.817,0.408,837
party,-0.329,533,10670,1,1,0.948,0.84,0.547,11203
mine,-0.329,770,15409,1,1,0.688,0.418,0.578,16179
leaky,-0.33,1,39,1,1,0.17,0.686,0.288,40
burr,-0.33,1,39,1,1,0.39,0.426,0.308,40
antichrist,-0.33,1,39,1,1,0.082,0.837,0.544,40
abduct,-0.33,1,39,1,1,0.173,0.72,0.615,40
superstition,-0.33,2,59,1,1,0.177,0.64,0.418,61
lightbulb,-0.33,1,39,1,1,0.573,0.255,0.302,40
honorary,-0.33,1,39,1,1,0.885,0.565,0.811,40
tape,-0.33,27,559,1,1,0.531,0.277,0.254,586
obedient,-0.33,3,79,1,1,0.8,0.179,0.518,82
mashed,-0.33,3,79,1,1,0.531,0.337,0.194,82
endearing,-0.33,6,139,1,1,0.663,0.434,0.604,145
scold,-0.33,2,59,1,1,0.194,0.755,0.626,61
corduroy,-0.33,1,39,1,1,0.57,0.324,0.357,40
dodge,-0.33,6,139,1,1,0.333,0.76,0.509,145
snoop,-0.33,3,79,1,1,0.134,0.74,0.434,82
yaaaay,-0.33,1,39,1,1,0.625,0.677,0.326,40
stead,-0.33,2,59,1,1,0.551,0.214,0.51,61
coiled,-0.33,1,39,1,1,0.378,0.518,0.389,40
spotty,-0.33,1,39,1,1,0.281,0.606,0.241,40
contaminate,-0.33,1,39,1,1,0.14,0.611,0.426,40
collide,-0.33,7,159,1,1,0.271,0.892,0.557,166
orbiting,-0.33,2,59,1,1,0.52,0.643,0.554,61
toga,-0.33,2,59,1,1,0.698,0.393,0.373,61
degradation,-0.33,3,79,1,1,0.16,0.608,0.315,82
prestige,-0.33,2,59,1,1,0.918,0.594,0.907,61
cartel,-0.33,1,39,1,1,0.438,0.394,0.602,40
latch,-0.33,7,159,1,1,0.395,0.263,0.288,166
dead,-0.332,638,12801,1,1,0.052,0.454,0.194,13439
belong,-0.332,233,4689,1,1,0.643,0.405,0.569,4922
sauce,-0.333,18,380,1,1,0.562,0.515,0.288,398
jaded,-0.333,15,320,1,1,0.255,0.56,0.4,335
admitted,-0.333,30,621,1,1,0.72,0.49,0.767,651
makeup,-0.333,44,902,1,1,0.74,0.333,0.331,946
ridiculous,-0.333,71,1444,1,1,0.159,0.594,0.245,1515
cheeks,-0.334,45,923,1,1,0.708,0.324,0.282,968
bomb,-0.334,44,903,1,1,0.167,0.912,0.75,947
choke,-0.335,20,421,1,1,0.167,0.788,0.676,441
gut,-0.335,29,602,1,1,0.408,0.367,0.364,631
yesss,-0.335,18,381,1,1,0.719,0.657,0.451,399
overbearing,-0.335,8,180,1,1,0.323,0.833,0.861,188
misfit,-0.335,8,180,1,1,0.173,0.5,0.393,188
nutshell,-0.335,8,180,1,1,0.458,0.407,0.31,188
stressful,-0.337,97,1972,1,1,0.153,0.873,0.389,2069
omega,-0.337,14,301,1,1,0.529,0.337,0.526,315
cruise,-0.337,21,442,1,1,0.74,0.442,0.683,463
baseball,-0.337,35,724,1,1,0.66,0.76,0.563,759
caution,-0.337,6,140,1,1,0.552,0.712,0.547,146
friday,-0.337,336,6788,1,1,0.624,0.411,0.341,7124
chip,-0.337,19,402,1,1,0.479,0.382,0.452,421
princess,-0.338,92,1874,1,1,0.885,0.557,0.62,1966
stick,-0.338,176,3568,1,1,0.396,0.364,0.382,3744
refund,-0.338,5,120,1,1,0.541,0.528,0.43,125
start,-0.339,1366,27590,1,1,0.684,0.43,0.589,28956
reaction,-0.339,63,1291,1,1,0.47,0.811,0.706,1354
liberalism,-0.34,4,100,1,1,0.562,0.712,0.75,104
stinking,-0.34,4,100,1,1,0.041,0.657,0.264,104
terrifies,-0.34,4,100,1,1,0.083,0.923,0.5,104
confidential,-0.34,4,100,1,1,0.643,0.471,0.761,104
loveliness,-0.34,4,100,1,1,0.959,0.509,0.75,104
late,-0.34,644,13031,1,1,0.245,0.358,0.315,13675
rice,-0.34,28,585,1,1,0.667,0.208,0.33,613
rose,-0.34,127,2586,1,1,0.865,0.276,0.386,2713
pained,-0.341,13,282,1,1,0.112,0.5,0.25,295
expensive,-0.341,72,1475,1,1,0.323,0.54,0.53,1547
end,-0.341,2095,42382,1,1,0.198,0.349,0.298,44477
mil,-0.341,8,181,1,1,0.534,0.388,0.347,189
site,-0.341,90,1840,1,1,0.677,0.265,0.452,1930
sunflower,-0.341,12,262,1,1,0.878,0.231,0.27,274
sticking,-0.342,29,606,1,1,0.486,0.425,0.356,635
deactivate,-0.342,16,343,1,1,0.235,0.447,0.392,359
suspended,-0.342,20,424,1,1,0.224,0.402,0.368,444
barely,-0.342,196,3987,1,1,0.448,0.183,0.268,4183
right,-0.342,3853,78031,1,1,0.74,0.352,0.71,81884
full,-0.342,1273,25794,1,1,0.602,0.255,0.704,27067
irritability,-0.342,3,80,1,1,0.146,0.853,0.283,83
spirited,-0.342,7,161,1,1,0.854,0.587,0.734,168
hormone,-0.342,3,80,1,1,0.49,0.75,0.621,83
wasp,-0.342,3,80,1,1,0.39,0.62,0.406,83
bluff,-0.342,3,80,1,1,0.418,0.286,0.377,83
trigger,-0.342,47,971,1,1,0.271,0.804,0.66,1018
staring,-0.343,154,3139,1,1,0.542,0.306,0.423,3293
tasting,-0.343,22,465,1,1,0.781,0.603,0.6,487
media,-0.343,682,13840,1,1,0.5,0.33,0.464,14522
fighter,-0.343,29,607,1,1,0.637,0.76,0.898,636
capitalist,-0.344,10,222,1,1,0.352,0.577,0.821,232
haunted,-0.344,61,1256,1,1,0.264,0.731,0.52,1317
superior,-0.344,39,810,1,1,0.801,0.697,0.94,849
insidious,-0.344,6,141,1,1,0.146,0.622,0.48,147
vengeful,-0.344,6,141,1,1,0.15,0.84,0.561,147
fleet,-0.344,6,141,1,1,0.547,0.43,0.623,147
encouragement,-0.345,33,689,1,1,0.865,0.7,0.759,722
check,-0.345,424,8624,1,1,0.523,0.552,0.602,9048
tribute,-0.345,29,608,1,1,0.684,0.573,0.7,637
movies,-0.345,382,7775,1,1,0.724,0.426,0.472,8157
bloke,-0.345,15,324,1,1,0.45,0.479,0.545,339
willing,-0.346,224,4571,1,1,0.833,0.561,0.783,4795
drifted,-0.346,11,243,1,1,0.312,0.542,0.31,254
discounted,-0.346,2,60,1,1,0.677,0.471,0.43,62
debilitating,-0.346,20,426,1,1,0.125,0.49,0.308,446
apricot,-0.346,2,60,1,1,0.708,0.32,0.278,62
banking,-0.346,2,60,1,1,0.51,0.327,0.5,62
eighth,-0.346,5,121,1,1,0.531,0.226,0.38,126
aft,-0.346,2,60,1,1,0.48,0.417,0.518,62
register,-0.346,11,243,1,1,0.49,0.412,0.654,254
gigantic,-0.346,5,121,1,1,0.75,0.776,0.921,126
predictive,-0.346,2,60,1,1,0.479,0.454,0.736,62
revolving,-0.346,8,182,1,1,0.602,0.57,0.58,190
abandon,-0.347,77,1586,1,1,0.052,0.519,0.245,1663
fairy,-0.347,36,752,1,1,0.776,0.408,0.413,788
cult,-0.348,44,915,1,1,0.448,0.535,0.648,959
secretary,-0.348,10,223,1,1,0.612,0.426,0.561,233
insensitive,-0.348,10,223,1,1,0.219,0.471,0.302,233
panicked,-0.349,7,162,1,1,0.1,0.949,0.26,169
thanks,-0.349,1091,22257,1,1,0.918,0.472,0.461,23348
proof,-0.349,60,1243,1,1,0.438,0.509,0.619,1303
network,-0.35,72,1488,1,1,0.531,0.337,0.466,1560
drinks,-0.35,84,1733,1,1,0.729,0.656,0.412,1817
descriptive,-0.35,4,101,1,1,0.667,0.352,0.57,105
infuriating,-0.35,4,101,1,1,0.139,0.87,0.509,105
condom,-0.35,4,101,1,1,0.406,0.637,0.5,105
crazy,-0.35,756,15453,1,1,0.156,0.843,0.321,16209
sweater,-0.351,18,387,1,1,0.704,0.245,0.295,405
unpaid,-0.351,6,142,1,1,0.3,0.413,0.365,148
drinking,-0.352,305,6253,1,1,0.562,0.459,0.317,6558
pit,-0.352,72,1491,1,1,0.408,0.396,0.278,1563
sob,-0.352,33,694,1,1,0.115,0.48,0.212,727
station,-0.352,80,1655,1,1,0.688,0.367,0.519,1735
grandmother,-0.352,26,551,1,1,0.792,0.283,0.426,577
ideology,-0.352,19,408,1,1,0.573,0.344,0.692,427
presidential,-0.352,10,224,1,1,0.612,0.656,0.972,234
clinic,-0.352,10,224,1,1,0.469,0.439,0.6,234
polish,-0.352,10,224,1,1,0.604,0.412,0.533,234
vocal,-0.353,36,756,1,1,0.583,0.352,0.34,792
carter,-0.353,12,265,1,1,0.312,0.48,0.431,277
suspicious,-0.353,12,265,1,1,0.153,0.745,0.431,277
luck,-0.354,209,4301,1,1,0.854,0.49,0.717,4510
like,-0.354,18895,387280,1,1,0.719,0.353,0.446,406175
pauper,-0.355,1,40,1,1,0.26,0.347,0.151,41
whammy,-0.355,1,40,1,1,0.461,0.491,0.345,41
disarm,-0.355,1,40,1,1,0.292,0.528,0.613,41
whoo,-0.355,3,81,1,1,0.531,0.578,0.311,84
discount,-0.355,11,245,1,1,0.724,0.53,0.302,256
snipe,-0.355,1,40,1,1,0.198,0.915,0.491,41
cooker,-0.355,1,40,1,1,0.592,0.373,0.407,41
fundraiser,-0.355,1,40,1,1,0.61,0.577,0.667,41
operative,-0.355,1,40,1,1,0.541,0.635,0.718,41
snide,-0.355,1,40,1,1,0.186,0.723,0.455,41
overjoyed,-0.355,3,81,1,1,0.908,0.708,0.755,84
ploughed,-0.355,1,40,1,1,0.438,0.42,0.431,41
rotary,-0.355,1,40,1,1,0.573,0.462,0.528,41
usual,-0.355,180,3710,1,1,0.625,0.221,0.4,3890
anonymous,-0.355,32,676,1,1,0.396,0.291,0.431,708
cap,-0.356,52,1087,1,1,0.612,0.24,0.375,1139
commercial,-0.357,19,410,1,1,0.806,0.49,0.528,429
hair,-0.358,264,5448,1,1,0.582,0.186,0.286,5712
trio,-0.358,13,287,1,1,0.521,0.613,0.473,300
do,-0.359,11271,231971,1,1,0.67,0.548,0.536,243242
watermelon,-0.36,4,102,1,1,0.714,0.23,0.239,106
unholy,-0.36,9,205,1,1,0.327,0.56,0.445,214
glamour,-0.36,9,205,1,1,0.823,0.606,0.623,214
cookies,-0.36,39,823,1,1,0.823,0.451,0.316,862
hat,-0.36,52,1091,1,1,0.604,0.183,0.353,1143
accidentally,-0.36,54,1133,1,1,0.333,0.741,0.333,1187
erase,-0.361,26,556,1,1,0.24,0.26,0.321,582
interact,-0.361,213,4414,1,1,0.822,0.69,0.759,4627
sap,-0.361,10,226,1,1,0.47,0.298,0.258,236
friendly,-0.361,173,3590,1,1,0.917,0.398,0.598,3763
loved,-0.362,1181,24403,1,1,0.927,0.452,0.582,25584
rid,-0.362,121,2518,1,1,0.194,0.408,0.327,2639
debate,-0.362,48,1011,1,1,0.408,0.691,0.683,1059
deserved,-0.362,77,1610,1,1,0.781,0.582,0.689,1687
interstate,-0.363,2,61,1,1,0.52,0.443,0.6,63
diploma,-0.363,2,61,1,1,0.75,0.462,0.731,63
unheard,-0.363,14,309,1,1,0.344,0.539,0.5,323
obsessed,-0.363,105,2190,1,1,0.219,0.84,0.439,2295
throat,-0.364,56,1178,1,1,0.35,0.538,0.346,1234
acknowledged,-0.364,15,330,1,1,0.714,0.443,0.765,345
yelling,-0.364,36,765,1,1,0.323,0.939,0.565,801
aids,-0.365,16,351,1,1,0.561,0.48,0.5,367
pirate,-0.365,13,289,1,1,0.156,0.74,0.559,302
sarcastic,-0.366,21,455,1,1,0.397,0.781,0.298,476
advice,-0.366,250,5205,1,1,0.698,0.408,0.688,5455
tax,-0.367,39,829,1,1,0.26,0.481,0.534,868
puke,-0.367,7,165,1,1,0.204,0.545,0.292,172
paranormal,-0.367,3,82,1,1,0.167,0.814,0.56,85
mend,-0.368,26,560,1,1,0.542,0.436,0.602,586
angst,-0.369,32,685,1,1,0.167,0.888,0.333,717
apparently,-0.369,203,4241,1,1,0.531,0.41,0.426,4444
menopause,-0.369,4,103,1,1,0.204,0.46,0.306,107
grilled,-0.369,4,103,1,1,0.702,0.5,0.373,107
psychotic,-0.369,14,311,1,1,0.198,0.856,0.474,325
frail,-0.369,9,207,1,1,0.255,0.333,0.069,216
unclean,-0.369,4,103,1,1,0.133,0.529,0.134,107
explicit,-0.371,5,124,1,1,0.562,0.694,0.734,129
undercover,-0.371,5,124,1,1,0.388,0.627,0.483,129
reason,-0.371,1213,25292,1,1,0.781,0.455,0.712,26505
messenger,-0.371,25,541,1,1,0.694,0.434,0.5,566
pyramid,-0.372,6,145,1,1,0.74,0.39,0.635,151
burn,-0.372,144,3024,1,1,0.219,0.783,0.509,3168
unemployment,-0.372,14,312,1,1,0.094,0.4,0.297,326
pizza,-0.372,127,2670,1,1,0.847,0.39,0.295,2797
deliver,-0.373,44,939,1,1,0.583,0.37,0.582,983
meth,-0.373,8,187,1,1,0.354,0.564,0.34,195
shy,-0.374,170,3572,1,1,0.28,0.153,0.132,3742
rubbish,-0.374,19,417,1,1,0.198,0.454,0.164,436
brown,-0.374,85,1797,1,1,0.396,0.202,0.293,1882
disconnected,-0.374,66,1400,1,1,0.292,0.276,0.173,1466
coo,-0.375,22,480,1,1,0.49,0.439,0.5,502
coaster,-0.375,11,250,1,1,0.612,0.788,0.627,261
straight,-0.375,323,6777,1,1,0.667,0.298,0.669,7100
bedtime,-0.376,15,334,1,1,0.673,0.314,0.373,349
committed,-0.376,89,1884,1,1,0.71,0.542,0.712,1973
playground,-0.376,19,418,1,1,0.888,0.62,0.435,437
anthem,-0.377,42,900,1,1,0.78,0.343,0.729,942
sweetest,-0.377,44,942,1,1,0.959,0.5,0.37,986
typical,-0.377,50,1068,1,1,0.635,0.206,0.426,1118
president,-0.378,178,3754,1,1,0.677,0.622,0.973,3932
dancing,-0.378,164,3462,1,1,0.885,0.868,0.444,3626
hoy,-0.379,8,188,1,1,0.583,0.298,0.471,196
exclamation,-0.379,1,41,1,1,0.612,0.745,0.598,42
loaf,-0.379,4,104,1,1,0.755,0.25,0.277,108
cabal,-0.379,1,41,1,1,0.5,0.406,0.573,42
ruse,-0.379,1,41,1,1,0.531,0.64,0.546,42
villager,-0.379,1,41,1,1,0.71,0.387,0.509,42
outreach,-0.379,3,83,1,1,0.54,0.462,0.672,86
shopper,-0.379,1,41,1,1,0.646,0.615,0.741,42
beater,-0.379,1,41,1,1,0.438,0.545,0.482,42
bearded,-0.379,4,104,1,1,0.439,0.337,0.391,108
assault,-0.379,21,461,1,1,0.167,0.848,0.55,482
ope,-0.379,1,41,1,1,0.375,0.38,0.395,42
cherry,-0.379,31,671,1,1,0.688,0.186,0.25,702
ratio,-0.379,10,230,1,1,0.56,0.461,0.741,240
usher,-0.379,5,125,1,1,0.521,0.44,0.519,130
euthanasia,-0.379,1,41,1,1,0.229,0.716,0.325,42
rosy,-0.379,7,167,1,1,0.94,0.528,0.755,174
consult,-0.379,4,104,1,1,0.755,0.37,0.441,108
jeopardy,-0.379,3,83,1,1,0.129,0.908,0.536,86
uninteresting,-0.379,5,125,1,1,0.153,0.235,0.228,130
greyhound,-0.379,2,62,1,1,0.52,0.49,0.44,64
tomorrow,-0.379,680,14310,1,1,0.792,0.377,0.407,14990
failing,-0.38,51,1092,1,1,0.125,0.49,0.268,1143
section,-0.38,59,1261,1,1,0.5,0.269,0.421,1320
hint,-0.381,44,946,1,1,0.602,0.33,0.517,990
popcorn,-0.381,18,399,1,1,0.875,0.441,0.231,417
employee,-0.382,14,315,1,1,0.582,0.361,0.481,329
captive,-0.382,13,294,1,1,0.235,0.558,0.411,307
boston,-0.383,23,505,1,1,0.643,0.38,0.58,528
dear,-0.383,495,10463,1,1,0.88,0.434,0.629,10958
distract,-0.384,95,2025,1,1,0.241,0.609,0.336,2120
parental,-0.384,8,189,1,1,0.76,0.43,0.627,197
sponsor,-0.385,7,168,1,1,0.729,0.537,0.8,175
inside,-0.385,1054,22295,1,1,0.612,0.404,0.472,23349
runaway,-0.386,13,295,1,1,0.271,0.77,0.402,308
award,-0.386,33,718,1,1,0.865,0.745,0.66,751
stigma,-0.386,39,845,1,1,0.327,0.5,0.47,884
fridge,-0.386,31,676,1,1,0.571,0.292,0.402,707
sentient,-0.387,10,232,1,1,0.583,0.417,0.363,242
team,-0.387,350,7434,1,1,0.708,0.461,0.688,7784
stuff,-0.388,686,14554,1,1,0.622,0.367,0.263,15240
bank,-0.388,75,1610,1,1,0.562,0.327,0.675,1685
edible,-0.388,4,105,1,1,0.75,0.425,0.497,109
sow,-0.389,8,190,1,1,0.667,0.43,0.446,198
curve,-0.39,34,742,1,1,0.48,0.375,0.307,776
exam,-0.39,34,742,1,1,0.479,0.663,0.577,776
throw,-0.39,185,3949,1,1,0.344,0.77,0.623,4134
waste,-0.39,190,4056,1,1,0.041,0.51,0.184,4246
jimmy,-0.39,28,615,1,1,0.579,0.321,0.311,643
compensation,-0.391,3,84,1,1,0.775,0.469,0.598,87
fireworks,-0.391,23,509,1,1,0.735,0.863,0.579,532
beak,-0.391,3,84,1,1,0.375,0.363,0.411,87
topless,-0.391,3,84,1,1,0.625,0.765,0.414,87
palpable,-0.391,11,254,1,1,0.552,0.343,0.611,265
ball,-0.391,107,2295,1,1,0.74,0.427,0.317,2402
bone,-0.392,58,1255,1,1,0.337,0.37,0.413,1313
humor,-0.392,61,1319,1,1,0.89,0.633,0.462,1380
dock,-0.393,9,212,1,1,0.49,0.409,0.481,221
idiots,-0.393,52,1128,1,1,0.143,0.6,0.144,1180
government,-0.393,105,2258,1,1,0.427,0.53,0.85,2363
nose,-0.394,53,1150,1,1,0.582,0.27,0.245,1203
bride,-0.394,18,404,1,1,0.84,0.708,0.579,422
partner,-0.394,386,8250,1,1,0.673,0.302,0.586,8636
discuss,-0.394,63,1364,1,1,0.396,0.769,0.509,1427
untouchable,-0.394,5,127,1,1,0.49,0.602,0.683,132
scarcity,-0.394,2,63,1,1,0.167,0.5,0.182,65
comb,-0.394,2,63,1,1,0.49,0.123,0.268,65
ask,-0.395,960,20514,1,1,0.531,0.44,0.459,21474
iconic,-0.395,33,725,1,1,0.583,0.537,0.7,758
bummed,-0.395,16,362,1,1,0.296,0.43,0.227,378
leaving,-0.396,547,11702,1,1,0.163,0.542,0.371,12249
boot,-0.396,18,405,1,1,0.438,0.65,0.625,423
typo,-0.396,7,170,1,1,0.224,0.415,0.255,177
depressive,-0.396,39,854,1,1,0.143,0.434,0.202,893
puddle,-0.396,7,170,1,1,0.396,0.302,0.298,177
imagining,-0.396,31,683,1,1,0.765,0.458,0.545,714
younger,-0.396,140,3013,1,1,0.781,0.457,0.558,3153
roommate,-0.397,120,2586,1,1,0.75,0.481,0.48,2706
decline,-0.397,20,448,1,1,0.173,0.491,0.24,468
try,-0.397,1719,36783,1,1,0.604,0.551,0.556,38502
trapping,-0.398,4,106,1,1,0.333,0.621,0.491,110
filler,-0.398,4,106,1,1,0.531,0.347,0.529,110
filling,-0.398,69,1497,1,1,0.51,0.382,0.525,1566
jack,-0.398,118,2546,1,1,0.487,0.45,0.441,2664
coach,-0.399,37,813,1,1,0.633,0.823,0.735,850
ghoul,-0.399,6,149,1,1,0.26,0.561,0.43,155
stoop,-0.399,6,149,1,1,0.49,0.43,0.284,155
quirky,-0.399,15,342,1,1,0.708,0.373,0.564,357
cake,-0.4,83,1800,1,1,0.81,0.375,0.287,1883
bowling,-0.4,10,235,1,1,0.656,0.431,0.309,245
beef,-0.4,23,514,1,1,0.582,0.312,0.492,537
propaganda,-0.4,23,514,1,1,0.521,0.651,0.618,537
want,-0.4,8515,182748,1,1,0.671,0.642,0.598,191263
international,-0.401,46,1008,1,1,0.8,0.519,0.702,1054
forgotten,-0.401,221,4765,1,1,0.235,0.28,0.184,4986
cheerful,-0.401,31,686,1,1,0.99,0.72,0.696,717
rocket,-0.401,31,686,1,1,0.664,0.824,0.774,717
silly,-0.401,96,2082,1,1,0.384,0.349,0.161,2178
manager,-0.402,38,837,1,1,0.625,0.549,0.897,875
constituency,-0.402,1,42,1,1,0.5,0.48,0.696,43
bugger,-0.402,5,128,1,1,0.312,0.627,0.474,133
arsehole,-0.402,5,128,1,1,0.276,0.598,0.433,133
downpour,-0.402,13,300,1,1,0.328,0.602,0.481,313
mime,-0.402,1,42,1,1,0.455,0.235,0.302,43
commentator,-0.402,1,42,1,1,0.492,0.51,0.607,43
tweak,-0.402,1,42,1,1,0.44,0.462,0.452,43
prude,-0.402,1,42,1,1,0.327,0.41,0.333,43
penetration,-0.402,3,85,1,1,0.438,0.885,0.792,88
ladybug,-0.402,1,42,1,1,0.602,0.4,0.224,43
animate,-0.402,1,42,1,1,0.827,0.755,0.635,43
fringe,-0.402,7,171,1,1,0.52,0.387,0.323,178
tapeworm,-0.402,1,42,1,1,0.357,0.334,0.331,43
slag,-0.402,3,85,1,1,0.266,0.6,0.254,88
turbo,-0.402,1,42,1,1,0.583,0.729,0.596,43
nuke,-0.402,1,42,1,1,0.125,0.905,0.873,43
leash,-0.402,5,128,1,1,0.32,0.347,0.427,133
womanizer,-0.402,1,42,1,1,0.281,0.8,0.471,43
desperado,-0.402,1,42,1,1,0.26,0.745,0.361,43
gunner,-0.402,1,42,1,1,0.25,0.853,0.817,43
evergreen,-0.402,5,128,1,1,0.729,0.471,0.546,133
quitter,-0.402,1,42,1,1,0.26,0.46,0.321,43
crane,-0.402,5,128,1,1,0.396,0.417,0.589,133
missy,-0.402,3,85,1,1,0.521,0.48,0.333,88
grits,-0.402,1,42,1,1,0.458,0.333,0.346,43
percent,-0.403,24,537,1,1,0.47,0.35,0.356,561
tab,-0.404,10,236,1,1,0.594,0.208,0.308,246
dizzy,-0.405,8,193,1,1,0.199,0.582,0.193,201
glasses,-0.405,40,883,1,1,0.531,0.21,0.33,923
class,-0.405,306,6620,1,1,0.656,0.314,0.522,6926
parenting,-0.406,20,452,1,1,0.812,0.52,0.676,472
sickening,-0.406,13,301,1,1,0.074,0.618,0.259,314
edit,-0.406,34,754,1,1,0.51,0.41,0.544,788
traumatic,-0.406,16,366,1,1,0.062,0.885,0.427,382
percentage,-0.407,9,215,1,1,0.469,0.4,0.553,224
roster,-0.407,4,107,1,1,0.531,0.306,0.381,111
decreased,-0.407,4,107,1,1,0.224,0.271,0.17,111
warn,-0.407,14,323,1,1,0.429,0.647,0.564,337
funky,-0.407,9,215,1,1,0.531,0.755,0.389,224
despondent,-0.407,4,107,1,1,0.133,0.378,0.221,111
embarrassment,-0.407,22,496,1,1,0.143,0.685,0.226,518
terrible,-0.408,263,5705,1,1,0.061,0.849,0.604,5968
dinner,-0.408,236,5122,1,1,0.823,0.392,0.379,5358
wasting,-0.409,83,1817,1,1,0.051,0.417,0.207,1900
lily,-0.409,22,497,1,1,0.64,0.245,0.263,519
wicked,-0.41,43,952,1,1,0.138,0.8,0.627,995
cable,-0.41,14,324,1,1,0.583,0.245,0.434,338
web,-0.41,38,844,1,1,0.583,0.411,0.519,882
puck,-0.41,2,64,1,1,0.398,0.49,0.349,66
sixteen,-0.41,5,129,1,1,0.583,0.29,0.324,134
flush,-0.41,11,259,1,1,0.408,0.755,0.589,270
bankruptcy,-0.41,2,64,1,1,0.01,0.696,0.209,66
surrogate,-0.41,2,64,1,1,0.406,0.59,0.472,66
janitor,-0.41,2,64,1,1,0.51,0.35,0.527,66
demon,-0.41,78,1711,1,1,0.037,0.908,0.509,1789
interview,-0.41,61,1343,1,1,0.573,0.77,0.619,1404
deserving,-0.411,18,411,1,1,0.802,0.596,0.858,429
trend,-0.411,28,628,1,1,0.625,0.458,0.706,656
email,-0.411,70,1539,1,1,0.698,0.23,0.456,1609
counts,-0.411,22,498,1,1,0.343,0.373,0.5,520
young,-0.411,693,15056,1,1,0.812,0.52,0.537,15749
moderate,-0.412,9,216,1,1,0.582,0.19,0.453,225
drought,-0.412,9,216,1,1,0.133,0.353,0.267,225
clowns,-0.412,16,368,1,1,0.6,0.673,0.391,384
flower,-0.412,141,3082,1,1,0.802,0.189,0.254,3223
rite,-0.413,10,238,1,1,0.378,0.57,0.606,248
teary,-0.413,10,238,1,1,0.167,0.473,0.216,248
player,-0.414,97,2130,1,1,0.557,0.688,0.644,2227
suffocating,-0.414,54,1195,1,1,0.133,0.774,0.429,1249
honk,-0.414,3,86,1,1,0.549,0.635,0.415,89
playa,-0.414,11,260,1,1,0.724,0.51,0.575,271
spaghetti,-0.414,11,260,1,1,0.729,0.353,0.288,271
badge,-0.414,7,173,1,1,0.567,0.488,0.691,180
weird,-0.414,756,16464,1,1,0.26,0.66,0.402,17220
grieving,-0.414,36,804,1,1,0.093,0.673,0.403,840
sticky,-0.415,12,282,1,1,0.385,0.569,0.292,294
heart,-0.415,3281,71466,1,1,0.827,0.5,0.693,74747
ship,-0.415,119,2613,1,1,0.646,0.5,0.439,2732
roast,-0.415,13,304,1,1,0.521,0.541,0.311,317
existential,-0.416,73,1612,1,1,0.583,0.51,0.638,1685
textbook,-0.416,4,108,1,1,0.622,0.235,0.526,112
hospice,-0.416,4,108,1,1,0.337,0.443,0.535,112
contest,-0.417,15,348,1,1,0.667,0.698,0.717,363
abuse,-0.417,132,2901,1,1,0.071,0.873,0.469,3033
hip,-0.417,27,610,1,1,0.448,0.415,0.345,637
phone,-0.417,768,16780,1,1,0.729,0.344,0.418,17548
soldier,-0.417,61,1352,1,1,0.392,0.708,0.768,1413
tiny,-0.417,163,3578,1,1,0.479,0.196,0.125,3741
coincidence,-0.417,16,370,1,1,0.612,0.45,0.518,386
enterprise,-0.418,5,130,1,1,0.76,0.392,0.754,135
kill,-0.418,485,10616,1,1,0.052,0.941,0.736,11101
squirrel,-0.418,12,283,1,1,0.592,0.358,0.333,295
purse,-0.419,6,152,1,1,0.656,0.176,0.306,158
twinkle,-0.42,7,174,1,1,0.719,0.724,0.61,181
gun,-0.42,64,1422,1,1,0.147,0.92,0.713,1486
terrorist,-0.42,18,415,1,1,0.019,0.93,0.679,433
believe,-0.421,1120,24546,1,1,0.781,0.37,0.682,25666
pink,-0.421,91,2014,1,1,0.806,0.269,0.471,2105
wet,-0.421,76,1686,1,1,0.385,0.417,0.185,1762
warren,-0.421,10,240,1,1,0.417,0.57,0.464,250
beam,-0.422,13,306,1,1,0.584,0.349,0.382,319
job,-0.422,633,13902,1,1,0.694,0.541,0.717,14535
rescue,-0.422,78,1732,1,1,0.806,0.926,0.85,1810
openly,-0.422,31,701,1,1,0.603,0.388,0.553,732
shutdown,-0.422,15,350,1,1,0.173,0.367,0.418,365
evidence,-0.423,49,1096,1,1,0.5,0.5,0.778,1145
notice,-0.425,208,4596,1,1,0.646,0.408,0.491,4804
understatement,-0.425,13,307,1,1,0.347,0.48,0.473,320
disclaimer,-0.425,5,131,1,1,0.367,0.571,0.542,136
figment,-0.425,4,109,1,1,0.552,0.316,0.533,113
preventative,-0.425,1,43,1,1,0.65,0.442,0.682,44
haggard,-0.425,2,65,1,1,0.115,0.51,0.246,67
niece,-0.425,23,527,1,1,0.771,0.32,0.4,550
probability,-0.425,2,65,1,1,0.673,0.365,0.651,67
pox,-0.425,1,43,1,1,0.235,0.567,0.309,44
grandchild,-0.425,2,65,1,1,0.781,0.433,0.465,67
glimmer,-0.425,9,219,1,1,0.615,0.462,0.427,228
impassioned,-0.425,1,43,1,1,0.74,0.78,0.802,44
dye,-0.425,7,175,1,1,0.479,0.314,0.371,182
warden,-0.425,2,65,1,1,0.615,0.627,0.898,67
hiccup,-0.425,1,43,1,1,0.271,0.549,0.24,44
flatter,-0.425,2,65,1,1,0.521,0.418,0.302,67
lee,-0.425,96,2133,1,1,0.51,0.269,0.296,2229
prevalent,-0.425,8,197,1,1,0.694,0.43,0.669,205
squeak,-0.425,1,43,1,1,0.271,0.679,0.3,44
criticise,-0.425,2,65,1,1,0.073,0.7,0.452,67
childbirth,-0.425,1,43,1,1,0.604,0.861,0.673,44
knickers,-0.425,1,43,1,1,0.552,0.428,0.328,44
hairline,-0.425,2,65,1,1,0.418,0.154,0.23,67
yeahhhh,-0.425,3,87,1,1,0.865,0.721,0.44,90
trolley,-0.425,3,87,1,1,0.562,0.558,0.464,90
impostor,-0.425,1,43,1,1,0.135,0.704,0.442,44
booger,-0.425,1,43,1,1,0.399,0.537,0.427,44
grimy,-0.425,1,43,1,1,0.112,0.597,0.283,44
lessen,-0.425,15,351,1,1,0.235,0.284,0.255,366
transplant,-0.425,2,65,1,1,0.445,0.806,0.62,67
round,-0.426,183,4050,1,1,0.552,0.434,0.311,4233
supporters,-0.426,41,924,1,1,0.763,0.539,0.558,965
combo,-0.426,41,924,1,1,0.698,0.439,0.453,965
come,-0.427,3644,80333,1,1,0.529,0.269,0.558,83977
jay,-0.428,34,771,1,1,0.531,0.408,0.389,805
put,-0.428,1406,31038,1,1,0.52,0.398,0.51,32444
bachelor,-0.428,30,683,1,1,0.667,0.406,0.6,713
cart,-0.429,12,286,1,1,0.52,0.344,0.388,298
kudos,-0.429,12,286,1,1,0.925,0.587,0.642,298
beg,-0.429,68,1523,1,1,0.292,0.608,0.328,1591
movie,-0.43,533,11799,1,1,0.792,0.56,0.471,12332
health,-0.43,589,13042,1,1,0.935,0.427,0.551,13631
stream,-0.431,213,4732,1,1,0.449,0.537,0.559,4945
older,-0.431,425,9422,1,1,0.385,0.255,0.317,9847
creeping,-0.431,44,995,1,1,0.292,0.613,0.282,1039
see,-0.431,4181,92576,1,1,0.635,0.269,0.312,96757
secretly,-0.432,54,1217,1,1,0.525,0.404,0.479,1271
boredom,-0.433,197,4387,1,1,0.167,0.139,0.255,4584
glad,-0.433,556,12344,1,1,0.938,0.76,0.74,12900
mansion,-0.433,59,1329,1,1,0.847,0.49,0.717,1388
disregard,-0.433,17,398,1,1,0.177,0.647,0.308,415
customer,-0.433,27,620,1,1,0.562,0.43,0.673,647
seasonal,-0.434,20,465,1,1,0.592,0.273,0.305,485
shelf,-0.434,35,798,1,1,0.561,0.202,0.366,833
hype,-0.434,50,1131,1,1,0.51,0.5,0.586,1181
bag,-0.434,141,3151,1,1,0.5,0.25,0.314,3292
warms,-0.434,14,332,1,1,0.594,0.58,0.632,346
alleged,-0.434,4,110,1,1,0.365,0.522,0.52,114
spoiler,-0.434,14,332,1,1,0.347,0.527,0.38,346
provoke,-0.434,4,110,1,1,0.3,0.871,0.735,114
amp,-0.434,4,110,1,1,0.439,0.393,0.375,114
paycheck,-0.435,8,199,1,1,0.896,0.63,0.652,207
lovely,-0.435,491,10933,1,1,0.917,0.456,0.741,11424
amber,-0.436,16,377,1,1,0.635,0.308,0.369,393
frightened,-0.436,50,1133,1,1,0.153,0.817,0.255,1183
proud,-0.436,288,6426,1,1,0.906,0.7,0.873,6714
salsa,-0.437,3,88,1,1,0.742,0.5,0.37,91
rack,-0.437,7,177,1,1,0.385,0.373,0.409,184
loop,-0.437,37,845,1,1,0.516,0.343,0.317,882
emergency,-0.438,28,645,1,1,0.2,0.9,0.571,673
disappointed,-0.438,93,2093,1,1,0.071,0.472,0.241,2186
joining,-0.438,63,1425,1,1,0.755,0.469,0.685,1488
rope,-0.438,27,623,1,1,0.385,0.28,0.345,650
stabbed,-0.439,9,222,1,1,0.031,0.875,0.431,231
student,-0.439,123,2765,1,1,0.634,0.318,0.537,2888
penguin,-0.439,15,356,1,1,0.615,0.296,0.307,371
lasagna,-0.44,5,133,1,1,0.719,0.441,0.396,138
takeover,-0.44,2,66,1,1,0.663,0.531,0.861,68
inflated,-0.44,2,66,1,1,0.303,0.431,0.617,68
shampoo,-0.44,5,133,1,1,0.604,0.18,0.25,138
dung,-0.44,2,66,1,1,0.104,0.549,0.149,68
indictment,-0.44,2,66,1,1,0.245,0.745,0.577,68
must,-0.441,2207,49335,1,1,0.408,0.382,0.441,51542
pilot,-0.442,15,357,1,1,0.688,0.68,0.736,372
relevant,-0.443,46,1051,1,1,0.719,0.608,0.764,1097
promote,-0.443,32,738,1,1,0.83,0.596,0.853,770
compulsive,-0.443,4,111,1,1,0.347,0.871,0.573,115
sheriff,-0.443,4,111,1,1,0.602,0.541,0.802,115
wand,-0.443,4,111,1,1,0.542,0.322,0.315,115
tube,-0.443,24,559,1,1,0.418,0.279,0.409,583
exploitation,-0.443,4,111,1,1,0.156,0.92,0.718,115
album,-0.444,491,11029,1,1,0.635,0.349,0.453,11520
button,-0.445,43,986,1,1,0.52,0.22,0.343,1029
journalism,-0.445,8,201,1,1,0.622,0.5,0.684,209
badly,-0.447,104,2360,1,1,0.073,0.509,0.286,2464
gigolo,-0.448,1,44,1,1,0.4,0.706,0.528,45
infirm,-0.448,1,44,1,1,0.115,0.521,0.21,45
stomp,-0.448,3,89,1,1,0.365,0.565,0.438,92
horseshit,-0.448,1,44,1,1,0.153,0.582,0.179,45
consoled,-0.448,1,44,1,1,0.7,0.343,0.452,45
faker,-0.448,1,44,1,1,0.245,0.63,0.48,45
rump,-0.448,1,44,1,1,0.449,0.425,0.396,45
gaby,-0.448,1,44,1,1,0.51,0.347,0.377,45
stressin,-0.448,3,89,1,1,0.146,0.81,0.367,92
holder,-0.448,5,134,1,1,0.592,0.33,0.713,139
uptight,-0.448,3,89,1,1,0.184,0.716,0.333,92
insurance,-0.448,17,404,1,1,0.714,0.308,0.825,421
hoax,-0.448,3,89,1,1,0.146,0.696,0.303,92
group,-0.449,696,15694,1,1,0.573,0.423,0.48,16390
exception,-0.45,43,991,1,1,0.469,0.6,0.544,1034
brand,-0.45,75,1713,1,1,0.562,0.284,0.547,1788
be,-0.45,33374,752734,1,1,0.67,0.24,0.554,786108
flat,-0.451,82,1873,1,1,0.408,0.236,0.303,1955
sos,-0.452,21,496,1,1,0.354,0.675,0.386,517
slander,-0.452,9,225,1,1,0.184,0.604,0.454,234
stain,-0.452,9,225,1,1,0.453,0.324,0.264,234
dweller,-0.452,4,112,1,1,0.615,0.304,0.5,116
roulette,-0.452,4,112,1,1,0.326,0.69,0.422,116
ghost,-0.452,213,4836,1,1,0.265,0.755,0.343,5049
fluffy,-0.453,22,519,1,1,0.781,0.431,0.356,541
dash,-0.453,12,293,1,1,0.574,0.312,0.324,305
sickness,-0.454,56,1290,1,1,0.094,0.704,0.288,1346
rate,-0.454,56,1290,1,1,0.521,0.297,0.407,1346
meh,-0.455,51,1177,1,1,0.38,0.286,0.365,1228
disloyal,-0.455,2,67,1,1,0.062,0.582,0.245,69
agoraphobia,-0.455,2,67,1,1,0.127,0.712,0.438,69
bases,-0.455,5,135,1,1,0.569,0.236,0.591,140
booster,-0.455,2,67,1,1,0.755,0.6,0.8,69
count,-0.455,188,4283,1,1,0.594,0.389,0.492,4471
scary,-0.456,282,6417,1,1,0.062,0.952,0.528,6699
real,-0.456,1982,44985,1,1,0.719,0.51,0.717,46967
harmless,-0.457,9,226,1,1,0.625,0.226,0.241,235
insert,-0.457,27,635,1,1,0.481,0.552,0.519,662
kidnapping,-0.457,6,158,1,1,0.094,0.88,0.561,164
quit,-0.458,139,3180,1,1,0.469,0.559,0.488,3319
corn,-0.458,14,340,1,1,0.594,0.196,0.292,354
spit,-0.458,18,431,1,1,0.149,0.545,0.436,449
box,-0.458,162,3706,1,1,0.5,0.179,0.312,3868
airplane,-0.459,19,454,1,1,0.719,0.702,0.708,473
mafia,-0.459,7,181,1,1,0.204,0.867,0.676,188
sewer,-0.459,3,90,1,1,0.286,0.367,0.282,93
midlife,-0.459,3,90,1,1,0.594,0.244,0.473,93
impoverished,-0.459,3,90,1,1,0.125,0.311,0.203,93
link,-0.459,103,2365,1,1,0.427,0.264,0.491,2468
viewer,-0.459,7,181,1,1,0.592,0.358,0.558,188
agreeing,-0.46,8,204,1,1,0.854,0.48,0.557,212
sky,-0.46,614,14009,1,1,0.958,0.234,0.401,14623
tee,-0.461,9,227,1,1,0.459,0.373,0.377,236
dishonesty,-0.461,4,113,1,1,0.094,0.592,0.348,117
insomnia,-0.461,60,1390,1,1,0.198,0.611,0.373,1450
shot,-0.461,193,4423,1,1,0.144,0.75,0.569,4616
ambassador,-0.462,5,136,1,1,0.651,0.529,0.917,141
scooter,-0.462,5,136,1,1,0.51,0.587,0.371,141
heartbreaking,-0.463,75,1735,1,1,0.146,0.811,0.423,1810
million,-0.463,155,3563,1,1,0.776,0.647,0.812,3718
lowest,-0.464,35,822,1,1,0.312,0.304,0.129,857
stat,-0.464,7,182,1,1,0.479,0.46,0.395,189
lawyer,-0.465,17,411,1,1,0.521,0.569,0.784,428
cartoon,-0.465,17,411,1,1,0.867,0.471,0.387,428
brain,-0.465,455,10441,1,1,0.667,0.441,0.823,10896
comrade,-0.465,9,228,1,1,0.781,0.412,0.804,237
skip,-0.466,46,1076,1,1,0.458,0.804,0.439,1122
thread,-0.466,194,4468,1,1,0.646,0.184,0.209,4662
ready,-0.466,866,19871,1,1,0.77,0.388,0.648,20737
limb,-0.466,12,297,1,1,0.51,0.397,0.427,309
pains,-0.466,52,1214,1,1,0.106,0.673,0.362,1266
acoustic,-0.467,27,641,1,1,0.542,0.462,0.536,668
ignorant,-0.467,69,1604,1,1,0.102,0.461,0.223,1673
shove,-0.467,17,412,1,1,0.306,0.69,0.602,429
stuck,-0.468,364,8378,1,1,0.153,0.644,0.285,8742
hope,-0.468,2161,49640,1,1,0.927,0.317,0.739,51801
walker,-0.468,30,711,1,1,0.551,0.491,0.525,741
judging,-0.469,36,849,1,1,0.24,0.625,0.693,885
garbage,-0.469,62,1447,1,1,0.188,0.51,0.192,1509
smiles,-0.469,134,3102,1,1,0.892,0.606,0.607,3236
halftime,-0.47,1,45,1,1,0.458,0.352,0.429,46
outraged,-0.47,4,114,1,1,0.156,0.696,0.538,118
stinging,-0.47,2,68,1,1,0.26,0.73,0.459,70
loathsome,-0.47,2,68,1,1,0.12,0.694,0.343,70
raptor,-0.47,1,45,1,1,0.27,0.773,0.612,46
counsellor,-0.47,2,68,1,1,0.823,0.327,0.74,70
scifi,-0.47,1,45,1,1,0.592,0.57,0.394,46
sparkly,-0.47,2,68,1,1,0.885,0.59,0.726,70
endorsement,-0.47,2,68,1,1,0.834,0.36,0.611,70
piper,-0.47,6,160,1,1,0.569,0.442,0.398,166
cannibal,-0.47,2,68,1,1,0.122,0.824,0.48,70
liver,-0.47,6,160,1,1,0.439,0.29,0.385,166
floss,-0.47,2,68,1,1,0.5,0.28,0.278,70
anxiousness,-0.47,2,68,1,1,0.235,0.814,0.282,70
transmission,-0.47,1,45,1,1,0.688,0.49,0.611,46
parakeet,-0.47,1,45,1,1,0.576,0.387,0.227,46
pecker,-0.47,1,45,1,1,0.459,0.509,0.375,46
haircut,-0.47,8,206,1,1,0.677,0.343,0.307,214
tinsel,-0.47,1,45,1,1,0.663,0.521,0.473,46
care,-0.47,1679,38649,1,1,0.729,0.37,0.5,40328
dry,-0.47,137,3174,1,1,0.363,0.169,0.311,3311
empty,-0.47,1084,24968,1,1,0.188,0.183,0.081,26052
channel,-0.47,67,1564,1,1,0.49,0.287,0.405,1631
hopeful,-0.472,44,1036,1,1,0.947,0.357,0.627,1080
loot,-0.472,16,391,1,1,0.604,0.711,0.537,407
strawberry,-0.473,13,322,1,1,0.833,0.27,0.336,335
excuse,-0.473,160,3715,1,1,0.24,0.696,0.318,3875
bastards,-0.473,23,553,1,1,0.082,0.68,0.422,576
psychologist,-0.473,11,276,1,1,0.375,0.308,0.658,287
clinical,-0.474,10,253,1,1,0.337,0.412,0.64,263
itchy,-0.474,9,230,1,1,0.334,0.726,0.296,239
paranoid,-0.474,39,923,1,1,0.122,0.918,0.364,962
smart,-0.474,121,2818,1,1,0.906,0.607,0.923,2939
picture,-0.475,282,6542,1,1,0.714,0.308,0.462,6824
hen,-0.475,7,184,1,1,0.385,0.276,0.241,191
trembling,-0.476,14,346,1,1,0.177,0.824,0.324,360
hardworking,-0.476,6,161,1,1,0.719,0.583,0.792,167
taps,-0.477,5,138,1,1,0.448,0.378,0.409,143
synthetic,-0.477,5,138,1,1,0.396,0.35,0.519,143
resentful,-0.478,10,254,1,1,0.12,0.608,0.324,264
annoy,-0.478,46,1089,1,1,0.094,0.765,0.286,1135
pancake,-0.478,4,115,1,1,0.802,0.274,0.364,119
straightforward,-0.478,4,115,1,1,0.78,0.15,0.38,119
arsenal,-0.478,9,231,1,1,0.365,0.741,0.752,240
phew,-0.478,9,231,1,1,0.531,0.429,0.302,240
impeachment,-0.478,4,115,1,1,0.163,0.735,0.694,119
abusive,-0.479,47,1113,1,1,0.125,0.903,0.567,1160
unpopular,-0.479,32,765,1,1,0.073,0.441,0.164,797
smelly,-0.479,8,208,1,1,0.1,0.528,0.245,216
meat,-0.48,50,1184,1,1,0.612,0.421,0.413,1234
surfer,-0.481,3,92,1,1,0.704,0.701,0.554,95
bandit,-0.481,3,92,1,1,0.094,0.796,0.567,95
suppress,-0.482,10,255,1,1,0.281,0.559,0.509,265
shrug,-0.482,13,325,1,1,0.208,0.296,0.278,338
salary,-0.482,6,162,1,1,0.786,0.48,0.652,168
cancer,-0.482,121,2840,1,1,0.052,0.694,0.529,2961
big,-0.483,1263,29454,1,1,0.802,0.588,0.812,30717
imaging,-0.484,2,69,1,1,0.724,0.394,0.482,71
squire,-0.484,2,69,1,1,0.479,0.459,0.71,71
layout,-0.484,8,209,1,1,0.615,0.442,0.557,217
ravioli,-0.484,2,69,1,1,0.656,0.281,0.308,71
tong,-0.484,2,69,1,1,0.475,0.48,0.37,71
peas,-0.484,5,139,1,1,0.542,0.283,0.31,144
teaser,-0.485,13,326,1,1,0.51,0.558,0.534,339
emptiness,-0.485,299,7007,1,1,0.177,0.173,0.184,7306
mud,-0.486,29,700,1,1,0.333,0.26,0.185,729
keep,-0.486,2355,55059,1,1,0.714,0.296,0.547,57414
strip,-0.486,26,630,1,1,0.427,0.5,0.436,656
bus,-0.486,129,3038,1,1,0.407,0.411,0.4,3167
icon,-0.486,17,420,1,1,0.549,0.349,0.415,437
decency,-0.487,9,233,1,1,0.75,0.235,0.634,242
jealousy,-0.487,60,1427,1,1,0.146,0.783,0.481,1487
shocked,-0.487,33,795,1,1,0.292,0.773,0.375,828
shoulder,-0.488,92,2177,1,1,0.562,0.286,0.406,2269
horseman,-0.488,6,163,1,1,0.441,0.7,0.676,169
noir,-0.488,13,327,1,1,0.375,0.394,0.365,340
dazed,-0.489,8,210,1,1,0.3,0.697,0.277,218
little,-0.489,2922,68556,1,1,0.385,0.16,0.213,71478
shave,-0.489,10,257,1,1,0.521,0.41,0.48,267
chorus,-0.49,27,656,1,1,0.62,0.417,0.5,683
chart,-0.49,26,633,1,1,0.469,0.317,0.33,659
aback,-0.491,1,46,1,1,0.385,0.407,0.288,47
hash,-0.491,3,93,1,1,0.344,0.453,0.355,96
inflammation,-0.491,1,46,1,1,0.146,0.765,0.423,47
pipeline,-0.491,1,46,1,1,0.479,0.337,0.411,47
correctness,-0.491,1,46,1,1,0.796,0.45,0.649,47
polling,-0.491,3,93,1,1,0.448,0.598,0.602,96
tribal,-0.491,3,93,1,1,0.417,0.404,0.482,96
geographic,-0.491,1,46,1,1,0.698,0.33,0.664,47
injection,-0.491,1,46,1,1,0.281,0.741,0.518,47
buss,-0.491,3,93,1,1,0.469,0.5,0.391,96
hypnosis,-0.491,1,46,1,1,0.417,0.41,0.546,47
misunderstood,-0.492,90,2139,1,1,0.177,0.625,0.309,2229
tell,-0.492,2108,49611,1,1,0.551,0.35,0.457,51719
obsessive,-0.493,14,352,1,1,0.219,0.823,0.48,366
cheek,-0.493,40,964,1,1,0.67,0.314,0.421,1004
sally,-0.493,12,305,1,1,0.604,0.39,0.451,317
child,-0.493,625,14737,1,1,0.912,0.46,0.413,15362
shooter,-0.493,10,258,1,1,0.224,0.814,0.774,268
pancakes,-0.494,8,211,1,1,0.844,0.373,0.402,219
hubby,-0.494,33,800,1,1,0.548,0.435,0.43,833
grinding,-0.494,24,588,1,1,0.415,0.45,0.461,612
significant,-0.494,120,2850,1,1,0.827,0.649,0.786,2970
shock,-0.494,36,871,1,1,0.286,0.821,0.453,907
shut,-0.494,305,7211,1,1,0.24,0.352,0.311,7516
bad,-0.494,2019,47613,1,1,0.125,0.625,0.373,49632
defeated,-0.494,32,777,1,1,0.104,0.582,0.145,809
sympathetic,-0.495,11,282,1,1,0.796,0.434,0.609,293
jade,-0.495,11,282,1,1,0.604,0.41,0.455,293
venue,-0.495,11,282,1,1,0.727,0.316,0.395,293
riddle,-0.495,4,117,1,1,0.521,0.583,0.543,121
campus,-0.495,74,1769,1,1,0.604,0.388,0.519,1843
glitter,-0.496,12,306,1,1,0.814,0.75,0.762,318
funk,-0.497,15,377,1,1,0.466,0.589,0.39,392
balloon,-0.497,10,259,1,1,0.729,0.245,0.315,269
cope,-0.498,156,3713,1,1,0.592,0.647,0.709,3869
size,-0.498,56,1348,1,1,0.531,0.336,0.569,1404
distrust,-0.498,20,496,1,1,0.06,0.67,0.276,516
programme,-0.498,17,425,1,1,0.74,0.298,0.537,442
repress,-0.498,2,70,1,1,0.208,0.612,0.536,72
villain,-0.5,22,544,1,1,0.177,0.892,0.59,566
relate,-0.5,317,7538,1,1,0.653,0.5,0.623,7855
rolling,-0.5,93,2228,1,1,0.51,0.606,0.321,2321
hoping,-0.5,232,5525,1,1,0.684,0.469,0.454,5757
mean,-0.501,1587,37673,1,1,0.44,0.467,0.62,39260
motel,-0.501,10,260,1,1,0.531,0.372,0.45,270
incomplete,-0.501,29,711,1,1,0.153,0.37,0.205,740
heartless,-0.501,29,711,1,1,0.071,0.652,0.4,740
aeroplane,-0.502,3,94,1,1,0.714,0.642,0.644,97
soulless,-0.502,11,284,1,1,0.125,0.591,0.4,295
shorten,-0.502,3,94,1,1,0.302,0.382,0.46,97
questionable,-0.502,7,189,1,1,0.268,0.551,0.365,196
rough,-0.502,140,3348,1,1,0.406,0.794,0.632,3488
thank,-0.502,1666,39595,1,1,0.958,0.353,0.526,41261
spouse,-0.502,40,973,1,1,0.75,0.6,0.645,1013
sliding,-0.502,16,403,1,1,0.356,0.73,0.491,419
dull,-0.503,49,1188,1,1,0.194,0.12,0.185,1237
feed,-0.503,160,3829,1,1,0.812,0.429,0.739,3989
seven,-0.504,91,2188,1,1,0.672,0.265,0.373,2279
vindictive,-0.504,4,118,1,1,0.092,0.83,0.5,122
barks,-0.504,4,118,1,1,0.427,0.694,0.325,122
wheel,-0.504,45,1094,1,1,0.615,0.31,0.446,1139
queen,-0.505,210,5024,1,1,0.875,0.692,0.86,5234
actor,-0.505,33,809,1,1,0.653,0.561,0.629,842
athlete,-0.505,5,142,1,1,0.781,0.718,0.686,147
pax,-0.505,5,142,1,1,0.551,0.421,0.473,147
clingy,-0.506,67,1620,1,1,0.224,0.46,0.37,1687
pocket,-0.506,49,1191,1,1,0.458,0.275,0.34,1240
genie,-0.506,12,309,1,1,0.76,0.6,0.908,321
pulse,-0.506,12,309,1,1,0.507,0.412,0.492,321
mess,-0.506,186,4460,1,1,0.143,0.843,0.273,4646
austerity,-0.506,6,166,1,1,0.438,0.406,0.534,172
drop,-0.507,254,6085,1,1,0.479,0.321,0.291,6339
poorly,-0.507,22,548,1,1,0.077,0.62,0.196,570
gag,-0.507,7,190,1,1,0.323,0.66,0.398,197
supermarket,-0.508,8,214,1,1,0.69,0.547,0.571,222
streaming,-0.508,72,1743,1,1,0.592,0.481,0.582,1815
bit,-0.508,1405,33595,1,1,0.427,0.31,0.225,35000
counseling,-0.508,9,238,1,1,0.667,0.48,0.704,247
incompetent,-0.508,9,238,1,1,0.133,0.566,0.239,247
gambling,-0.508,9,238,1,1,0.365,0.806,0.347,247
mayor,-0.508,10,262,1,1,0.469,0.481,0.818,272
dean,-0.509,33,812,1,1,0.612,0.469,0.723,845
clubs,-0.509,34,836,1,1,0.723,0.53,0.591,870
parent,-0.509,81,1961,1,1,0.812,0.357,0.86,2042
severely,-0.51,19,478,1,1,0.219,0.673,0.7,497
remember,-0.51,1334,31981,1,1,0.776,0.422,0.454,33315
say,-0.511,3028,72597,1,1,0.571,0.31,0.482,75625
highlight,-0.511,36,886,1,1,0.844,0.637,0.882,922
abroad,-0.511,37,910,1,1,0.677,0.596,0.561,947
foolish,-0.511,39,958,1,1,0.316,0.255,0.109,997
caring,-0.512,143,3453,1,1,0.635,0.469,0.5,3596
eyebrow,-0.512,6,167,1,1,0.51,0.198,0.222,173
umbrella,-0.512,20,503,1,1,0.583,0.246,0.255,523
roomy,-0.512,1,47,1,1,0.76,0.342,0.736,48
munchies,-0.512,1,47,1,1,0.562,0.47,0.491,48
troublemaker,-0.512,1,47,1,1,0.26,0.9,0.596,48
lousy,-0.512,5,143,1,1,0.125,0.482,0.234,148
kos,-0.512,1,47,1,1,0.5,0.471,0.407,48
pageant,-0.512,1,47,1,1,0.719,0.667,0.651,48
bandage,-0.512,1,47,1,1,0.22,0.327,0.286,48
roller,-0.512,14,359,1,1,0.521,0.394,0.345,373
faze,-0.512,2,71,1,1,0.417,0.515,0.382,73
clapping,-0.512,4,119,1,1,0.823,0.894,0.686,123
suitor,-0.512,1,47,1,1,0.708,0.639,0.546,48
blackness,-0.512,8,215,1,1,0.26,0.48,0.406,223
exorcist,-0.512,1,47,1,1,0.219,0.906,0.716,48
covering,-0.512,25,623,1,1,0.615,0.382,0.583,648
transaction,-0.512,2,71,1,1,0.65,0.577,0.579,73
toxic,-0.513,373,8978,1,1,0.008,0.885,0.492,9351
karma,-0.513,48,1176,1,1,0.5,0.51,0.537,1224
untold,-0.514,22,552,1,1,0.24,0.367,0.191,574
representation,-0.514,20,504,1,1,0.677,0.542,0.75,524
hard,-0.515,1979,47644,1,1,0.302,0.708,0.616,49623
status,-0.516,84,2046,1,1,0.658,0.377,0.588,2130
tragic,-0.516,70,1709,1,1,0.048,0.904,0.396,1779
busted,-0.516,10,264,1,1,0.204,0.676,0.345,274
answering,-0.517,34,843,1,1,0.684,0.5,0.607,877
helper,-0.517,7,192,1,1,0.704,0.438,0.567,199
gram,-0.518,6,168,1,1,0.578,0.333,0.26,174
transferred,-0.518,6,168,1,1,0.48,0.45,0.409,174
knock,-0.519,82,2004,1,1,0.312,0.531,0.527,2086
recruiting,-0.519,5,144,1,1,0.448,0.787,0.693,149
unworthy,-0.519,23,579,1,1,0.194,0.433,0.226,602
dysfunctional,-0.52,10,265,1,1,0.125,0.558,0.307,275
chin,-0.52,35,870,1,1,0.571,0.31,0.269,905
fest,-0.521,9,241,1,1,0.704,0.574,0.402,250
shirt,-0.521,57,1403,1,1,0.698,0.186,0.231,1460
coworker,-0.521,32,798,1,1,0.667,0.49,0.625,830
burger,-0.523,19,484,1,1,0.688,0.568,0.398,503
pare,-0.523,3,96,1,1,0.5,0.356,0.309,99
squishy,-0.523,3,96,1,1,0.516,0.333,0.307,99
gloves,-0.523,7,193,1,1,0.542,0.225,0.491,200
fight,-0.523,476,11569,1,1,0.531,0.868,0.809,12045
man,-0.523,3404,82591,1,1,0.688,0.427,0.767,85995
damaged,-0.523,37,921,1,1,0.104,0.635,0.182,958
kids,-0.523,827,20094,1,1,0.837,0.5,0.417,20921
unlucky,-0.524,10,266,1,1,0.073,0.395,0.198,276
crappy,-0.524,21,533,1,1,0.039,0.582,0.208,554
slim,-0.524,10,266,1,1,0.562,0.18,0.296,276
tour,-0.524,134,3276,1,1,0.663,0.545,0.543,3410
bee,-0.524,28,703,1,1,0.52,0.509,0.309,731
sober,-0.525,74,1822,1,1,0.729,0.216,0.568,1896
fun,-0.526,1048,25521,1,1,0.918,0.843,0.667,26569
bilingual,-0.526,2,72,1,1,0.735,0.49,0.606,74
pay,-0.526,377,9197,1,1,0.514,0.588,0.592,9574
loveless,-0.526,23,583,1,1,0.102,0.365,0.216,606
dun,-0.526,14,364,1,1,0.458,0.431,0.339,378
hoop,-0.526,2,72,1,1,0.635,0.204,0.315,74
frown,-0.526,11,291,1,1,0.214,0.602,0.433,302
bargaining,-0.526,2,72,1,1,0.622,0.64,0.642,74
existent,-0.526,8,218,1,1,0.635,0.49,0.635,226
accurate,-0.526,46,1143,1,1,0.743,0.36,0.737,1189
brother,-0.527,376,9177,1,1,0.823,0.361,0.546,9553
stole,-0.527,39,973,1,1,0.135,0.76,0.384,1012
charity,-0.527,43,1071,1,1,0.92,0.284,0.551,1114
rapping,-0.528,7,194,1,1,0.565,0.716,0.417,201
blow,-0.528,75,1852,1,1,0.316,0.75,0.57,1927
eyes,-0.528,1032,25191,1,1,0.76,0.279,0.432,26223
funeral,-0.528,45,1121,1,1,0.073,0.38,0.393,1166
casket,-0.529,4,121,1,1,0.125,0.49,0.346,125
cucumber,-0.529,4,121,1,1,0.49,0.235,0.237,125
orientation,-0.529,9,243,1,1,0.667,0.454,0.686,252
blinded,-0.529,14,365,1,1,0.245,0.471,0.231,379
detective,-0.529,14,365,1,1,0.5,0.764,0.901,379
dryer,-0.529,4,121,1,1,0.479,0.343,0.277,125
disrespectful,-0.529,21,536,1,1,0.031,0.694,0.273,557
spoon,-0.529,23,585,1,1,0.479,0.236,0.259,608
biased,-0.529,11,292,1,1,0.271,0.302,0.368,303
bohemian,-0.529,11,292,1,1,0.622,0.5,0.407,303
university,-0.53,66,1635,1,1,0.735,0.574,0.741,1701
hesitate,-0.53,32,805,1,1,0.459,0.548,0.232,837
mall,-0.53,40,1001,1,1,0.724,0.663,0.492,1041
saddens,-0.531,8,219,1,1,0.104,0.436,0.144,227
lemonade,-0.531,8,219,1,1,0.661,0.287,0.412,227
zodiac,-0.531,8,219,1,1,0.594,0.429,0.426,227
tough,-0.533,255,6270,1,1,0.344,0.588,0.742,6525
cookout,-0.533,1,48,1,1,0.68,0.406,0.482,49
factual,-0.533,3,97,1,1,0.656,0.44,0.545,100
meatball,-0.533,1,48,1,1,0.612,0.279,0.343,49
onboard,-0.533,1,48,1,1,0.612,0.451,0.491,49
dribble,-0.533,1,48,1,1,0.417,0.551,0.465,49
thingy,-0.533,9,244,1,1,0.458,0.312,0.158,253
yearbook,-0.533,1,48,1,1,0.562,0.231,0.509,49
starve,-0.533,21,538,1,1,0.073,0.729,0.402,559
heiress,-0.533,1,48,1,1,0.827,0.571,0.676,49
godforsaken,-0.533,1,48,1,1,0.439,0.52,0.422,49
pasty,-0.533,1,48,1,1,0.479,0.363,0.375,49
naive,-0.534,25,637,1,1,0.406,0.26,0.375,662
bump,-0.535,21,539,1,1,0.286,0.458,0.368,560
lion,-0.535,55,1374,1,1,0.532,0.717,0.682,1429
supportive,-0.535,56,1399,1,1,0.875,0.42,0.635,1455
drill,-0.536,6,171,1,1,0.25,0.602,0.573,177
hysterical,-0.536,6,171,1,1,0.29,0.942,0.398,177
kindergarten,-0.536,6,171,1,1,0.833,0.462,0.308,177
warped,-0.536,6,171,1,1,0.219,0.663,0.304,177
socialist,-0.536,13,343,1,1,0.448,0.4,0.543,356
regretful,-0.536,6,171,1,1,0.167,0.48,0.188,177
wreck,-0.536,23,589,1,1,0.22,0.77,0.339,612
blink,-0.536,23,589,1,1,0.552,0.316,0.324,612
dishonest,-0.537,4,122,1,1,0.191,0.491,0.163,126
cowboy,-0.538,65,1625,1,1,0.594,0.625,0.695,1690
fab,-0.539,16,418,1,1,0.49,0.38,0.406,434
career,-0.539,116,2883,1,1,0.74,0.712,0.606,2999
sideline,-0.54,2,73,1,1,0.44,0.382,0.517,75
roach,-0.54,5,147,1,1,0.146,0.598,0.259,152
poisoning,-0.54,5,147,1,1,0.094,0.837,0.526,152
victim,-0.541,67,1678,1,1,0.115,0.676,0.202,1745
follower,-0.541,39,987,1,1,0.646,0.488,0.461,1026
tail,-0.541,26,666,1,1,0.48,0.272,0.293,692
housing,-0.542,24,617,1,1,0.776,0.304,0.591,641
char,-0.543,11,296,1,1,0.554,0.361,0.404,307
tackled,-0.543,3,98,1,1,0.438,0.612,0.569,101
sweets,-0.543,11,296,1,1,0.91,0.422,0.321,307
domino,-0.543,3,98,1,1,0.594,0.51,0.473,101
shrimp,-0.543,7,197,1,1,0.571,0.361,0.425,204
betrayed,-0.543,44,1113,1,1,0.122,0.769,0.308,1157
gentleman,-0.544,20,519,1,1,0.823,0.439,0.712,539
fights,-0.544,41,1039,1,1,0.07,0.92,0.712,1080
lance,-0.544,16,420,1,1,0.406,0.62,0.587,436
happy,-0.544,3299,81743,1,1,1,0.735,0.772,85042
fund,-0.544,21,544,1,1,0.521,0.36,0.426,565
yeahhh,-0.545,4,123,1,1,0.82,0.792,0.51,127
android,-0.546,15,396,1,1,0.663,0.436,0.5,411
piss,-0.546,44,1116,1,1,0.354,0.462,0.268,1160
husky,-0.546,5,148,1,1,0.63,0.45,0.49,153
daughter,-0.547,183,4569,1,1,0.908,0.415,0.455,4752
dancer,-0.547,19,496,1,1,0.74,0.768,0.545,515
adult,-0.55,216,5406,1,1,0.815,0.491,0.787,5622
com,-0.55,85,2142,1,1,0.396,0.382,0.382,2227
everyday,-0.551,536,13390,1,1,0.74,0.392,0.472,13926
costume,-0.551,16,423,1,1,0.548,0.51,0.374,439
left,-0.551,1925,48040,1,1,0.354,0.37,0.361,49965
kick,-0.551,129,3242,1,1,0.271,0.791,0.526,3371
till,-0.552,380,9513,1,1,0.49,0.327,0.319,9893
side,-0.553,929,23236,1,1,0.439,0.288,0.395,24165
tat,-0.553,7,199,1,1,0.429,0.38,0.404,206
scrawny,-0.553,1,49,1,1,0.276,0.422,0.245,50
duo,-0.553,29,749,1,1,0.51,0.5,0.447,778
specimen,-0.553,2,74,1,1,0.531,0.444,0.568,76
dropout,-0.553,2,74,1,1,0.253,0.55,0.481,76
barley,-0.553,4,124,1,1,0.614,0.212,0.296,128
testicle,-0.553,1,49,1,1,0.458,0.651,0.41,50
urine,-0.553,2,74,1,1,0.375,0.361,0.169,76
paisley,-0.553,1,49,1,1,0.531,0.327,0.347,50
lizard,-0.553,10,274,1,1,0.378,0.375,0.324,284
evangelical,-0.553,3,99,1,1,0.602,0.389,0.602,102
contender,-0.553,1,49,1,1,0.48,0.79,0.681,50
eek,-0.553,1,49,1,1,0.292,0.529,0.343,50
turnover,-0.553,1,49,1,1,0.49,0.392,0.512,50
boasting,-0.553,1,49,1,1,0.417,0.62,0.602,50
snare,-0.553,1,49,1,1,0.229,0.85,0.466,50
sparkle,-0.553,4,124,1,1,0.819,0.765,0.51,128
fishy,-0.553,3,99,1,1,0.224,0.601,0.471,102
humiliate,-0.553,3,99,1,1,0.052,0.714,0.275,102
semester,-0.553,55,1399,1,1,0.521,0.327,0.482,1454
puberty,-0.553,5,149,1,1,0.552,0.786,0.504,154
carpool,-0.553,3,99,1,1,0.625,0.509,0.5,102
grease,-0.553,3,99,1,1,0.255,0.404,0.306,102
blushing,-0.553,4,124,1,1,0.51,0.789,0.288,128
plank,-0.553,1,49,1,1,0.427,0.28,0.333,50
snore,-0.553,2,74,1,1,0.245,0.61,0.481,76
bur,-0.553,1,49,1,1,0.385,0.353,0.314,50
wipe,-0.553,27,699,1,1,0.663,0.427,0.551,726
lost,-0.554,1459,36515,1,1,0.199,0.663,0.148,37974
seem,-0.554,575,14412,1,1,0.471,0.302,0.298,14987
slowly,-0.555,493,12373,1,1,0.427,0.185,0.295,12866
high,-0.555,874,21923,1,1,0.684,0.51,0.614,22797
aunt,-0.555,52,1327,1,1,0.667,0.291,0.42,1379
saw,-0.555,578,14507,1,1,0.316,0.541,0.518,15085
inclusive,-0.556,11,300,1,1,0.604,0.42,0.564,311
taco,-0.557,20,526,1,1,0.561,0.353,0.277,546
bigotry,-0.558,8,225,1,1,0.356,0.737,0.481,233
gender,-0.558,58,1481,1,1,0.688,0.346,0.611,1539
pissed,-0.558,63,1607,1,1,0.102,0.888,0.543,1670
lowly,-0.558,7,200,1,1,0.562,0.294,0.417,207
internship,-0.559,6,175,1,1,0.59,0.51,0.482,181
anger,-0.559,250,6311,1,1,0.167,0.865,0.657,6561
senate,-0.559,12,326,1,1,0.49,0.349,0.836,338
pat,-0.559,25,653,1,1,0.418,0.377,0.34,678
cod,-0.56,11,301,1,1,0.51,0.321,0.304,312
pea,-0.56,5,150,1,1,0.58,0.275,0.298,155
imagine,-0.56,634,15981,1,1,0.759,0.48,0.587,16615
name,-0.56,911,22963,1,1,0.573,0.3,0.415,23874
mouth,-0.56,124,3147,1,1,0.734,0.294,0.336,3271
wishing,-0.56,172,4356,1,1,0.755,0.6,0.491,4528
vacancy,-0.561,9,251,1,1,0.643,0.311,0.418,260
sigh,-0.561,216,5468,1,1,0.469,0.387,0.273,5684
cover,-0.561,191,4839,1,1,0.365,0.24,0.471,5030
murderer,-0.562,13,352,1,1,0.01,0.96,0.65,365
token,-0.562,8,226,1,1,0.51,0.418,0.414,234
invite,-0.562,133,3379,1,1,0.745,0.655,0.611,3512
deserve,-0.563,533,13479,1,1,0.802,0.436,0.613,14012
dirt,-0.563,72,1842,1,1,0.112,0.5,0.236,1914
plough,-0.563,3,100,1,1,0.677,0.427,0.458,103
aaaah,-0.563,3,100,1,1,0.52,0.636,0.282,103
sax,-0.563,3,100,1,1,0.573,0.465,0.409,103
stocks,-0.563,3,100,1,1,0.573,0.598,0.586,103
alligator,-0.563,3,100,1,1,0.354,0.704,0.645,103
admirer,-0.563,3,100,1,1,0.796,0.72,0.65,103
impeach,-0.563,3,100,1,1,0.208,0.776,0.664,103
callous,-0.563,3,100,1,1,0.245,0.5,0.386,103
humiliated,-0.564,6,176,1,1,0.104,0.712,0.216,182
homework,-0.565,42,1087,1,1,0.396,0.412,0.459,1129
settle,-0.565,200,5085,1,1,0.833,0.52,0.772,5285
bin,-0.565,28,733,1,1,0.422,0.304,0.327,761
replay,-0.566,15,404,1,1,0.612,0.522,0.761,419
awkwardness,-0.566,15,404,1,1,0.167,0.454,0.148,419
shine,-0.566,146,3720,1,1,0.844,0.539,0.741,3866
mitt,-0.566,2,75,1,1,0.406,0.183,0.264,77
barb,-0.566,2,75,1,1,0.448,0.365,0.417,77
juggling,-0.566,2,75,1,1,0.562,0.874,0.346,77
mumble,-0.566,2,75,1,1,0.292,0.444,0.245,77
craig,-0.566,8,227,1,1,0.448,0.449,0.49,235
macho,-0.566,2,75,1,1,0.643,0.69,0.676,77
breast,-0.568,10,278,1,1,0.753,0.429,0.5,288
alcoholism,-0.568,10,278,1,1,0.061,0.779,0.407,288
disc,-0.568,7,202,1,1,0.622,0.41,0.426,209
spread,-0.569,91,2335,1,1,0.57,0.583,0.651,2426
peanut,-0.569,14,380,1,1,0.646,0.202,0.246,394
nightmares,-0.57,37,965,1,1,0.082,0.942,0.448,1002
smiling,-0.57,120,3075,1,1,0.981,0.679,0.625,3195
nanny,-0.57,6,177,1,1,0.615,0.37,0.528,183
rejection,-0.571,124,3179,1,1,0.08,0.704,0.33,3303
uncle,-0.572,57,1476,1,1,0.653,0.255,0.578,1533
look,-0.572,1978,50417,1,1,0.719,0.429,0.615,52395
down,-0.572,2577,65680,1,1,0.208,0.33,0.264,68257
overprotective,-0.573,1,50,1,1,0.448,0.673,0.741,51
lovee,-0.573,1,50,1,1,0.949,0.592,0.611,51
rigged,-0.573,1,50,1,1,0.188,0.51,0.412,51
rider,-0.573,13,356,1,1,0.635,0.627,0.574,369
recline,-0.573,3,101,1,1,0.46,0.404,0.418,104
caveman,-0.573,1,50,1,1,0.235,0.644,0.482,51
darn,-0.573,15,407,1,1,0.115,0.765,0.418,422
referral,-0.573,1,50,1,1,0.694,0.314,0.603,51
yayy,-0.573,1,50,1,1,0.64,0.587,0.355,51
despicable,-0.573,9,254,1,1,0.146,0.71,0.255,263
crisis,-0.573,71,1836,1,1,0.208,0.811,0.431,1907
farmer,-0.575,19,510,1,1,0.677,0.432,0.464,529
boost,-0.576,25,664,1,1,0.865,0.73,0.75,689
waiting,-0.577,657,16839,1,1,0.239,0.339,0.333,17496
therapist,-0.577,61,1586,1,1,0.468,0.43,0.679,1647
syndrome,-0.577,29,767,1,1,0.229,0.51,0.246,796
losing,-0.577,274,7042,1,1,0.076,0.686,0.223,7316
breed,-0.578,31,819,1,1,0.49,0.441,0.578,850
lyric,-0.578,37,973,1,1,0.702,0.269,0.464,1010
cooling,-0.578,10,281,1,1,0.469,0.324,0.392,291
cream,-0.578,88,2281,1,1,0.688,0.259,0.22,2369
bust,-0.579,22,589,1,1,0.52,0.5,0.42,611
poll,-0.579,17,461,1,1,0.552,0.5,0.554,478
clerk,-0.579,2,76,1,1,0.5,0.579,0.509,78
lice,-0.579,2,76,1,1,0.133,0.5,0.194,78
comforter,-0.579,8,230,1,1,0.618,0.275,0.302,238
congratulation,-0.579,2,76,1,1,0.948,0.78,0.717,78
tattoo,-0.581,32,847,1,1,0.49,0.602,0.525,879
wedding,-0.581,77,2004,1,1,0.875,0.802,0.642,2081
saxophone,-0.583,3,102,1,1,0.688,0.444,0.482,105
stroke,-0.584,21,566,1,1,0.562,0.44,0.57,587
eleven,-0.585,14,386,1,1,0.449,0.25,0.43,400
geez,-0.585,19,515,1,1,0.417,0.396,0.39,534
nosey,-0.585,4,128,1,1,0.276,0.655,0.223,132
monthly,-0.585,14,386,1,1,0.622,0.314,0.364,400
mailbox,-0.585,4,128,1,1,0.573,0.222,0.404,132
giggling,-0.586,5,154,1,1,0.886,0.726,0.391,159
monopoly,-0.586,5,154,1,1,0.449,0.509,0.64,159
dale,-0.586,5,154,1,1,0.622,0.27,0.365,159
frustrating,-0.586,60,1575,1,1,0.042,0.696,0.264,1635
snatch,-0.587,6,180,1,1,0.219,0.861,0.691,186
ted,-0.587,42,1111,1,1,0.712,0.453,0.336,1153
puff,-0.588,7,206,1,1,0.531,0.367,0.26,213
nugget,-0.588,7,206,1,1,0.602,0.34,0.348,213
classy,-0.588,7,206,1,1,0.917,0.41,0.649,213
buying,-0.589,91,2383,1,1,0.665,0.784,0.589,2474
active,-0.59,132,3449,1,1,0.847,0.73,0.731,3581
application,-0.59,16,440,1,1,0.646,0.445,0.726,456
coward,-0.59,35,933,1,1,0.102,0.49,0.149,968
plug,-0.59,18,492,1,1,0.531,0.356,0.473,510
wife,-0.591,435,11315,1,1,0.886,0.63,0.583,11750
kangaroo,-0.592,1,51,1,1,0.716,0.333,0.301,52
hart,-0.592,7,207,1,1,0.643,0.389,0.447,214
guidelines,-0.592,1,51,1,1,0.459,0.5,0.664,52
adoptive,-0.592,2,77,1,1,0.531,0.469,0.52,79
semen,-0.592,1,51,1,1,0.5,0.755,0.471,52
viscous,-0.592,0,25,1,1,0.398,0.396,0.409,25
bulldog,-0.592,3,103,1,1,0.494,0.65,0.53,106
liner,-0.592,5,155,1,1,0.469,0.396,0.4,160
runny,-0.592,0,25,1,1,0.54,0.439,0.325,25
juke,-0.592,0,25,1,1,0.5,0.491,0.41,25
schadenfreude,-0.592,0,25,1,1,0.354,0.64,0.463,25
absinthe,-0.592,0,25,1,1,0.481,0.51,0.462,25
annoyin,-0.592,0,25,1,1,0.26,0.573,0.352,25
tailgate,-0.592,0,25,1,1,0.323,0.34,0.398,25
froggy,-0.592,0,25,1,1,0.5,0.56,0.425,25
polygamy,-0.592,1,51,1,1,0.365,0.647,0.563,52
lowlife,-0.592,3,103,1,1,0.296,0.529,0.309,106
flattered,-0.592,4,129,1,1,0.865,0.608,0.708,133
diesel,-0.592,3,103,1,1,0.49,0.327,0.448,106
pusher,-0.592,0,25,1,1,0.323,0.828,0.585,25
dak,-0.592,0,25,1,1,0.51,0.417,0.424,25
censor,-0.592,1,51,1,1,0.344,0.276,0.538,52
diatribe,-0.592,0,25,1,1,0.354,0.569,0.409,25
posse,-0.592,3,103,1,1,0.398,0.51,0.473,106
payphone,-0.592,0,25,1,1,0.469,0.36,0.37,25
locket,-0.592,0,25,1,1,0.615,0.327,0.616,25
waiter,-0.592,7,207,1,1,0.459,0.3,0.295,214
temperamental,-0.592,0,25,1,1,0.316,0.774,0.608,25
lifesaver,-0.592,1,51,1,1,0.908,0.745,0.703,52
raincoat,-0.592,0,25,1,1,0.458,0.3,0.525,25
navigator,-0.592,0,25,1,1,0.583,0.592,0.623,25
beggar,-0.592,3,103,1,1,0.24,0.402,0.116,106
hyena,-0.592,1,51,1,1,0.396,0.719,0.464,52
columbine,-0.592,0,25,1,1,0.52,0.521,0.407,25
graze,-0.592,2,77,1,1,0.56,0.255,0.371,79
headliner,-0.592,0,25,1,1,0.5,0.49,0.625,25
ante,-0.592,0,25,1,1,0.448,0.32,0.417,25
reproductive,-0.592,1,51,1,1,0.77,0.604,0.856,52
internet,-0.594,323,8438,1,1,0.76,0.462,0.755,8761
shake,-0.594,82,2161,1,1,0.439,0.689,0.539,2243
embarrassing,-0.594,40,1067,1,1,0.226,0.809,0.225,1107
vet,-0.594,19,520,1,1,0.531,0.4,0.644,539
local,-0.595,180,4719,1,1,0.656,0.269,0.452,4899
snowflake,-0.596,11,312,1,1,0.748,0.192,0.26,323
random,-0.596,245,6418,1,1,0.49,0.52,0.321,6663
breakdown,-0.596,59,1565,1,1,0.365,0.423,0.361,1624
spree,-0.596,9,260,1,1,0.564,0.663,0.474,269
comedy,-0.597,49,1305,1,1,0.918,0.555,0.49,1354
fling,-0.597,7,208,1,1,0.439,0.696,0.534,215
clip,-0.599,30,810,1,1,0.438,0.31,0.381,840
kiwi,-0.599,5,156,1,1,0.646,0.273,0.282,161
lash,-0.599,10,287,1,1,0.235,0.794,0.609,297
senile,-0.6,4,130,1,1,0.28,0.211,0.305,134
sire,-0.6,4,130,1,1,0.854,0.452,0.808,134
queue,-0.601,13,366,1,1,0.458,0.344,0.365,379
basement,-0.601,96,2542,1,1,0.388,0.5,0.268,2638
teasing,-0.602,11,314,1,1,0.235,0.725,0.352,325
projection,-0.602,7,209,1,1,0.708,0.5,0.731,216
buckle,-0.602,3,104,1,1,0.416,0.373,0.361,107
sewing,-0.602,3,104,1,1,0.625,0.337,0.356,107
filthy,-0.602,23,629,1,1,0.115,0.714,0.321,652
mitigate,-0.602,3,104,1,1,0.506,0.427,0.456,107
yell,-0.603,24,656,1,1,0.24,0.798,0.558,680
forum,-0.604,16,446,1,1,0.556,0.49,0.632,462
watch,-0.604,1021,26878,1,1,0.531,0.346,0.423,27899
thx,-0.604,55,1472,1,1,0.562,0.425,0.461,1527
fleabag,-0.605,2,78,1,1,0.271,0.557,0.348,80
manipulate,-0.605,14,394,1,1,0.255,0.7,0.772,408
tic,-0.605,2,78,1,1,0.271,0.438,0.25,80
blueberry,-0.605,2,78,1,1,0.656,0.185,0.365,80
frustration,-0.607,82,2188,1,1,0.06,0.73,0.28,2270
dreamt,-0.607,20,553,1,1,0.812,0.38,0.518,573
crib,-0.607,38,1028,1,1,0.653,0.24,0.407,1066
mail,-0.607,30,817,1,1,0.615,0.231,0.548,847
taxi,-0.608,24,659,1,1,0.542,0.362,0.43,683
worker,-0.608,29,791,1,1,0.719,0.598,0.684,820
affection,-0.608,206,5466,1,1,0.898,0.559,0.696,5672
banger,-0.608,16,448,1,1,0.378,0.54,0.538,464
whip,-0.608,11,316,1,1,0.208,0.899,0.509,327
bikini,-0.609,6,184,1,1,0.73,0.639,0.353,190
estranged,-0.609,6,184,1,1,0.156,0.382,0.377,190
gamble,-0.609,6,184,1,1,0.568,0.798,0.361,190
savings,-0.609,8,237,1,1,0.776,0.431,0.608,245
rick,-0.609,17,475,1,1,0.459,0.42,0.444,492
giveaway,-0.609,8,237,1,1,0.865,0.618,0.437,245
pretended,-0.61,10,290,1,1,0.167,0.556,0.227,300
make,-0.61,4681,123890,1,1,0.684,0.42,0.48,128571
banter,-0.61,12,343,1,1,0.594,0.677,0.464,355
dying,-0.61,283,7517,1,1,0.04,0.664,0.422,7800
bill,-0.61,71,1905,1,1,0.396,0.402,0.535,1976
update,-0.611,101,2701,1,1,0.698,0.535,0.802,2802
infect,-0.611,1,52,1,1,0.102,0.777,0.424,53
lusty,-0.611,1,52,1,1,0.469,0.941,0.673,53
snag,-0.611,1,52,1,1,0.417,0.25,0.339,53
fatal,-0.611,19,529,1,1,0.061,0.775,0.509,548
straits,-0.611,1,52,1,1,0.408,0.269,0.41,53
conservatism,-0.611,1,52,1,1,0.406,0.369,0.633,53
whelp,-0.611,1,52,1,1,0.344,0.458,0.31,53
dopey,-0.611,1,52,1,1,0.32,0.38,0.365,53
hairdresser,-0.611,1,52,1,1,0.708,0.509,0.407,53
reporter,-0.611,7,211,1,1,0.531,0.55,0.604,218
ankle,-0.611,5,158,1,1,0.5,0.274,0.234,163
predict,-0.611,9,264,1,1,0.615,0.486,0.654,273
console,-0.611,41,1112,1,1,0.625,0.398,0.415,1153
smoke,-0.612,196,5222,1,1,0.188,0.5,0.391,5418
cue,-0.612,22,609,1,1,0.521,0.433,0.484,631
fraud,-0.612,16,450,1,1,0.111,0.688,0.407,466
pump,-0.613,10,291,1,1,0.417,0.882,0.681,301
facial,-0.613,10,291,1,1,0.594,0.429,0.433,301
fry,-0.616,7,212,1,1,0.52,0.61,0.324,219
laugh,-0.616,308,8228,1,1,0.98,0.639,0.587,8536
mouse,-0.617,16,452,1,1,0.427,0.441,0.206,468
crusty,-0.618,8,239,1,1,0.625,0.531,0.473,247
handy,-0.618,8,239,1,1,0.741,0.378,0.639,247
choreography,-0.618,5,159,1,1,0.812,0.75,0.547,164
herpes,-0.618,2,79,1,1,0.11,0.6,0.309,81
psychopathic,-0.618,2,79,1,1,0.077,0.918,0.508,81
creep,-0.618,51,1386,1,1,0.354,0.647,0.361,1437
shin,-0.619,6,186,1,1,0.459,0.5,0.231,192
nana,-0.619,20,560,1,1,0.765,0.255,0.375,580
laughing,-0.62,141,3796,1,1,0.906,0.596,0.534,3937
imaginary,-0.62,49,1336,1,1,0.56,0.424,0.31,1385
celebrity,-0.621,27,748,1,1,0.76,0.619,0.855,775
montage,-0.621,3,106,1,1,0.438,0.52,0.388,109
borderline,-0.622,17,481,1,1,0.449,0.52,0.49,498
pictures,-0.622,180,4846,1,1,0.653,0.24,0.405,5026
sing,-0.623,262,7047,1,1,0.858,0.606,0.42,7309
schizophrenia,-0.623,4,133,1,1,0.092,0.88,0.435,137
tasteless,-0.623,4,133,1,1,0.146,0.196,0.148,137
debut,-0.623,35,964,1,1,0.806,0.606,0.629,999
ashamed,-0.623,66,1796,1,1,0.156,0.588,0.228,1862
snake,-0.624,34,938,1,1,0.276,0.75,0.549,972
prevention,-0.624,11,321,1,1,0.76,0.463,0.6,332
prostitution,-0.624,5,160,1,1,0.125,0.843,0.475,165
bam,-0.624,12,348,1,1,0.427,0.472,0.39,360
policy,-0.626,26,725,1,1,0.324,0.735,0.833,751
awkward,-0.626,153,4140,1,1,0.296,0.65,0.358,4293
randomly,-0.627,54,1479,1,1,0.41,0.594,0.302,1533
treat,-0.628,233,6302,1,1,0.573,0.571,0.436,6535
embarrassed,-0.628,35,969,1,1,0.184,0.56,0.246,1004
lullaby,-0.628,18,511,1,1,0.796,0.156,0.339,529
annoying,-0.628,254,6872,1,1,0.082,0.853,0.348,7126
soulmate,-0.629,82,2237,1,1,0.89,0.5,0.628,2319
edgy,-0.629,27,754,1,1,0.281,0.895,0.306,781
unsupervised,-0.63,0,26,1,1,0.478,0.481,0.442,26
goofy,-0.63,24,674,1,1,0.281,0.224,0.179,698
flagstaff,-0.63,0,26,1,1,0.52,0.517,0.5,26
trickery,-0.63,0,26,1,1,0.146,0.798,0.336,26
hohoho,-0.63,0,26,1,1,0.677,0.433,0.33,26
glider,-0.63,2,80,1,1,0.618,0.548,0.59,82
fantasia,-0.63,0,26,1,1,0.898,0.694,0.436,26
dipper,-0.63,0,26,1,1,0.548,0.361,0.348,26
drier,-0.63,0,26,1,1,0.306,0.347,0.392,26
curable,-0.63,0,26,1,1,0.823,0.292,0.574,26
silliness,-0.63,1,53,1,1,0.327,0.368,0.192,54
extortion,-0.63,0,26,1,1,0.112,0.868,0.63,26
spunky,-0.63,0,26,1,1,0.646,0.879,0.755,26
pus,-0.63,0,26,1,1,0.135,0.431,0.226,26
impregnate,-0.63,0,26,1,1,0.51,0.721,0.655,26
restock,-0.63,1,53,1,1,0.51,0.538,0.645,54
heating,-0.63,7,215,1,1,0.647,0.491,0.537,222
bleach,-0.63,5,161,1,1,0.336,0.282,0.337,166
pornographic,-0.63,0,26,1,1,0.23,0.896,0.5,26
chairman,-0.63,2,80,1,1,0.656,0.567,0.933,82
mortified,-0.63,0,26,1,1,0.073,0.731,0.27,26
habitation,-0.63,0,26,1,1,0.781,0.231,0.538,26
credentials,-0.63,1,53,1,1,0.708,0.373,0.675,54
prosecute,-0.63,0,26,1,1,0.479,0.587,0.769,26
jockey,-0.63,0,26,1,1,0.562,0.644,0.703,26
shelters,-0.63,7,215,1,1,0.582,0.333,0.482,222
melon,-0.63,3,107,1,1,0.461,0.231,0.271,110
elicit,-0.63,0,26,1,1,0.406,0.594,0.658,26
arghh,-0.63,0,26,1,1,0.292,0.536,0.397,26
wiener,-0.63,1,53,1,1,0.594,0.434,0.391,54
motte,-0.63,0,26,1,1,0.481,0.389,0.37,26
steroid,-0.63,0,26,1,1,0.36,0.706,0.681,26
electron,-0.63,0,26,1,1,0.52,0.455,0.56,26
ministerial,-0.63,0,26,1,1,0.571,0.519,0.66,26
enema,-0.63,0,26,1,1,0.281,0.673,0.268,26
dimwit,-0.63,0,26,1,1,0.255,0.459,0.175,26
speculate,-0.63,1,53,1,1,0.398,0.602,0.553,54
patriot,-0.63,8,242,1,1,0.771,0.635,0.886,250
don,-0.631,5618,151836,1,1,0.646,0.454,0.702,157454
harry,-0.631,84,2296,1,1,0.52,0.409,0.39,2380
kicking,-0.632,50,1378,1,1,0.327,0.802,0.51,1428
congress,-0.632,23,648,1,1,0.449,0.444,0.857,671
fighting,-0.633,232,6311,1,1,0.292,0.885,0.783,6543
calling,-0.633,273,7422,1,1,0.646,0.59,0.483,7695
host,-0.634,48,1327,1,1,0.693,0.471,0.537,1375
telling,-0.635,331,9007,1,1,0.719,0.441,0.527,9338
democratic,-0.636,12,352,1,1,0.802,0.519,0.798,364
overthinking,-0.636,50,1384,1,1,0.408,0.761,0.525,1434
doctor,-0.636,84,2308,1,1,0.7,0.531,0.861,2392
gutter,-0.636,5,162,1,1,0.466,0.26,0.4,167
crushing,-0.637,110,3016,1,1,0.219,0.755,0.411,3126
skeleton,-0.637,10,298,1,1,0.183,0.464,0.343,308
fooled,-0.637,15,434,1,1,0.051,0.692,0.241,449
ad,-0.637,51,1413,1,1,0.521,0.705,0.558,1464
sweatshirt,-0.637,4,135,1,1,0.51,0.368,0.353,139
loan,-0.638,8,244,1,1,0.552,0.48,0.352,252
bones,-0.639,64,1769,1,1,0.281,0.343,0.358,1833
desperation,-0.639,71,1960,1,1,0.125,0.904,0.419,2031
outsider,-0.639,20,571,1,1,0.398,0.549,0.447,591
wonder,-0.639,702,19149,1,1,0.939,0.771,0.765,19851
diaper,-0.639,3,108,1,1,0.409,0.274,0.155,111
boomerang,-0.639,3,108,1,1,0.531,0.625,0.5,111
lobby,-0.639,11,326,1,1,0.625,0.427,0.472,337
uniform,-0.639,7,217,1,1,0.57,0.245,0.655,224
honey,-0.639,97,2670,1,1,0.92,0.431,0.51,2767
advertising,-0.64,10,299,1,1,0.622,0.608,0.632,309
allergic,-0.64,10,299,1,1,0.135,0.549,0.273,309
target,-0.64,45,1254,1,1,0.633,0.573,0.798,1299
unrequited,-0.641,13,381,1,1,0.143,0.441,0.179,394
woman,-0.641,897,24506,1,1,0.865,0.5,0.578,25403
fascist,-0.641,9,272,1,1,0.2,0.755,0.527,281
crotch,-0.642,2,81,1,1,0.521,0.637,0.447,83
deputy,-0.642,2,81,1,1,0.429,0.53,0.787,83
carnation,-0.642,2,81,1,1,0.653,0.357,0.431,83
delete,-0.643,69,1913,1,1,0.292,0.298,0.409,1982
hurtful,-0.643,16,464,1,1,0.104,0.68,0.463,480
failure,-0.643,134,3692,1,1,0.167,0.575,0.139,3826
satisfy,-0.644,34,957,1,1,0.867,0.79,0.705,991
moan,-0.644,12,355,1,1,0.357,0.735,0.352,367
sleep,-0.644,1196,32782,1,1,0.719,0.09,0.339,33978
whit,-0.645,4,136,1,1,0.562,0.393,0.595,140
member,-0.645,124,3426,1,1,0.698,0.333,0.555,3550
fed,-0.646,74,2056,1,1,0.602,0.37,0.482,2130
discouragement,-0.646,6,191,1,1,0.112,0.319,0.206,197
disgusted,-0.646,15,438,1,1,0.051,0.773,0.274,453
legit,-0.646,111,3073,1,1,0.747,0.427,0.849,3184
boss,-0.647,94,2607,1,1,0.31,0.627,0.954,2701
venom,-0.647,10,301,1,1,0.125,0.77,0.491,311
monkey,-0.647,21,603,1,1,0.548,0.449,0.283,624
row,-0.648,61,1703,1,1,0.427,0.275,0.406,1764
merry,-0.648,105,2913,1,1,0.979,0.731,0.764,3018
remind,-0.648,246,6790,1,1,0.721,0.415,0.563,7036
deport,-0.648,1,54,1,1,0.167,0.667,0.546,55
underpaid,-0.648,1,54,1,1,0.146,0.413,0.209,55
rub,-0.648,39,1099,1,1,0.521,0.565,0.4,1138
parliamentary,-0.648,1,54,1,1,0.49,0.554,0.755,55
steering,-0.648,1,54,1,1,0.58,0.431,0.66,55
dejected,-0.648,7,219,1,1,0.104,0.654,0.347,226
laughable,-0.648,5,164,1,1,0.592,0.627,0.298,169
kale,-0.648,1,54,1,1,0.469,0.226,0.411,55
corpus,-0.648,1,54,1,1,0.543,0.34,0.49,55
seizure,-0.648,1,54,1,1,0.177,0.775,0.462,55
rumor,-0.648,7,219,1,1,0.255,0.582,0.282,226
snowball,-0.648,1,54,1,1,0.717,0.444,0.321,55
decreasing,-0.648,3,109,1,1,0.32,0.346,0.224,112
chest,-0.649,128,3548,1,1,0.52,0.429,0.481,3676
anal,-0.649,20,577,1,1,0.333,0.798,0.334,597
wink,-0.65,12,357,1,1,0.688,0.557,0.304,369
hire,-0.65,19,550,1,1,0.688,0.558,0.556,569
turkey,-0.651,18,523,1,1,0.634,0.245,0.247,541
get,-0.651,9589,264504,1,1,0.74,0.594,0.667,274093
sadly,-0.652,113,3145,1,1,0.047,0.255,0.216,3258
griffin,-0.652,4,137,1,1,0.418,0.337,0.36,141
jukebox,-0.652,4,137,1,1,0.699,0.54,0.429,141
blame,-0.653,168,4669,1,1,0.115,0.64,0.309,4837
hot,-0.654,385,10674,1,1,0.49,0.74,0.573,11059
frailty,-0.654,2,82,1,1,0.385,0.4,0.218,84
beanie,-0.654,2,82,1,1,0.5,0.23,0.263,84
gnome,-0.654,2,82,1,1,0.429,0.479,0.38,84
infection,-0.654,5,165,1,1,0.083,0.735,0.407,170
loony,-0.654,2,82,1,1,0.439,0.474,0.295,84
intern,-0.654,5,165,1,1,0.459,0.46,0.392,170
extinct,-0.654,5,165,1,1,0.112,0.491,0.412,170
patriotic,-0.654,2,82,1,1,0.875,0.509,0.933,84
tally,-0.654,2,82,1,1,0.542,0.42,0.518,84
grad,-0.655,24,691,1,1,0.806,0.538,0.733,715
birthday,-0.655,431,11960,1,1,0.969,0.844,0.575,12391
replace,-0.655,51,1439,1,1,0.417,0.52,0.5,1490
era,-0.655,64,1799,1,1,0.615,0.407,0.449,1863
rhapsody,-0.656,9,276,1,1,0.708,0.49,0.46,285
bereaved,-0.656,6,193,1,1,0.104,0.479,0.221,199
manipulative,-0.657,14,415,1,1,0.177,0.724,0.546,429
controversy,-0.657,3,110,1,1,0.25,0.819,0.6,113
attacking,-0.657,27,776,1,1,0.276,0.837,0.642,803
blonde,-0.658,57,1609,1,1,0.698,0.545,0.412,1666
tier,-0.658,12,360,1,1,0.52,0.245,0.56,372
guts,-0.659,22,638,1,1,0.592,0.649,0.582,660
husband,-0.659,263,7339,1,1,0.771,0.5,0.655,7602
december,-0.659,137,3836,1,1,0.74,0.54,0.464,3973
suicide,-0.66,177,4953,1,1,0.03,0.873,0.429,5130
lucky,-0.661,225,6293,1,1,0.96,0.61,0.793,6518
flashback,-0.662,7,222,1,1,0.265,0.4,0.485,229
pension,-0.662,8,250,1,1,0.625,0.409,0.406,258
successful,-0.662,99,2788,1,1,0.949,0.724,0.938,2887
lego,-0.663,9,278,1,1,0.6,0.294,0.189,287
star,-0.663,318,8904,1,1,0.833,0.418,0.56,9222
goodbye,-0.664,175,4913,1,1,0.24,0.389,0.328,5088
bearable,-0.664,12,362,1,1,0.542,0.375,0.605,374
dusty,-0.664,25,725,1,1,0.406,0.294,0.255,750
racism,-0.664,27,781,1,1,0.122,0.673,0.487,808
deranged,-0.664,13,390,1,1,0.376,0.868,0.357,403
address,-0.664,69,1954,1,1,0.65,0.327,0.567,2023
goat,-0.665,37,1061,1,1,0.448,0.304,0.364,1098
fan,-0.665,260,7297,1,1,0.781,0.429,0.357,7557
click,-0.665,34,978,1,1,0.536,0.365,0.268,1012
fess,-0.666,0,27,1,1,0.395,0.42,0.37,27
intensify,-0.666,1,55,1,1,0.604,0.87,0.737,56
dental,-0.666,3,111,1,1,0.573,0.404,0.463,114
subservient,-0.666,0,27,1,1,0.255,0.402,0.339,27
biceps,-0.666,0,27,1,1,0.592,0.588,0.602,27
capitalize,-0.666,2,83,1,1,0.771,0.601,0.885,85
skunk,-0.666,1,55,1,1,0.284,0.491,0.38,56
audition,-0.666,3,111,1,1,0.75,0.685,0.615,114
succulent,-0.666,1,55,1,1,0.823,0.538,0.556,56
spat,-0.666,2,83,1,1,0.427,0.413,0.309,85
jig,-0.666,0,27,1,1,0.531,0.396,0.357,27
crayon,-0.666,2,83,1,1,0.604,0.26,0.185,85
hobo,-0.666,5,167,1,1,0.323,0.443,0.282,172
hydrogen,-0.666,0,27,1,1,0.469,0.303,0.554,27
soprano,-0.666,0,27,1,1,0.552,0.55,0.685,27
gawk,-0.666,0,27,1,1,0.333,0.472,0.434,27
whine,-0.666,21,615,1,1,0.342,0.686,0.218,636
bashful,-0.666,0,27,1,1,0.4,0.406,0.217,27
prowl,-0.666,1,55,1,1,0.312,0.542,0.396,56
discredit,-0.666,2,83,1,1,0.075,0.529,0.355,85
sleazy,-0.666,1,55,1,1,0.292,0.674,0.37,56
zit,-0.666,0,27,1,1,0.337,0.41,0.381,27
consenting,-0.666,1,55,1,1,0.727,0.406,0.693,56
dumbasses,-0.666,4,139,1,1,0.316,0.59,0.363,143
turnout,-0.666,1,55,1,1,0.641,0.692,0.898,56
shroud,-0.666,7,223,1,1,0.417,0.457,0.389,230
ohno,-0.666,0,27,1,1,0.396,0.475,0.38,27
fixable,-0.666,0,27,1,1,0.724,0.47,0.645,27
pho,-0.666,2,83,1,1,0.541,0.37,0.384,85
disgruntled,-0.666,2,83,1,1,0.104,0.658,0.442,85
gymnastics,-0.666,1,55,1,1,0.745,0.677,0.508,56
spud,-0.666,0,27,1,1,0.403,0.423,0.349,27
dodgy,-0.666,2,83,1,1,0.281,0.51,0.254,85
chug,-0.666,1,55,1,1,0.401,0.413,0.358,56
flagging,-0.666,0,27,1,1,0.521,0.519,0.509,27
yayyy,-0.666,1,55,1,1,0.602,0.7,0.381,56
metric,-0.666,1,55,1,1,0.519,0.248,0.573,56
robot,-0.666,58,1651,1,1,0.441,0.337,0.543,1709
cocksucker,-0.666,0,27,1,1,0.083,0.764,0.339,27
cuckold,-0.666,1,55,1,1,0.21,0.573,0.23,56
unwrap,-0.666,0,27,1,1,0.604,0.491,0.557,27
landfill,-0.666,0,27,1,1,0.398,0.423,0.324,27
genetics,-0.666,1,55,1,1,0.552,0.46,0.574,56
cough,-0.666,19,559,1,1,0.255,0.627,0.241,578
fill,-0.669,358,10073,1,1,0.729,0.449,0.637,10431
missing,-0.669,532,14958,1,1,0.306,0.418,0.222,15490
rap,-0.669,42,1206,1,1,0.604,0.575,0.464,1248
video,-0.669,489,13759,1,1,0.646,0.577,0.427,14248
sadness,-0.669,689,19378,1,1,0.052,0.288,0.164,20067
psych,-0.67,10,308,1,1,0.48,0.5,0.526,318
unmarried,-0.67,9,280,1,1,0.438,0.48,0.545,289
audacity,-0.67,18,533,1,1,0.76,0.755,0.916,551
sexual,-0.671,111,3148,1,1,0.584,0.959,0.64,3259
town,-0.671,381,10740,1,1,0.551,0.299,0.627,11121
support,-0.671,632,17800,1,1,0.811,0.472,0.737,18432
obsessing,-0.671,7,224,1,1,0.173,0.773,0.698,231
swap,-0.672,6,196,1,1,0.552,0.5,0.509,202
illness,-0.672,137,3884,1,1,0.098,0.717,0.211,4021
heartbeat,-0.672,37,1069,1,1,0.75,0.698,0.585,1106
rink,-0.672,5,168,1,1,0.551,0.392,0.392,173
die,-0.672,1075,30307,1,1,0.031,0.765,0.259,31382
stereotype,-0.674,9,281,1,1,0.151,0.422,0.612,290
suitcase,-0.674,4,140,1,1,0.562,0.212,0.318,144
xanax,-0.674,4,140,1,1,0.427,0.402,0.446,144
lazy,-0.674,93,2651,1,1,0.392,0.264,0.096,2744
dude,-0.674,429,12132,1,1,0.809,0.356,0.615,12561
brunette,-0.675,12,366,1,1,0.802,0.528,0.529,378
retail,-0.675,20,592,1,1,0.51,0.353,0.411,612
follow,-0.675,558,15789,1,1,0.667,0.509,0.6,16347
hop,-0.676,44,1271,1,1,0.45,0.52,0.427,1315
snowman,-0.677,6,197,1,1,0.776,0.291,0.323,203
low,-0.678,333,9461,1,1,0.292,0.22,0.102,9794
mince,-0.678,2,84,1,1,0.417,0.529,0.378,86
swag,-0.678,5,169,1,1,0.656,0.676,0.654,174
sociopath,-0.678,8,254,1,1,0.104,0.863,0.439,262
smiled,-0.678,52,1501,1,1,0.949,0.53,0.536,1553
weak,-0.679,219,6234,1,1,0.18,0.241,0.045,6453
senator,-0.679,13,396,1,1,0.391,0.422,0.821,409
mono,-0.679,35,1020,1,1,0.5,0.39,0.273,1055
police,-0.68,72,2070,1,1,0.458,0.77,0.83,2142
healthcare,-0.682,13,397,1,1,0.78,0.392,0.63,410
egg,-0.682,31,909,1,1,0.684,0.241,0.293,940
alienated,-0.682,24,710,1,1,0.41,0.423,0.559,734
relationship,-0.682,1063,30273,1,1,0.867,0.566,0.589,31336
underlying,-0.683,10,312,1,1,0.48,0.445,0.452,322
worse,-0.683,403,11495,1,1,0.062,0.704,0.225,11898
died,-0.683,275,7853,1,1,0.021,0.65,0.327,8128
disorder,-0.683,34,995,1,1,0.115,0.816,0.218,1029
projecting,-0.683,24,711,1,1,0.635,0.564,0.786,735
stoopid,-0.684,3,113,1,1,0.28,0.431,0.382,116
priesthood,-0.684,1,56,1,1,0.622,0.304,0.649,57
proportions,-0.684,1,56,1,1,0.625,0.43,0.5,57
walrus,-0.684,1,56,1,1,0.521,0.327,0.361,57
scrabble,-0.684,1,56,1,1,0.625,0.412,0.399,57
fooling,-0.684,7,227,1,1,0.167,0.755,0.384,234
painfully,-0.685,36,1054,1,1,0.156,0.72,0.407,1090
forget,-0.686,642,18351,1,1,0.312,0.382,0.209,18993
sister,-0.686,327,9367,1,1,0.916,0.324,0.562,9694
wrenching,-0.687,6,199,1,1,0.204,0.833,0.483,205
donation,-0.687,6,199,1,1,0.792,0.398,0.602,205
wit,-0.687,156,4486,1,1,0.844,0.484,0.775,4642
platonic,-0.687,21,628,1,1,0.49,0.461,0.469,649
operator,-0.688,4,142,1,1,0.612,0.63,0.726,146
dollar,-0.688,24,714,1,1,0.755,0.632,0.694,738
rating,-0.689,7,228,1,1,0.663,0.679,0.637,235
know,-0.689,7804,223511,1,1,0.765,0.361,0.704,231315
generation,-0.689,96,2778,1,1,0.903,0.48,0.685,2874
buy,-0.689,362,10400,1,1,0.771,0.769,0.612,10762
repulsive,-0.69,5,171,1,1,0.146,0.775,0.425,176
copying,-0.69,2,85,1,1,0.448,0.315,0.404,87
limp,-0.69,5,171,1,1,0.393,0.44,0.172,176
contaminated,-0.69,2,85,1,1,0.04,0.5,0.368,87
tiredness,-0.691,16,487,1,1,0.387,0.408,0.242,503
chemical,-0.692,10,315,1,1,0.337,0.56,0.508,325
cub,-0.693,3,114,1,1,0.646,0.382,0.284,117
detention,-0.693,3,114,1,1,0.265,0.698,0.562,117
divert,-0.693,3,114,1,1,0.344,0.622,0.407,117
goof,-0.693,3,114,1,1,0.448,0.49,0.272,117
header,-0.693,7,229,1,1,0.56,0.398,0.74,236
awful,-0.694,158,4574,1,1,0.061,0.786,0.45,4732
wish,-0.694,1602,46159,1,1,0.771,0.583,0.647,47761
promotion,-0.695,9,287,1,1,0.906,0.755,0.769,296
freelancer,-0.695,4,143,1,1,0.614,0.564,0.553,147
industry,-0.695,45,1324,1,1,0.65,0.447,0.836,1369
anxiety,-0.695,608,17544,1,1,0.146,0.865,0.342,18152
lyrics,-0.696,176,5103,1,1,0.582,0.214,0.333,5279
correlation,-0.698,9,288,1,1,0.596,0.462,0.571,297
admit,-0.698,180,5230,1,1,0.538,0.423,0.667,5410
respond,-0.699,93,2719,1,1,0.573,0.435,0.594,2812
fox,-0.7,57,1679,1,1,0.323,0.555,0.491,1736
stool,-0.702,3,115,1,1,0.448,0.269,0.302,118
pacifier,-0.702,0,28,1,1,0.615,0.342,0.356,28
irked,-0.702,0,28,1,1,0.164,0.791,0.353,28
godbless,-0.702,1,57,1,1,0.823,0.395,0.588,58
buildup,-0.702,0,28,1,1,0.49,0.509,0.623,28
fjord,-0.702,0,28,1,1,0.51,0.404,0.463,28
handout,-0.702,1,57,1,1,0.56,0.33,0.545,58
deplorable,-0.702,3,115,1,1,0.135,0.657,0.23,118
effeminate,-0.702,0,28,1,1,0.337,0.619,0.291,28
furiously,-0.702,2,86,1,1,0.062,0.925,0.657,88
trombone,-0.702,0,28,1,1,0.562,0.5,0.5,28
earring,-0.702,1,57,1,1,0.583,0.52,0.5,58
fireball,-0.702,0,28,1,1,0.302,0.777,0.664,28
spinner,-0.702,0,28,1,1,0.458,0.593,0.471,28
armory,-0.702,0,28,1,1,0.448,0.663,0.8,28
prejudiced,-0.702,0,28,1,1,0.235,0.625,0.345,28
lml,-0.702,1,57,1,1,0.448,0.519,0.385,58
mitigating,-0.702,0,28,1,1,0.551,0.52,0.6,28
gimmick,-0.702,1,57,1,1,0.38,0.663,0.519,58
flick,-0.702,5,173,1,1,0.688,0.541,0.515,178
midget,-0.702,2,86,1,1,0.396,0.295,0.254,88
hedgehog,-0.702,5,173,1,1,0.458,0.491,0.377,178
derelict,-0.702,0,28,1,1,0.208,0.47,0.237,28
wacko,-0.702,0,28,1,1,0.271,0.574,0.33,28
slob,-0.702,2,86,1,1,0.275,0.365,0.3,88
cornbread,-0.702,0,28,1,1,0.643,0.304,0.302,28
hypertension,-0.702,0,28,1,1,0.133,0.784,0.427,28
loophole,-0.702,0,28,1,1,0.406,0.755,0.491,28
prawn,-0.702,0,28,1,1,0.488,0.324,0.39,28
deployment,-0.702,4,144,1,1,0.51,0.52,0.612,148
egomaniac,-0.702,0,28,1,1,0.133,0.708,0.596,28
chewy,-0.702,0,28,1,1,0.625,0.418,0.39,28
prostate,-0.702,0,28,1,1,0.323,0.51,0.438,28
mate,-0.702,165,4814,1,1,0.847,0.417,0.669,4979
bio,-0.703,55,1625,1,1,0.612,0.225,0.49,1680
trash,-0.703,137,4007,1,1,0.163,0.541,0.154,4144
narcissistic,-0.703,19,580,1,1,0.323,0.708,0.655,599
tan,-0.704,13,406,1,1,0.643,0.46,0.444,419
upload,-0.704,12,377,1,1,0.638,0.683,0.696,389
funds,-0.705,10,319,1,1,0.633,0.33,0.461,329
dork,-0.705,8,261,1,1,0.272,0.519,0.361,269
outrage,-0.705,8,261,1,1,0.06,0.689,0.542,269
cocaine,-0.706,7,232,1,1,0.156,0.84,0.373,239
play,-0.706,1037,30245,1,1,0.812,0.765,0.358,31282
parade,-0.708,16,495,1,1,0.792,0.685,0.509,511
report,-0.708,64,1896,1,1,0.583,0.444,0.575,1960
unhappiness,-0.708,24,729,1,1,0.083,0.63,0.222,753
smile,-0.709,553,16190,1,1,0.906,0.598,0.618,16743
vest,-0.71,3,116,1,1,0.667,0.38,0.371,119
gasoline,-0.71,3,116,1,1,0.417,0.562,0.519,119
rib,-0.71,7,233,1,1,0.49,0.349,0.351,240
shout,-0.71,79,2339,1,1,0.229,0.925,0.444,2418
poppy,-0.711,6,204,1,1,0.635,0.392,0.357,210
defender,-0.711,6,204,1,1,0.639,0.708,0.75,210
festive,-0.711,27,819,1,1,0.854,0.74,0.764,846
targeted,-0.712,9,292,1,1,0.573,0.537,0.573,301
pity,-0.713,119,3518,1,1,0.16,0.398,0.114,3637
password,-0.713,5,175,1,1,0.39,0.356,0.559,180
flexin,-0.713,2,87,1,1,0.552,0.559,0.366,89
goalie,-0.713,2,87,1,1,0.573,0.389,0.455,89
jab,-0.713,2,87,1,1,0.385,0.519,0.482,89
spike,-0.715,9,293,1,1,0.382,0.51,0.408,302
submarine,-0.715,4,146,1,1,0.572,0.481,0.549,150
heheh,-0.715,4,146,1,1,0.625,0.51,0.278,150
stop,-0.715,1389,40866,1,1,0.28,0.51,0.49,42255
together,-0.716,1154,33970,1,1,0.874,0.392,0.658,35124
worry,-0.716,409,12066,1,1,0.245,0.776,0.267,12475
redneck,-0.719,3,117,1,1,0.401,0.5,0.348,120
gingerbread,-0.719,1,58,1,1,0.597,0.333,0.264,59
succeeding,-0.719,3,117,1,1,0.867,0.755,0.849,120
homicidal,-0.719,1,58,1,1,0.02,0.912,0.573,59
panty,-0.719,1,58,1,1,0.451,0.557,0.303,59
compilation,-0.719,9,294,1,1,0.53,0.512,0.606,303
whack,-0.719,9,294,1,1,0.219,0.816,0.708,303
tuning,-0.719,9,294,1,1,0.719,0.39,0.635,303
ethnic,-0.719,3,117,1,1,0.583,0.373,0.555,120
congressional,-0.719,1,58,1,1,0.552,0.491,0.848,59
street,-0.719,201,5962,1,1,0.594,0.324,0.398,6163
narcissist,-0.72,14,442,1,1,0.173,0.614,0.629,456
male,-0.72,146,4341,1,1,0.612,0.532,0.695,4487
rapist,-0.72,8,265,1,1,0.062,0.906,0.571,273
daisy,-0.721,11,354,1,1,0.562,0.367,0.333,365
billion,-0.723,41,1244,1,1,0.719,0.564,0.782,1285
bullet,-0.724,16,503,1,1,0.408,0.794,0.634,519
defending,-0.724,19,592,1,1,0.604,0.871,0.812,611
deceived,-0.724,5,177,1,1,0.059,0.673,0.302,182
cloud,-0.724,110,3292,1,1,0.74,0.133,0.342,3402
unclear,-0.724,2,88,1,1,0.229,0.463,0.202,90
skater,-0.724,2,88,1,1,0.633,0.774,0.652,90
grrr,-0.724,2,88,1,1,0.271,0.755,0.327,90
chemo,-0.724,2,88,1,1,0.214,0.686,0.444,90
eligible,-0.724,2,88,1,1,0.75,0.4,0.518,90
chief,-0.725,33,1008,1,1,0.52,0.544,0.869,1041
unsafe,-0.727,7,237,1,1,0.115,0.562,0.147,244
poof,-0.727,3,118,1,1,0.469,0.387,0.21,121
chase,-0.728,63,1904,1,1,0.396,0.878,0.623,1967
number,-0.728,262,7828,1,1,0.406,0.231,0.471,8090
premium,-0.729,19,595,1,1,0.786,0.59,0.769,614
deprived,-0.73,37,1133,1,1,0.354,0.506,0.536,1170
stunt,-0.731,7,238,1,1,0.387,0.555,0.526,245
survey,-0.731,16,507,1,1,0.58,0.357,0.379,523
ranting,-0.732,18,567,1,1,0.181,0.755,0.5,585
hurt,-0.732,680,20362,1,1,0.062,0.773,0.291,21042
ignore,-0.732,181,5442,1,1,0.146,0.23,0.295,5623
rep,-0.733,11,358,1,1,0.52,0.51,0.64,369
talented,-0.733,37,1136,1,1,0.939,0.635,0.938,1173
awake,-0.733,187,5627,1,1,0.667,0.469,0.741,5814
dugout,-0.735,0,29,1,1,0.49,0.37,0.463,29
bimbo,-0.735,1,59,1,1,0.396,0.37,0.3,60
scat,-0.735,0,29,1,1,0.337,0.548,0.409,29
yaay,-0.735,0,29,1,1,0.604,0.575,0.327,29
voter,-0.735,4,149,1,1,0.612,0.538,0.754,153
exacerbate,-0.735,2,89,1,1,0.323,0.776,0.58,91
sausage,-0.735,9,299,1,1,0.542,0.429,0.3,308
accompany,-0.735,77,2339,1,1,0.833,0.406,0.585,2416
shilling,-0.735,0,29,1,1,0.521,0.342,0.43,29
simulator,-0.735,2,89,1,1,0.677,0.559,0.583,91
hornet,-0.735,0,29,1,1,0.398,0.594,0.5,29
lint,-0.735,0,29,1,1,0.388,0.173,0.214,29
uncontrolled,-0.735,0,29,1,1,0.188,0.891,0.544,29
braces,-0.735,1,59,1,1,0.5,0.337,0.568,60
sill,-0.735,1,59,1,1,0.433,0.375,0.324,60
genocide,-0.735,4,149,1,1,0.02,0.878,0.627,153
mouthpiece,-0.735,0,29,1,1,0.573,0.346,0.393,29
pharmaceutical,-0.735,0,29,1,1,0.5,0.435,0.562,29
sufferer,-0.735,2,89,1,1,0.156,0.69,0.278,91
harmonica,-0.735,1,59,1,1,0.847,0.235,0.51,60
nibble,-0.735,0,29,1,1,0.551,0.551,0.411,29
jailbreak,-0.735,0,29,1,1,0.354,0.629,0.471,29
tyre,-0.735,0,29,1,1,0.48,0.358,0.407,29
slider,-0.735,0,29,1,1,0.585,0.491,0.518,29
fluke,-0.735,0,29,1,1,0.446,0.45,0.432,29
chopper,-0.735,0,29,1,1,0.594,0.56,0.509,29
sturgeon,-0.735,0,29,1,1,0.417,0.473,0.465,29
yuletide,-0.735,0,29,1,1,0.438,0.43,0.445,29
dizziness,-0.735,0,29,1,1,0.229,0.555,0.254,29
veronica,-0.735,4,149,1,1,0.594,0.399,0.402,153
legitimacy,-0.735,0,29,1,1,0.823,0.42,0.855,29
sheepish,-0.735,0,29,1,1,0.326,0.441,0.205,29
yaw,-0.735,2,89,1,1,0.586,0.592,0.491,91
lady,-0.737,335,10096,1,1,0.854,0.481,0.602,10431
popular,-0.737,120,3636,1,1,0.88,0.676,0.731,3756
acting,-0.738,138,4179,1,1,0.698,0.643,0.5,4317
masculinity,-0.738,12,390,1,1,0.583,0.67,0.851,402
sexuality,-0.738,24,751,1,1,0.67,0.898,0.657,775
wealthy,-0.738,23,721,1,1,0.927,0.566,0.862,744
supported,-0.739,33,1023,1,1,0.853,0.408,0.613,1056
funny,-0.74,424,12807,1,1,0.918,0.61,0.566,13231
scoop,-0.74,6,210,1,1,0.583,0.543,0.64,216
pop,-0.741,112,3407,1,1,0.673,0.51,0.491,3519
bottom,-0.741,142,4312,1,1,0.417,0.37,0.291,4454
landlord,-0.741,5,180,1,1,0.684,0.5,0.858,185
immigrant,-0.741,10,331,1,1,0.357,0.663,0.509,341
dorm,-0.742,53,1629,1,1,0.719,0.194,0.327,1682
vegan,-0.742,24,754,1,1,0.49,0.226,0.357,778
hunger,-0.744,76,2328,1,1,0.083,0.554,0.328,2404
kicker,-0.744,3,120,1,1,0.427,0.711,0.614,123
squid,-0.744,3,120,1,1,0.497,0.398,0.357,123
pug,-0.744,3,120,1,1,0.6,0.298,0.462,123
liberal,-0.744,49,1512,1,1,0.565,0.565,0.755,1561
bday,-0.744,47,1452,1,1,0.729,0.6,0.415,1499
psalm,-0.745,34,1059,1,1,0.688,0.224,0.557,1093
brat,-0.746,12,393,1,1,0.312,0.44,0.231,405
butt,-0.746,45,1394,1,1,0.347,0.725,0.336,1439
duckling,-0.746,2,90,1,1,0.602,0.353,0.263,92
cold,-0.748,1133,34437,1,1,0.398,0.538,0.348,35570
china,-0.749,32,1003,1,1,0.561,0.443,0.556,1035
isolated,-0.75,354,10801,1,1,0.221,0.356,0.255,11155
automatic,-0.75,6,212,1,1,0.562,0.433,0.664,218
nickname,-0.75,8,273,1,1,0.49,0.47,0.263,281
discouraged,-0.75,19,608,1,1,0.22,0.304,0.09,627
heck,-0.752,64,1981,1,1,0.24,0.728,0.56,2045
geriatric,-0.752,1,60,1,1,0.479,0.247,0.436,61
taxpayer,-0.752,1,60,1,1,0.592,0.528,0.647,61
mir,-0.752,1,60,1,1,0.417,0.339,0.355,61
squeeze,-0.752,13,426,1,1,0.458,0.676,0.532,439
patronising,-0.752,1,60,1,1,0.439,0.455,0.582,61
quell,-0.752,3,121,1,1,0.388,0.696,0.434,124
picket,-0.752,1,60,1,1,0.365,0.615,0.451,61
giraffe,-0.752,3,121,1,1,0.561,0.347,0.436,124
elementary,-0.753,12,396,1,1,0.594,0.286,0.686,408
woof,-0.755,4,152,1,1,0.354,0.509,0.404,156
bald,-0.757,16,520,1,1,0.306,0.184,0.268,536
astonishing,-0.757,22,704,1,1,0.844,0.802,0.821,726
referendum,-0.757,2,91,1,1,0.51,0.469,0.643,93
advertisement,-0.757,2,91,1,1,0.6,0.566,0.539,93
diagnose,-0.757,2,91,1,1,0.378,0.52,0.714,93
logo,-0.757,20,643,1,1,0.469,0.296,0.565,663
warm,-0.76,432,13312,1,1,0.76,0.312,0.585,13744
orgy,-0.76,7,245,1,1,0.346,0.962,0.536,252
shoot,-0.761,84,2616,1,1,0.092,0.926,0.625,2700
ring,-0.762,102,3171,1,1,0.677,0.427,0.464,3273
provider,-0.762,4,153,1,1,0.751,0.494,0.75,157
orphan,-0.763,19,616,1,1,0.133,0.388,0.14,635
microwave,-0.764,6,215,1,1,0.542,0.497,0.443,221
intoxicated,-0.764,6,215,1,1,0.079,0.824,0.246,221
notch,-0.764,6,215,1,1,0.459,0.361,0.358,221
chuck,-0.765,17,555,1,1,0.542,0.509,0.413,572
suddenly,-0.765,266,8248,1,1,0.67,0.51,0.456,8514
scariest,-0.765,9,308,1,1,0.167,0.863,0.538,317
heartache,-0.766,51,1607,1,1,0.088,0.75,0.291,1658
petty,-0.766,39,1236,1,1,0.21,0.537,0.236,1275
duck,-0.767,27,866,1,1,0.594,0.337,0.236,893
joke,-0.768,187,5824,1,1,0.704,0.61,0.316,6011
forefront,-0.768,1,61,1,1,0.573,0.559,0.811,62
catchy,-0.768,6,216,1,1,0.677,0.441,0.462,222
pixie,-0.768,2,92,1,1,0.562,0.537,0.325,94
tambourine,-0.768,0,30,1,1,0.622,0.548,0.348,30
refugee,-0.768,10,340,1,1,0.379,0.607,0.327,350
reschedule,-0.768,0,30,1,1,0.438,0.422,0.537,30
oat,-0.768,0,30,1,1,0.622,0.17,0.298,30
blazer,-0.768,0,30,1,1,0.635,0.385,0.417,30
hight,-0.768,0,30,1,1,0.667,0.637,0.645,30
periscope,-0.768,1,61,1,1,0.604,0.375,0.609,62
shrew,-0.768,1,61,1,1,0.306,0.463,0.39,62
erotic,-0.768,13,433,1,1,0.625,0.946,0.683,446
weasel,-0.768,3,123,1,1,0.408,0.317,0.337,126
disability,-0.768,19,619,1,1,0.073,0.482,0.173,638
bullpen,-0.768,0,30,1,1,0.48,0.549,0.5,30
dignify,-0.768,0,30,1,1,0.854,0.588,0.735,30
sneaky,-0.768,5,185,1,1,0.24,0.74,0.56,190
kanji,-0.768,0,30,1,1,0.51,0.413,0.425,30
consensus,-0.768,2,92,1,1,0.627,0.358,0.625,94
jacks,-0.768,2,92,1,1,0.49,0.4,0.505,94
impersonate,-0.768,0,30,1,1,0.51,0.632,0.591,30
caucus,-0.768,1,61,1,1,0.418,0.311,0.491,62
saggy,-0.768,1,61,1,1,0.37,0.429,0.3,62
patronizing,-0.768,0,30,1,1,0.542,0.365,0.529,30
gage,-0.768,0,30,1,1,0.552,0.451,0.473,30
bridesmaid,-0.768,0,30,1,1,0.748,0.519,0.618,30
compute,-0.768,0,30,1,1,0.531,0.408,0.564,30
dried,-0.768,10,340,1,1,0.427,0.26,0.385,350
spy,-0.768,13,433,1,1,0.26,0.686,0.53,446
overdose,-0.77,15,496,1,1,0.11,0.82,0.468,511
old,-0.771,1649,51308,1,1,0.41,0.279,0.315,52957
hallmark,-0.772,8,279,1,1,0.646,0.315,0.411,287
grade,-0.772,56,1773,1,1,0.698,0.36,0.6,1829
heroin,-0.774,5,186,1,1,0.276,0.843,0.655,191
backup,-0.774,10,342,1,1,0.52,0.51,0.553,352
strap,-0.775,4,155,1,1,0.38,0.417,0.382,159
freestyle,-0.775,4,155,1,1,0.765,0.652,0.52,159
tramp,-0.775,4,155,1,1,0.108,0.51,0.182,159
call,-0.775,1243,38816,1,1,0.594,0.627,0.558,40059
smoking,-0.775,128,4027,1,1,0.176,0.557,0.384,4155
frat,-0.776,3,124,1,1,0.714,0.371,0.726,127
spiteful,-0.776,7,249,1,1,0.073,0.71,0.33,256
interested,-0.777,221,6943,1,1,0.75,0.529,0.725,7164
lump,-0.777,6,218,1,1,0.438,0.337,0.463,224
homecoming,-0.778,9,312,1,1,0.76,0.413,0.472,321
tease,-0.778,12,406,1,1,0.317,0.79,0.432,418
rejected,-0.778,66,2097,1,1,0.102,0.48,0.25,2163
shocker,-0.779,2,93,1,1,0.235,0.804,0.616,95
maternity,-0.779,5,187,1,1,0.865,0.48,0.622,192
wake,-0.779,329,10339,1,1,0.7,0.47,0.512,10668
anytime,-0.78,94,2978,1,1,0.625,0.461,0.436,3072
comment,-0.78,120,3794,1,1,0.667,0.417,0.379,3914
sticker,-0.782,6,219,1,1,0.583,0.306,0.346,225
hell,-0.782,704,22159,1,1,0.02,0.918,0.565,22863
yay,-0.783,66,2107,1,1,0.694,0.575,0.345,2173
participant,-0.784,1,62,1,1,0.712,0.598,0.613,63
choosy,-0.784,7,251,1,1,0.28,0.76,0.712,258
certificate,-0.784,1,62,1,1,0.786,0.377,0.746,63
spew,-0.784,7,251,1,1,0.26,0.651,0.573,258
harem,-0.784,3,125,1,1,0.521,0.578,0.582,128
leave,-0.785,2048,64576,1,1,0.375,0.315,0.295,66624
help,-0.785,1833,57805,1,1,0.673,0.471,0.46,59638
bipolar,-0.785,14,472,1,1,0.208,0.685,0.426,486
waist,-0.786,10,346,1,1,0.542,0.448,0.351,356
adulthood,-0.786,43,1388,1,1,0.541,0.454,0.652,1431
literally,-0.787,861,27225,1,1,0.571,0.353,0.673,28086
graduation,-0.787,16,536,1,1,0.88,0.67,0.837,552
extremely,-0.788,272,8630,1,1,0.635,0.827,0.886,8902
redhead,-0.788,12,410,1,1,0.677,0.549,0.518,422
boxer,-0.789,2,94,1,1,0.49,0.81,0.802,96
lecturer,-0.789,2,94,1,1,0.677,0.549,0.736,96
snuggled,-0.789,5,189,1,1,0.552,0.439,0.314,194
mushroom,-0.789,5,189,1,1,0.49,0.274,0.269,194
kinky,-0.791,9,316,1,1,0.449,0.558,0.361,325
hourglass,-0.792,3,126,1,1,0.542,0.284,0.492,129
cohort,-0.792,3,126,1,1,0.459,0.551,0.566,129
speck,-0.793,8,285,1,1,0.418,0.245,0.343,293
carrot,-0.794,4,158,1,1,0.5,0.235,0.279,162
rip,-0.794,92,2957,1,1,0.146,0.676,0.365,3049
slutty,-0.795,5,190,1,1,0.224,0.81,0.371,195
whistle,-0.797,10,350,1,1,0.653,0.551,0.463,360
bud,-0.798,26,861,1,1,0.46,0.402,0.333,887
sou,-0.8,3,127,1,1,0.48,0.39,0.412,130
bate,-0.8,0,31,1,1,0.429,0.525,0.464,31
brag,-0.8,15,511,1,1,0.347,0.545,0.578,526
disown,-0.8,2,95,1,1,0.153,0.637,0.368,97
aroused,-0.8,1,63,1,1,0.708,0.952,0.667,64
neural,-0.8,0,31,1,1,0.582,0.426,0.391,31
pang,-0.8,7,255,1,1,0.146,0.595,0.455,262
goodies,-0.8,2,95,1,1,0.95,0.622,0.424,97
gaiety,-0.8,0,31,1,1,0.854,0.759,0.72,31
coke,-0.8,14,479,1,1,0.404,0.461,0.397,493
bloodstream,-0.8,0,31,1,1,0.552,0.53,0.528,31
feller,-0.8,0,31,1,1,0.406,0.622,0.617,31
kissy,-0.8,0,31,1,1,0.874,0.684,0.402,31
meatloaf,-0.8,0,31,1,1,0.625,0.389,0.375,31
coon,-0.8,1,63,1,1,0.49,0.46,0.4,64
granddaughter,-0.8,2,95,1,1,0.823,0.445,0.389,97
toothless,-0.8,2,95,1,1,0.312,0.541,0.272,97
discharge,-0.8,1,63,1,1,0.427,0.538,0.578,64
packet,-0.8,2,95,1,1,0.582,0.385,0.407,97
gout,-0.8,0,31,1,1,0.354,0.314,0.17,31
sniff,-0.8,7,255,1,1,0.396,0.5,0.318,262
omniscient,-0.8,0,31,1,1,0.656,0.334,0.778,31
cavalry,-0.8,0,31,1,1,0.667,0.727,0.794,31
autocorrect,-0.8,3,127,1,1,0.551,0.439,0.616,130
contention,-0.8,0,31,1,1,0.375,0.51,0.738,31
swear,-0.8,230,7392,1,1,0.601,0.577,0.658,7622
wan,-0.802,17,576,1,1,0.384,0.457,0.31,593
compensate,-0.802,12,416,1,1,0.612,0.429,0.762,428
singing,-0.804,194,6267,1,1,0.885,0.594,0.528,6461
message,-0.805,284,9162,1,1,0.65,0.391,0.415,9446
specially,-0.806,31,1029,1,1,0.847,0.398,0.714,1060
wallpaper,-0.806,4,160,1,1,0.673,0.173,0.308,164
jeans,-0.807,8,289,1,1,0.622,0.324,0.371,297
lingerie,-0.807,8,289,1,1,0.543,0.463,0.308,297
supporting,-0.808,68,2224,1,1,0.634,0.49,0.764,2292
hacker,-0.808,3,128,1,1,0.271,0.755,0.74,131
misguided,-0.809,9,322,1,1,0.28,0.531,0.259,331
id,-0.81,106,3456,1,1,0.449,0.344,0.391,3562
mega,-0.81,15,516,1,1,0.724,0.538,0.723,531
clown,-0.81,47,1551,1,1,0.65,0.598,0.3,1598
noob,-0.81,2,96,1,1,0.417,0.43,0.267,98
disposable,-0.81,5,193,1,1,0.271,0.439,0.25,198
driver,-0.811,55,1810,1,1,0.553,0.538,0.637,1865
military,-0.812,47,1553,1,1,0.396,0.71,0.875,1600
female,-0.812,164,5343,1,1,0.857,0.52,0.625,5507
lass,-0.812,4,161,1,1,0.656,0.536,0.433,165
nerd,-0.813,40,1328,1,1,0.408,0.481,0.315,1368
puppet,-0.813,20,680,1,1,0.459,0.433,0.298,700
string,-0.814,19,648,1,1,0.385,0.398,0.445,667
nerdy,-0.814,10,356,1,1,0.296,0.255,0.292,366
show,-0.815,998,32447,1,1,0.673,0.771,0.719,33445
geezer,-0.815,1,64,1,1,0.458,0.374,0.414,65
inflatable,-0.815,1,64,1,1,0.51,0.51,0.4,65
vogue,-0.815,1,64,1,1,0.74,0.491,0.538,65
peachy,-0.815,1,64,1,1,0.755,0.479,0.388,65
millionth,-0.815,1,64,1,1,0.635,0.528,0.611,65
senior,-0.815,53,1754,1,1,0.561,0.415,0.536,1807
attractive,-0.817,60,1985,1,1,0.906,0.63,0.769,2045
inappropriate,-0.819,7,260,1,1,0.135,0.542,0.353,267
offset,-0.821,5,195,1,1,0.719,0.394,0.704,200
rich,-0.821,237,7774,1,1,0.882,0.627,0.905,8011
asap,-0.821,50,1666,1,1,0.571,0.5,0.552,1716
alcoholic,-0.821,25,849,1,1,0.153,0.688,0.361,874
join,-0.823,386,12673,1,1,0.729,0.479,0.684,13059
moronic,-0.823,3,130,1,1,0.122,0.5,0.224,133
pretty,-0.825,1036,34017,1,1,0.875,0.516,0.561,35053
goodmorning,-0.827,7,262,1,1,0.922,0.461,0.552,269
incase,-0.828,10,361,1,1,0.58,0.196,0.365,371
clever,-0.829,16,559,1,1,0.896,0.353,0.729,575
frog,-0.831,20,692,1,1,0.439,0.311,0.15,712
otto,-0.831,0,32,1,1,0.427,0.425,0.404,32
senorita,-0.831,0,32,1,1,0.765,0.55,0.5,32
piggy,-0.831,4,164,1,1,0.541,0.365,0.412,168
swimsuit,-0.831,0,32,1,1,0.74,0.373,0.269,32
repellent,-0.831,0,32,1,1,0.286,0.5,0.491,32
discrepancy,-0.831,0,32,1,1,0.26,0.643,0.417,32
mason,-0.831,6,230,1,1,0.541,0.442,0.58,236
jinx,-0.831,1,65,1,1,0.337,0.582,0.373,66
catnip,-0.831,0,32,1,1,0.439,0.381,0.296,32
scab,-0.831,0,32,1,1,0.354,0.33,0.272,32
oink,-0.831,0,32,1,1,0.5,0.45,0.289,32
painkiller,-0.831,0,32,1,1,0.487,0.312,0.481,32
molest,-0.831,0,32,1,1,0.133,0.816,0.319,32
toughen,-0.831,0,32,1,1,0.458,0.683,0.711,32
woozy,-0.831,0,32,1,1,0.177,0.452,0.306,32
money,-0.833,656,21729,1,1,0.844,0.608,0.827,22385
college,-0.836,308,10246,1,1,0.7,0.467,0.746,10554
school,-0.836,773,25669,1,1,0.765,0.423,0.633,26442
rubber,-0.836,10,364,1,1,0.46,0.217,0.315,374
trust,-0.836,749,24890,1,1,0.888,0.547,0.741,25639
trump,-0.837,281,9363,1,1,0.64,0.716,0.898,9644
weirdo,-0.837,37,1261,1,1,0.173,0.539,0.328,1298
cheesy,-0.837,18,630,1,1,0.47,0.471,0.179,648
guess,-0.837,1040,34579,1,1,0.64,0.463,0.442,35619
kidding,-0.837,58,1959,1,1,0.622,0.625,0.457,2017
bed,-0.837,895,29765,1,1,0.604,0.173,0.327,30660
freak,-0.838,42,1428,1,1,0.052,0.839,0.464,1470
bitchy,-0.838,7,265,1,1,0.188,0.7,0.373,272
reassure,-0.838,7,265,1,1,0.837,0.306,0.63,272
scrap,-0.838,3,132,1,1,0.156,0.339,0.173,135
devastated,-0.839,18,631,1,1,0.12,0.544,0.264,649
stray,-0.84,47,1598,1,1,0.133,0.76,0.281,1645
circling,-0.841,2,99,1,1,0.51,0.654,0.336,101
cactus,-0.841,8,299,1,1,0.439,0.412,0.284,307
harass,-0.843,11,400,1,1,0.16,0.775,0.62,411
rebel,-0.844,13,467,1,1,0.235,0.83,0.555,480
bait,-0.846,9,334,1,1,0.276,0.327,0.296,343
swift,-0.846,27,937,1,1,0.76,0.776,0.698,964
jellyfish,-0.846,1,66,1,1,0.531,0.567,0.377,67
thrift,-0.846,1,66,1,1,0.76,0.217,0.649,67
hooky,-0.846,1,66,1,1,0.468,0.5,0.452,67
uninspired,-0.846,3,133,1,1,0.163,0.243,0.26,136
anomaly,-0.846,1,66,1,1,0.188,0.538,0.404,67
latex,-0.846,1,66,1,1,0.479,0.413,0.325,67
poodle,-0.846,1,66,1,1,0.5,0.413,0.301,67
lovesick,-0.846,3,133,1,1,0.796,0.842,0.5,136
commissioner,-0.846,1,66,1,1,0.602,0.449,0.949,67
shaker,-0.846,1,66,1,1,0.52,0.728,0.518,67
colleague,-0.848,11,402,1,1,0.74,0.413,0.6,413
mad,-0.848,408,13735,1,1,0.219,0.873,0.277,14143
inadequate,-0.849,12,436,1,1,0.122,0.45,0.223,448
lying,-0.85,144,4875,1,1,0.208,0.704,0.317,5019
homo,-0.85,10,369,1,1,0.531,0.368,0.415,379
horrible,-0.85,145,4912,1,1,0.071,0.857,0.398,5057
homeboy,-0.851,5,201,1,1,0.602,0.255,0.436,206
lineup,-0.851,5,201,1,1,0.635,0.427,0.638,206
hunk,-0.851,2,100,1,1,0.438,0.375,0.361,102
lad,-0.851,21,740,1,1,0.637,0.388,0.336,761
disco,-0.851,15,538,1,1,0.71,0.806,0.575,553
eve,-0.852,106,3606,1,1,0.612,0.378,0.44,3712
pledge,-0.852,6,235,1,1,0.719,0.49,0.764,241
snuggling,-0.852,6,235,1,1,0.683,0.585,0.373,241
miss,-0.853,1573,53100,1,1,0.573,0.49,0.408,54673
dime,-0.853,11,404,1,1,0.653,0.317,0.345,415
qualified,-0.854,8,303,1,1,0.76,0.52,0.815,311
trashy,-0.855,4,168,1,1,0.071,0.38,0.161,172
boom,-0.856,31,1082,1,1,0.604,0.655,0.731,1113
illegal,-0.856,25,879,1,1,0.061,0.787,0.337,904
cop,-0.856,20,710,1,1,0.327,0.77,0.836,730
hate,-0.857,1772,60054,1,1,0.031,0.802,0.43,61826
troops,-0.857,8,304,1,1,0.385,0.718,0.804,312
abused,-0.857,35,1219,1,1,0.021,0.874,0.235,1254
marry,-0.859,92,3157,1,1,0.896,0.765,0.673,3249
grenade,-0.861,1,67,1,1,0.281,0.777,0.694,68
deathbed,-0.861,1,67,1,1,0.051,0.652,0.311,68
twerp,-0.861,0,33,1,1,0.408,0.443,0.384,33
grovel,-0.861,0,33,1,1,0.36,0.5,0.414,33
spokesperson,-0.861,0,33,1,1,0.573,0.453,0.615,33
jihad,-0.861,0,33,1,1,0.323,0.66,0.444,33
orphanage,-0.861,3,135,1,1,0.184,0.439,0.425,138
kazoo,-0.861,0,33,1,1,0.503,0.462,0.411,33
nappy,-0.861,0,33,1,1,0.529,0.333,0.207,33
unqualified,-0.861,1,67,1,1,0.17,0.433,0.173,68
cookie,-0.861,15,543,1,1,0.792,0.306,0.25,558
vamp,-0.861,0,33,1,1,0.31,0.794,0.566,33
bum,-0.861,24,849,1,1,0.281,0.451,0.155,873
pandemic,-0.861,0,33,1,1,0.16,0.79,0.544,33
deodorant,-0.861,1,67,1,1,0.48,0.265,0.269,68
cretin,-0.861,2,101,1,1,0.265,0.583,0.312,103
wheeze,-0.861,0,33,1,1,0.229,0.462,0.461,33
floppy,-0.861,0,33,1,1,0.549,0.3,0.333,33
nutcase,-0.861,0,33,1,1,0.286,0.775,0.259,33
supplementary,-0.861,0,33,1,1,0.625,0.352,0.541,33
spunk,-0.861,0,33,1,1,0.438,0.632,0.473,33
splat,-0.861,0,33,1,1,0.51,0.433,0.385,33
quadrant,-0.861,0,33,1,1,0.5,0.269,0.482,33
notwithstanding,-0.861,0,33,1,1,0.367,0.316,0.433,33
pothead,-0.861,0,33,1,1,0.378,0.51,0.375,33
promo,-0.861,9,339,1,1,0.602,0.551,0.614,348
gratis,-0.861,0,33,1,1,0.796,0.51,0.417,33
dill,-0.861,0,33,1,1,0.427,0.36,0.373,33
unwanted,-0.862,97,3336,1,1,0.177,0.546,0.205,3433
stomach,-0.863,39,1362,1,1,0.367,0.402,0.438,1401
killer,-0.863,60,2078,1,1,0.041,0.971,0.543,2138
vulnerable,-0.863,111,3817,1,1,0.198,0.49,0.245,3928
aye,-0.863,40,1397,1,1,0.562,0.42,0.392,1437
twain,-0.864,7,272,1,1,0.541,0.255,0.37,279
doe,-0.865,14,511,1,1,0.55,0.336,0.336,525
hilarious,-0.865,43,1501,1,1,0.75,0.64,0.537,1544
super,-0.865,514,17589,1,1,0.844,0.663,0.78,18103
threesome,-0.865,5,204,1,1,0.49,0.676,0.56,209
heterosexual,-0.866,4,170,1,1,0.561,0.612,0.557,174
shit,-0.868,2398,82170,1,1,0,0.678,0.294,84568
insult,-0.868,25,890,1,1,0.085,0.831,0.389,915
block,-0.868,99,3426,1,1,0.286,0.35,0.402,3525
checkout,-0.87,2,102,1,1,0.597,0.51,0.67,104
dresser,-0.87,2,102,1,1,0.604,0.398,0.473,104
flashy,-0.87,2,102,1,1,0.704,0.6,0.827,104
lube,-0.87,2,102,1,1,0.552,0.49,0.411,104
angel,-0.871,168,5806,1,1,0.906,0.158,0.704,5974
playboy,-0.873,6,240,1,1,0.646,0.9,0.519,246
delusional,-0.874,28,998,1,1,0.219,0.745,0.327,1026
chronic,-0.874,51,1791,1,1,0.255,0.615,0.464,1842
mite,-0.875,1,68,1,1,0.29,0.584,0.271,69
oldies,-0.875,3,137,1,1,0.438,0.3,0.412,140
belittle,-0.875,3,137,1,1,0.122,0.417,0.25,140
bra,-0.875,11,413,1,1,0.672,0.529,0.509,424
meanie,-0.875,1,68,1,1,0.388,0.42,0.404,69
shag,-0.875,3,137,1,1,0.417,0.462,0.34,140
nauseous,-0.875,3,137,1,1,0.135,0.78,0.284,140
advertise,-0.875,3,137,1,1,0.5,0.529,0.58,140
expired,-0.875,3,137,1,1,0.198,0.394,0.2,140
prematurely,-0.875,1,68,1,1,0.292,0.657,0.289,69
nation,-0.876,116,4038,1,1,0.594,0.443,0.821,4154
married,-0.877,295,10227,1,1,0.674,0.57,0.602,10522
irrelevant,-0.878,28,1002,1,1,0.138,0.311,0.296,1030
asshole,-0.879,71,2493,1,1,0.133,0.582,0.263,2564
brainless,-0.88,2,103,1,1,0.138,0.31,0.224,105
secondhand,-0.88,2,103,1,1,0.194,0.389,0.283,105
gone,-0.882,810,28176,1,1,0.292,0.23,0.19,28986
math,-0.882,27,972,1,1,0.417,0.375,0.6,999
dickhead,-0.883,8,312,1,1,0.115,0.608,0.284,320
pornography,-0.884,4,173,1,1,0.323,0.921,0.481,177
randy,-0.884,4,173,1,1,0.49,0.394,0.481,177
comedian,-0.885,6,243,1,1,0.812,0.735,0.598,249
nut,-0.886,25,906,1,1,0.365,0.31,0.25,931
pervert,-0.886,8,313,1,1,0.082,0.863,0.5,321
conservative,-0.889,29,1048,1,1,0.615,0.316,0.788,1077
disabled,-0.889,32,1153,1,1,0.308,0.443,0.235,1185
barney,-0.89,1,69,1,1,0.451,0.378,0.44,70
fundamentalist,-0.89,0,34,1,1,0.49,0.43,0.759,34
plat,-0.89,0,34,1,1,0.716,0.359,0.556,34
charmer,-0.89,0,34,1,1,0.882,0.683,0.782,34
estimate,-0.89,2,104,1,1,0.719,0.469,0.517,106
hotshot,-0.89,0,34,1,1,0.5,0.727,0.615,34
asthma,-0.89,1,69,1,1,0.198,0.549,0.227,70
dashed,-0.89,0,34,1,1,0.276,0.393,0.338,34
perm,-0.89,0,34,1,1,0.667,0.465,0.741,34
abort,-0.89,2,104,1,1,0.153,0.686,0.429,106
deteriorated,-0.89,0,34,1,1,0.053,0.549,0.237,34
blackjack,-0.89,0,34,1,1,0.419,0.679,0.452,34
legalize,-0.89,0,34,1,1,0.51,0.46,0.818,34
poltergeist,-0.89,0,34,1,1,0.271,0.784,0.544,34
aggravate,-0.89,0,34,1,1,0.224,0.77,0.464,34
anorexic,-0.89,0,34,1,1,0.16,0.618,0.245,34
ooze,-0.89,0,34,1,1,0.344,0.577,0.333,34
cavalier,-0.89,1,69,1,1,0.735,0.462,0.713,70
sudden,-0.89,102,3605,1,1,0.449,0.66,0.435,3707
website,-0.89,31,1120,1,1,0.615,0.442,0.526,1151
stave,-0.893,8,315,1,1,0.417,0.333,0.424,323
activist,-0.894,12,456,1,1,0.531,0.653,0.877,468
venting,-0.895,14,527,1,1,0.375,0.388,0.418,541
dirty,-0.895,84,2991,1,1,0.153,0.46,0.17,3075
inadequacy,-0.896,8,316,1,1,0.286,0.5,0.297,324
unfair,-0.896,25,915,1,1,0.173,0.472,0.19,940
bracelet,-0.897,3,140,1,1,0.776,0.34,0.322,143
drifter,-0.897,3,140,1,1,0.449,0.512,0.391,143
masturbation,-0.897,18,669,1,1,0.542,0.961,0.509,687
unicorn,-0.898,9,352,1,1,0.776,0.51,0.48,361
scumbag,-0.899,5,211,1,1,0.24,0.591,0.278,216
gong,-0.899,2,105,1,1,0.49,0.529,0.462,107
lea,-0.899,2,105,1,1,0.583,0.294,0.358,107
cousins,-0.9,39,1413,1,1,0.76,0.409,0.464,1452
night,-0.9,3286,116282,1,1,0.598,0.396,0.404,119568
nipple,-0.901,4,176,1,1,0.48,0.786,0.415,180
junction,-0.901,4,176,1,1,0.49,0.481,0.364,180
cupcake,-0.901,4,176,1,1,0.656,0.333,0.344,180
nintendo,-0.903,14,531,1,1,0.802,0.571,0.464,545
unstable,-0.903,22,815,1,1,0.167,0.587,0.15,837
woot,-0.904,1,70,1,1,0.602,0.49,0.481,71
juju,-0.904,1,70,1,1,0.541,0.519,0.206,71
plump,-0.904,1,70,1,1,0.385,0.48,0.387,71
overworked,-0.904,5,212,1,1,0.133,0.67,0.387,217
payday,-0.904,1,70,1,1,0.833,0.741,0.571,71
vagina,-0.904,11,425,1,1,0.551,0.87,0.5,436
repairman,-0.904,1,70,1,1,0.582,0.426,0.707,71
imperfect,-0.904,24,887,1,1,0.173,0.527,0.202,911
keyboard,-0.906,27,995,1,1,0.573,0.279,0.349,1022
adorable,-0.907,35,1281,1,1,0.969,0.519,0.457,1316
girlie,-0.908,2,106,1,1,0.604,0.54,0.409,108
harassing,-0.915,9,358,1,1,0.12,0.873,0.446,367
tad,-0.915,23,861,1,1,0.459,0.24,0.25,884
asleep,-0.917,205,7408,1,1,0.604,0.1,0.27,7613
post,-0.917,364,13133,1,1,0.52,0.426,0.548,13497
documentation,-0.918,0,35,1,1,0.719,0.29,0.667,35
grownup,-0.918,0,35,1,1,0.735,0.4,0.683,35
synopsis,-0.918,1,71,1,1,0.541,0.39,0.482,72
sissy,-0.918,6,251,1,1,0.333,0.562,0.232,257
broth,-0.918,0,35,1,1,0.5,0.245,0.168,35
halt,-0.918,16,611,1,1,0.167,0.36,0.432,627
erectile,-0.918,0,35,1,1,0.542,0.796,0.625,35
truss,-0.918,0,35,1,1,0.521,0.482,0.569,35
transsexual,-0.918,0,35,1,1,0.264,0.815,0.423,35
barnyard,-0.918,1,71,1,1,0.51,0.353,0.336,72
attendant,-0.918,3,143,1,1,0.58,0.365,0.519,146
gunman,-0.918,0,35,1,1,0.167,0.922,0.689,35
boooo,-0.918,0,35,1,1,0.271,0.549,0.255,35
humbug,-0.918,0,35,1,1,0.219,0.622,0.456,35
vindicated,-0.918,0,35,1,1,0.615,0.48,0.609,35
koala,-0.918,1,71,1,1,0.608,0.21,0.311,72
tiff,-0.918,1,71,1,1,0.531,0.415,0.343,72
occupational,-0.918,0,35,1,1,0.583,0.469,0.596,35
ladylike,-0.918,0,35,1,1,0.592,0.559,0.538,35
oily,-0.918,0,35,1,1,0.276,0.533,0.385,35
seatbelt,-0.918,0,35,1,1,0.656,0.314,0.726,35
inhabiting,-0.918,0,35,1,1,0.458,0.44,0.598,35
emotive,-0.918,0,35,1,1,0.917,0.741,0.525,35
unwell,-0.918,7,287,1,1,0.143,0.64,0.221,294
roadhouse,-0.918,0,35,1,1,0.5,0.62,0.458,35
statistical,-0.918,0,35,1,1,0.714,0.353,0.627,35
breakers,-0.918,1,71,1,1,0.469,0.588,0.439,72
cinder,-0.918,0,35,1,1,0.35,0.26,0.157,35
kool-aid,-0.918,0,35,1,1,0.531,0.318,0.393,35
peep,-0.919,18,684,1,1,0.573,0.317,0.269,702
rubbing,-0.921,16,613,1,1,0.406,0.569,0.44,629
idiotic,-0.921,7,288,1,1,0.104,0.62,0.17,295
user,-0.922,19,722,1,1,0.629,0.347,0.442,741
abortion,-0.925,11,434,1,1,0.082,0.77,0.283,445
friend,-0.925,2082,75532,1,1,0.906,0.413,0.573,77614
sleeping,-0.925,292,10625,1,1,0.704,0.091,0.312,10917
mane,-0.926,13,507,1,1,0.521,0.277,0.373,520
bunch,-0.926,166,6061,1,1,0.552,0.358,0.473,6227
ostracized,-0.927,5,217,1,1,0.115,0.69,0.377,222
criticized,-0.927,2,108,1,1,0.24,0.6,0.311,110
jerks,-0.927,5,217,1,1,0.214,0.788,0.395,222
amateur,-0.931,16,619,1,1,0.469,0.5,0.409,635
grammar,-0.932,9,364,1,1,0.56,0.287,0.607,373
malignant,-0.932,1,72,1,1,0.143,0.824,0.37,73
discriminate,-0.932,3,145,1,1,0.125,0.761,0.366,148
bankrupt,-0.932,3,145,1,1,0.163,0.673,0.337,148
japan,-0.932,62,2300,1,1,0.667,0.482,0.58,2362
clueless,-0.933,12,474,1,1,0.35,0.333,0.161,486
paralysis,-0.933,6,255,1,1,0.156,0.5,0.305,261
girly,-0.933,6,255,1,1,0.595,0.462,0.371,261
duh,-0.934,19,731,1,1,0.357,0.461,0.364,750
cheater,-0.934,4,182,1,1,0.104,0.92,0.333,186
motherhood,-0.934,14,548,1,1,0.844,0.546,0.667,562
cohesion,-0.936,2,109,1,1,0.604,0.536,0.555,111
kid,-0.936,326,11993,1,1,0.76,0.453,0.298,12319
wages,-0.938,3,146,1,1,0.776,0.44,0.62,149
fix,-0.939,212,7831,1,1,0.76,0.538,0.519,8043
neglected,-0.939,30,1139,1,1,0.271,0.385,0.16,1169
fault,-0.939,133,4929,1,1,0.188,0.558,0.184,5062
worried,-0.94,148,5482,1,1,0.094,0.824,0.395,5630
heartbreak,-0.941,81,3021,1,1,0.208,0.61,0.245,3102
cat,-0.942,442,16335,1,1,0.667,0.26,0.37,16777
vent,-0.942,62,2323,1,1,0.479,0.519,0.529,2385
pig,-0.942,29,1106,1,1,0.343,0.368,0.324,1135
hamster,-0.943,11,442,1,1,0.52,0.394,0.349,453
rally,-0.943,11,442,1,1,0.612,0.68,0.554,453
anxious,-0.944,179,6653,1,1,0.281,0.875,0.434,6832
slimy,-0.945,1,73,1,1,0.177,0.5,0.309,74
feeder,-0.945,1,73,1,1,0.604,0.452,0.713,74
eel,-0.945,0,36,1,1,0.292,0.564,0.487,36
sweetheart,-0.945,26,998,1,1,0.959,0.423,0.509,1024
smack,-0.945,12,480,1,1,0.323,0.662,0.381,492
banjo,-0.945,1,73,1,1,0.469,0.4,0.37,74
attention,-0.945,763,28267,1,1,0.74,0.599,0.774,29030
moustache,-0.945,0,36,1,1,0.47,0.236,0.409,36
duet,-0.945,5,221,1,1,0.694,0.693,0.527,226
rotate,-0.945,1,73,1,1,0.458,0.47,0.492,74
christmassy,-0.945,0,36,1,1,0.875,0.698,0.602,36
vert,-0.945,1,73,1,1,0.49,0.375,0.434,74
subspace,-0.945,1,73,1,1,0.47,0.453,0.475,74
cow,-0.945,19,739,1,1,0.449,0.23,0.3,758
bowler,-0.945,0,36,1,1,0.552,0.633,0.481,36
useless,-0.946,97,3627,1,1,0.052,0.342,0.184,3724
upset,-0.946,184,6850,1,1,0.071,0.68,0.33,7034
gross,-0.946,39,1481,1,1,0.115,0.575,0.181,1520
pal,-0.948,36,1372,1,1,0.812,0.426,0.596,1408
alleviate,-0.948,17,667,1,1,0.869,0.27,0.528,684
hold,-0.948,716,26609,1,1,0.448,0.29,0.364,27325
discrimination,-0.949,7,296,1,1,0.051,0.724,0.379,303
sucking,-0.949,18,705,1,1,0.227,0.528,0.377,723
waffle,-0.95,5,222,1,1,0.708,0.394,0.327,227
furry,-0.95,22,854,1,1,0.428,0.4,0.333,876
teenager,-0.95,32,1226,1,1,0.781,0.593,0.527,1258
suck,-0.952,157,5884,1,1,0.344,0.706,0.377,6041
surgeon,-0.952,3,148,1,1,0.5,0.598,0.793,151
boogie,-0.952,3,148,1,1,0.59,0.543,0.4,151
enslave,-0.952,3,148,1,1,0.073,0.8,0.481,151
holidays,-0.952,190,7114,1,1,0.939,0.521,0.512,7304
grades,-0.952,14,558,1,1,0.521,0.349,0.566,572
speaker,-0.953,31,1192,1,1,0.604,0.66,0.723,1223
idiot,-0.954,82,3097,1,1,0.086,0.567,0.113,3179
statistic,-0.954,2,111,1,1,0.508,0.42,0.609,113
civic,-0.954,2,111,1,1,0.653,0.24,0.573,113
popper,-0.954,2,111,1,1,0.42,0.509,0.411,113
smith,-0.956,56,2131,1,1,0.677,0.333,0.529,2187
behavior,-0.956,124,4675,1,1,0.594,0.442,0.813,4799
hitchhiker,-0.957,6,261,1,1,0.594,0.626,0.603,267
fluff,-0.957,8,336,1,1,0.52,0.264,0.172,344
greasy,-0.957,8,336,1,1,0.399,0.442,0.294,344
pretending,-0.958,80,3034,1,1,0.378,0.42,0.317,3114
sadist,-0.959,1,74,1,1,0.042,0.918,0.5,75
quits,-0.959,3,149,1,1,0.229,0.48,0.352,152
parched,-0.959,1,74,1,1,0.25,0.235,0.255,75
ilk,-0.959,1,74,1,1,0.438,0.451,0.455,75
marshmallow,-0.959,1,74,1,1,0.74,0.441,0.391,75
caving,-0.959,1,74,1,1,0.378,0.491,0.551,75
camel,-0.959,1,74,1,1,0.54,0.282,0.314,75
dad,-0.96,286,10775,1,1,0.857,0.412,0.786,11061
extra,-0.961,235,8869,1,1,0.656,0.551,0.745,9104
dog,-0.964,497,18775,1,1,0.704,0.5,0.407,19272
planet,-0.967,234,8883,1,1,0.698,0.404,0.832,9117
promise,-0.967,255,9678,1,1,0.823,0.5,0.704,9933
hang,-0.968,418,15855,1,1,0.323,0.529,0.446,16273
curb,-0.969,8,340,1,1,0.472,0.371,0.402,348
bun,-0.969,9,378,1,1,0.424,0.306,0.268,387
fiancee,-0.972,1,75,1,1,0.959,0.626,0.556,76
cowgirl,-0.972,1,75,1,1,0.541,0.566,0.554,76
cheque,-0.972,0,37,1,1,0.698,0.529,0.66,37
gape,-0.972,2,113,1,1,0.493,0.651,0.287,115
pensioner,-0.972,2,113,1,1,0.44,0.245,0.442,115
tireless,-0.972,0,37,1,1,0.657,0.75,0.645,37
simulate,-0.972,1,75,1,1,0.551,0.375,0.417,76
unimportant,-0.972,12,493,1,1,0.281,0.24,0.175,505
florist,-0.972,0,37,1,1,0.771,0.41,0.388,37
chimp,-0.972,0,37,1,1,0.394,0.588,0.345,37
chinchilla,-0.972,0,37,1,1,0.48,0.45,0.286,37
bombed,-0.972,0,37,1,1,0.051,0.851,0.627,37
slick,-0.972,6,265,1,1,0.388,0.383,0.349,271
crocodile,-0.972,1,75,1,1,0.344,0.708,0.61,76
reflex,-0.972,4,189,1,1,0.583,0.46,0.538,193
viral,-0.975,8,342,1,1,0.24,0.612,0.518,350
psychopath,-0.977,10,419,1,1,0.04,0.943,0.536,429
humiliating,-0.977,4,190,1,1,0.062,0.716,0.279,194
relapse,-0.977,4,190,1,1,0.173,0.46,0.303,194
yea,-0.978,120,4625,1,1,0.751,0.412,0.472,4745
diamonds,-0.979,18,726,1,1,0.927,0.684,0.917,744
painstaking,-0.981,2,114,1,1,0.396,0.335,0.386,116
fascism,-0.981,2,114,1,1,0.104,0.74,0.695,116
sac,-0.981,2,114,1,1,0.344,0.245,0.226,116
bet,-0.981,154,5945,1,1,0.385,0.698,0.432,6099
pill,-0.984,30,1192,1,1,0.573,0.407,0.368,1222
papa,-0.985,19,769,1,1,0.656,0.34,0.527,788
noodle,-0.985,5,230,1,1,0.633,0.216,0.225,235
ops,-0.985,5,230,1,1,0.417,0.55,0.528,235
cry,-0.985,818,31533,1,1,0.133,0.627,0.255,32351
recruit,-0.987,4,192,1,1,0.551,0.654,0.633,196
seesaw,-0.989,2,115,1,1,0.57,0.559,0.41,117
gorilla,-0.989,2,115,1,1,0.565,0.72,0.648,117
add,-0.991,252,9800,1,1,0.728,0.49,0.554,10052
starving,-0.993,20,814,1,1,0.163,0.67,0.336,834
cure,-0.993,219,8538,1,1,0.719,0.377,0.623,8757
bingo,-0.994,5,232,1,1,0.735,0.667,0.429,237
dicks,-0.996,13,544,1,1,0.31,0.694,0.358,557
luckiest,-0.998,1,77,1,1,0.917,0.69,0.852,78
phi,-0.998,0,38,1,1,0.42,0.361,0.452,38
hoot,-0.998,1,77,1,1,0.449,0.56,0.43,78
strep,-0.998,0,38,1,1,0.365,0.594,0.353,38
kebab,-0.998,0,38,1,1,0.531,0.431,0.377,38
yelp,-0.998,0,38,1,1,0.417,0.709,0.431,38
gang,-0.998,61,2417,1,1,0.217,0.85,0.629,2478
fob,-0.998,1,77,1,1,0.327,0.402,0.396,78
sledgehammer,-0.998,0,38,1,1,0.449,0.479,0.482,38
inbred,-0.998,1,77,1,1,0.397,0.52,0.473,78
commie,-0.998,1,77,1,1,0.385,0.519,0.454,78
cornball,-0.998,0,38,1,1,0.479,0.378,0.325,38
qualifications,-0.998,1,77,1,1,0.776,0.576,0.75,78
woefully,-0.998,0,38,1,1,0.204,0.58,0.269,38
salami,-0.998,0,38,1,1,0.667,0.36,0.339,38
eggplant,-0.998,0,38,1,1,0.592,0.152,0.323,38
beep,-1.002,5,234,1,1,0.595,0.541,0.304,239
sophomore,-1.003,4,195,1,1,0.653,0.415,0.427,199
cheer,-1.005,103,4084,1,1,0.938,0.784,0.845,4187
agent,-1.007,19,786,1,1,0.48,0.439,0.755,805
jackass,-1.008,4,196,1,1,0.188,0.692,0.279,200
juice,-1.008,29,1181,1,1,0.776,0.281,0.352,1210
donate,-1.009,15,630,1,1,0.774,0.462,0.577,645
fur,-1.009,34,1380,1,1,0.583,0.392,0.315,1414
inequality,-1.011,3,157,1,1,0.122,0.575,0.259,160
depot,-1.011,1,78,1,1,0.635,0.255,0.471,79
dummy,-1.011,9,394,1,1,0.44,0.144,0.25,403
bandwagon,-1.011,5,236,1,1,0.625,0.651,0.509,241
freshman,-1.011,13,552,1,1,0.677,0.57,0.441,565
masturbate,-1.011,18,750,1,1,0.552,0.926,0.5,768
retard,-1.012,6,276,1,1,0.194,0.347,0.222,282
neon,-1.012,27,1107,1,1,0.594,0.48,0.38,1134
stripper,-1.013,4,197,1,1,0.625,0.848,0.453,201
pup,-1.013,25,1029,1,1,0.755,0.427,0.302,1054
corny,-1.014,16,673,1,1,0.448,0.37,0.221,689
titanic,-1.015,2,118,1,1,0.427,0.786,0.795,120
mash,-1.015,2,118,1,1,0.44,0.363,0.283,120
feminist,-1.015,24,991,1,1,0.51,0.56,0.585,1015
cutie,-1.017,18,754,1,1,0.638,0.528,0.464,772
joking,-1.018,26,1074,1,1,0.776,0.839,0.407,1100
hospital,-1.019,68,2747,1,1,0.323,0.537,0.598,2815
adoption,-1.02,7,318,1,1,0.625,0.566,0.589,325
petition,-1.02,7,318,1,1,0.498,0.575,0.415,325
shitty,-1.021,128,5146,1,1,0.02,0.679,0.163,5274
billionaire,-1.021,9,398,1,1,0.806,0.667,0.923,407
slap,-1.021,19,797,1,1,0.1,0.804,0.518,816
supporter,-1.021,14,598,1,1,0.721,0.51,0.698,612
concert,-1.022,96,3873,1,1,0.938,0.867,0.718,3969
pun,-1.022,17,718,1,1,0.653,0.529,0.457,735
flatbed,-1.023,0,39,1,1,0.49,0.25,0.38,39
wham,-1.023,0,39,1,1,0.469,0.49,0.423,39
pussycat,-1.023,0,39,1,1,0.541,0.29,0.196,39
disgusting,-1.023,60,2439,1,1,0.031,0.796,0.245,2499
imissyou,-1.023,0,39,1,1,0.48,0.608,0.344,39
crumb,-1.023,1,79,1,1,0.417,0.255,0.216,80
headline,-1.023,6,279,1,1,0.63,0.241,0.685,285
brandy,-1.023,2,119,1,1,0.6,0.59,0.487,121
charger,-1.023,4,199,1,1,0.531,0.418,0.545,203
minefield,-1.023,0,39,1,1,0.188,0.839,0.684,39
prototype,-1.023,0,39,1,1,0.673,0.33,0.657,39
sue,-1.023,13,559,1,1,0.219,0.731,0.679,572
agh,-1.023,2,119,1,1,0.26,0.5,0.4,121
palliative,-1.023,0,39,1,1,0.548,0.394,0.518,39
numb,-1.024,69,2801,1,1,0.108,0.42,0.352,2870
rant,-1.025,47,1922,1,1,0.219,0.774,0.482,1969
sorry,-1.026,832,33399,1,1,0.406,0.362,0.212,34231
disease,-1.026,70,2848,1,1,0.041,0.539,0.333,2918
pretend,-1.027,134,5421,1,1,0.49,0.528,0.542,5555
trafficking,-1.027,5,240,1,1,0.25,0.71,0.399,245
loyal,-1.028,73,2973,1,1,0.896,0.265,0.657,3046
shuffle,-1.028,14,602,1,1,0.459,0.45,0.556,616
gum,-1.028,4,200,1,1,0.573,0.227,0.213,204
idol,-1.029,29,1206,1,1,0.684,0.805,0.853,1235
jerk,-1.029,24,1005,1,1,0.194,0.63,0.238,1029
pouting,-1.029,3,160,1,1,0.263,0.471,0.27,163
song,-1.03,944,38054,1,1,0.854,0.413,0.5,38998
goldfish,-1.031,5,241,1,1,0.786,0.296,0.317,246
cheered,-1.032,7,322,1,1,0.875,0.648,0.79,329
goddamn,-1.032,52,2139,1,1,0.125,0.76,0.422,2191
drugs,-1.033,103,4201,1,1,0.167,0.75,0.368,4304
pet,-1.034,128,5216,1,1,0.875,0.327,0.305,5344
surgery,-1.035,20,849,1,1,0.286,0.769,0.6,869
squish,-1.036,1,80,1,1,0.26,0.788,0.481,81
revision,-1.036,1,80,1,1,0.417,0.459,0.71,81
wannabe,-1.036,7,323,1,1,0.602,0.547,0.337,330
brightens,-1.036,3,161,1,1,0.771,0.611,0.613,164
vomiting,-1.036,1,80,1,1,0.156,0.78,0.157,81
ham,-1.037,6,283,1,1,0.673,0.245,0.404,289
donkey,-1.039,7,324,1,1,0.406,0.367,0.245,331
supervisor,-1.04,2,121,1,1,0.615,0.479,0.933,123
skit,-1.04,2,121,1,1,0.438,0.434,0.421,123
bacteria,-1.04,2,121,1,1,0.177,0.553,0.57,123
pistol,-1.04,2,121,1,1,0.17,0.9,0.677,123
ay,-1.041,16,691,1,1,0.5,0.557,0.255,707
scroll,-1.042,15,651,1,1,0.375,0.63,0.409,666
ill,-1.042,215,8801,1,1,0.073,0.41,0.2,9016
holding,-1.042,200,8193,1,1,0.6,0.385,0.67,8393
unsuccessful,-1.043,4,203,1,1,0.14,0.318,0.106,207
ana,-1.044,12,530,1,1,0.541,0.3,0.314,542
causation,-1.048,0,40,1,1,0.562,0.48,0.567,40
crawfish,-1.048,0,40,1,1,0.51,0.427,0.342,40
heartburn,-1.048,0,40,1,1,0.143,0.613,0.398,40
coupon,-1.048,0,40,1,1,0.704,0.3,0.421,40
befriend,-1.048,42,1762,1,1,0.93,0.624,0.471,1804
freaky,-1.048,7,327,1,1,0.19,0.615,0.384,334
felon,-1.048,0,40,1,1,0.111,0.898,0.455,40
goody,-1.048,0,40,1,1,0.786,0.337,0.57,40
saucer,-1.048,0,40,1,1,0.51,0.327,0.337,40
gammon,-1.048,1,81,1,1,0.51,0.418,0.442,82
tumbleweed,-1.048,1,81,1,1,0.312,0.471,0.427,82
valor,-1.048,0,40,1,1,0.833,0.442,0.763,40
cog,-1.048,0,40,1,1,0.427,0.343,0.363,40
terrier,-1.048,0,40,1,1,0.562,0.54,0.431,40
acne,-1.048,3,163,1,1,0.167,0.474,0.308,166
chili,-1.048,6,286,1,1,0.592,0.566,0.433,292
feat,-1.049,44,1846,1,1,0.75,0.706,0.849,1890
matching,-1.049,15,656,1,1,0.719,0.735,0.418,671
childish,-1.051,26,1110,1,1,0.573,0.442,0.23,1136
cash,-1.054,36,1525,1,1,0.867,0.552,0.714,1561
junior,-1.054,18,783,1,1,0.635,0.343,0.304,801
tot,-1.056,2,123,1,1,0.602,0.431,0.311,125
purring,-1.056,2,123,1,1,0.748,0.33,0.271,125
ebony,-1.057,7,330,1,1,0.49,0.317,0.4,337
naughty,-1.058,16,703,1,1,0.451,0.857,0.371,719
postman,-1.06,1,82,1,1,0.643,0.482,0.455,83
smoker,-1.06,3,165,1,1,0.208,0.528,0.311,168
pharmacy,-1.06,1,82,1,1,0.531,0.337,0.542,83
confused,-1.06,216,9005,1,1,0.22,0.65,0.179,9221
mutual,-1.06,53,2241,1,1,0.729,0.321,0.464,2294
campaign,-1.062,35,1496,1,1,0.602,0.73,0.823,1531
nasty,-1.063,45,1913,1,1,0.115,0.62,0.264,1958
expectancy,-1.064,2,124,1,1,0.581,0.622,0.558,126
bloated,-1.064,2,124,1,1,0.167,0.593,0.424,126
sub,-1.065,28,1209,1,1,0.51,0.37,0.312,1237
billboard,-1.067,4,208,1,1,0.594,0.317,0.481,212
sleepy,-1.069,42,1799,1,1,0.604,0.125,0.25,1841
holly,-1.069,7,334,1,1,0.51,0.25,0.443,341
aged,-1.069,36,1549,1,1,0.135,0.365,0.236,1585
steeple,-1.072,0,41,1,1,0.625,0.519,0.5,41
firefighter,-1.072,0,41,1,1,0.637,0.77,0.773,41
malnutrition,-1.072,0,41,1,1,0.024,0.592,0.277,41
connoisseur,-1.072,0,41,1,1,0.76,0.461,0.769,41
disband,-1.072,1,83,1,1,0.302,0.491,0.417,84
broccoli,-1.072,1,83,1,1,0.469,0.2,0.283,84
cousin,-1.072,50,2141,1,1,0.675,0.394,0.427,2191
database,-1.072,0,41,1,1,0.604,0.286,0.644,41
douche,-1.072,6,293,1,1,0.49,0.413,0.397,299
tuition,-1.072,1,83,1,1,0.531,0.372,0.436,84
lifeline,-1.072,9,419,1,1,0.735,0.552,0.496,428
porky,-1.072,0,41,1,1,0.234,0.483,0.333,41
fiat,-1.072,0,41,1,1,0.52,0.418,0.446,41
yaaay,-1.072,0,41,1,1,0.65,0.61,0.33,41
fleece,-1.072,0,41,1,1,0.561,0.25,0.381,41
comeback,-1.073,34,1471,1,1,0.58,0.409,0.555,1505
mom,-1.076,458,19352,1,1,0.927,0.336,0.639,19810
less,-1.078,1283,54234,1,1,0.265,0.24,0.115,55517
porn,-1.078,161,6845,1,1,0.344,0.915,0.421,7006
panties,-1.079,6,295,1,1,0.594,0.529,0.312,301
pitiful,-1.079,20,887,1,1,0.219,0.49,0.232,907
date,-1.079,424,17984,1,1,0.604,0.231,0.4,18408
breaker,-1.08,2,126,1,1,0.323,0.527,0.52,128
informative,-1.08,2,126,1,1,0.812,0.419,0.741,128
panda,-1.081,9,423,1,1,0.646,0.194,0.406,432
gossip,-1.082,42,1824,1,1,0.173,0.765,0.245,1866
ceiling,-1.084,27,1189,1,1,0.52,0.224,0.366,1216
vending,-1.084,1,84,1,1,0.417,0.565,0.549,85
buffoon,-1.084,1,84,1,1,0.344,0.651,0.29,85
lower,-1.084,78,3358,1,1,0.327,0.296,0.258,3436
dice,-1.085,10,467,1,1,0.458,0.441,0.264,477
unsatisfied,-1.085,6,297,1,1,0.2,0.547,0.241,303
telegram,-1.086,4,212,1,1,0.561,0.542,0.55,216
pillow,-1.09,70,3034,1,1,0.663,0.128,0.195,3104
clover,-1.09,7,341,1,1,0.605,0.34,0.364,348
salty,-1.09,30,1325,1,1,0.388,0.531,0.288,1355
diagnosis,-1.093,7,342,1,1,0.571,0.5,0.819,349
psycho,-1.093,19,857,1,1,0.039,0.922,0.56,876
cried,-1.095,138,5972,1,1,0.167,0.612,0.254,6110
depression,-1.095,727,31289,1,1,0.031,0.52,0.232,32016
deacon,-1.095,0,42,1,1,0.531,0.43,0.736,42
pivot,-1.095,0,42,1,1,0.458,0.382,0.44,42
shears,-1.095,0,42,1,1,0.429,0.527,0.254,42
addresses,-1.095,2,128,1,1,0.51,0.354,0.45,130
delirious,-1.095,1,85,1,1,0.219,0.774,0.538,86
youngster,-1.095,0,42,1,1,0.796,0.557,0.661,42
withdrawals,-1.095,1,85,1,1,0.427,0.404,0.464,86
endemic,-1.095,0,42,1,1,0.406,0.48,0.483,42
slang,-1.095,2,128,1,1,0.479,0.418,0.491,130
peacock,-1.095,0,42,1,1,0.786,0.449,0.458,42
dialysis,-1.095,0,42,1,1,0.194,0.567,0.407,42
honky,-1.095,0,42,1,1,0.458,0.632,0.425,42
arthritis,-1.095,1,85,1,1,0.11,0.518,0.345,86
classmate,-1.099,5,258,1,1,0.781,0.4,0.593,263
moonlight,-1.1,73,3197,1,1,0.865,0.264,0.409,3270
friends,-1.106,4229,183752,1,1,0.929,0.51,0.625,187981
sexist,-1.106,8,390,1,1,0.255,0.798,0.411,398
motherfucker,-1.107,17,782,1,1,0.122,0.827,0.351,799
credibility,-1.107,3,173,1,1,0.875,0.427,0.809,176
structural,-1.107,1,86,1,1,0.582,0.425,0.69,87
diagram,-1.107,1,86,1,1,0.562,0.357,0.445,87
upbeat,-1.109,6,304,1,1,0.878,0.531,0.802,310
downer,-1.109,4,217,1,1,0.12,0.594,0.226,221
emo,-1.109,59,2615,1,1,0.354,0.314,0.226,2674
crook,-1.111,2,130,1,1,0.171,0.765,0.55,132
rabbit,-1.111,39,1746,1,1,0.685,0.33,0.241,1785
diamond,-1.111,33,1484,1,1,0.91,0.606,0.769,1517
island,-1.112,629,27541,1,1,0.745,0.347,0.432,28170
sexy,-1.114,107,4732,1,1,0.865,0.945,0.802,4839
pout,-1.115,5,262,1,1,0.458,0.354,0.202,267
vile,-1.115,18,832,1,1,0.083,0.537,0.553,850
spotted,-1.116,23,1052,1,1,0.354,0.472,0.295,1075
boring,-1.118,276,12185,1,1,0.194,0.217,0.125,12461
bumblebee,-1.118,0,43,1,1,0.469,0.493,0.321,43
moo,-1.118,2,131,1,1,0.438,0.355,0.3,133
immature,-1.118,13,615,1,1,0.114,0.5,0.2,628
derogatory,-1.118,0,43,1,1,0.122,0.58,0.404,43
bracket,-1.118,1,87,1,1,0.49,0.35,0.682,88
reinstall,-1.118,0,43,1,1,0.458,0.5,0.745,43
televised,-1.118,0,43,1,1,0.625,0.519,0.518,43
rave,-1.118,6,307,1,1,0.49,0.637,0.42,313
firefly,-1.118,1,87,1,1,0.622,0.41,0.363,88
bogus,-1.118,1,87,1,1,0.219,0.353,0.144,88
dorky,-1.118,1,87,1,1,0.302,0.48,0.39,88
recruitment,-1.118,1,87,1,1,0.479,0.645,0.591,88
gaggle,-1.118,0,43,1,1,0.542,0.529,0.664,43
dolphin,-1.118,3,175,1,1,0.776,0.35,0.414,178
boob,-1.124,3,176,1,1,0.694,0.6,0.392,179
bye,-1.124,149,6639,1,1,0.375,0.398,0.321,6788
download,-1.125,25,1150,1,1,0.602,0.49,0.503,1175
hopelessness,-1.127,26,1197,1,1,0.052,0.402,0.223,1223
creepy,-1.128,52,2353,1,1,0.125,0.861,0.373,2405
con,-1.128,37,1687,1,1,0.255,0.736,0.427,1724
tipsy,-1.128,8,399,1,1,0.51,0.625,0.57,407
fax,-1.13,1,88,1,1,0.406,0.368,0.304,89
swoop,-1.13,1,88,1,1,0.479,0.618,0.446,89
snap,-1.13,67,3027,1,1,0.344,0.517,0.352,3094
breakup,-1.131,21,979,1,1,0.25,0.72,0.357,1000
server,-1.132,22,1025,1,1,0.656,0.356,0.536,1047
uneventful,-1.133,2,133,1,1,0.51,0.343,0.41,135
unappreciated,-1.136,12,581,1,1,0.143,0.431,0.209,593
sex,-1.136,543,24363,1,1,0.803,0.939,0.704,24906
apex,-1.137,10,492,1,1,0.57,0.433,0.418,502
schmuck,-1.141,0,44,1,1,0.363,0.412,0.375,44
liar,-1.141,28,1304,1,1,0.042,0.606,0.339,1332
guacamole,-1.141,0,44,1,1,0.684,0.317,0.282,44
alto,-1.141,0,44,1,1,0.656,0.404,0.73,44
armpit,-1.141,0,44,1,1,0.283,0.439,0.25,44
sneeze,-1.141,2,134,1,1,0.271,0.442,0.336,136
vaccine,-1.141,0,44,1,1,0.5,0.52,0.555,44
raving,-1.141,1,89,1,1,0.312,0.764,0.358,90
bouquet,-1.141,3,179,1,1,0.724,0.352,0.306,182
blush,-1.141,4,224,1,1,0.698,0.61,0.445,228
cretins,-1.141,0,44,1,1,0.094,0.741,0.328,44
racetrack,-1.141,0,44,1,1,0.708,0.808,0.624,44
masochism,-1.141,0,44,1,1,0.194,0.845,0.483,44
spleen,-1.141,1,89,1,1,0.448,0.255,0.396,90
pregnancy,-1.141,22,1034,1,1,0.74,0.769,0.569,1056
pie,-1.142,29,1351,1,1,0.88,0.402,0.368,1380
stressed,-1.143,122,5544,1,1,0.167,0.74,0.502,5666
ungrateful,-1.143,10,495,1,1,0.219,0.461,0.275,505
insecurity,-1.145,32,1490,1,1,0.094,0.647,0.35,1522
single,-1.145,1576,71278,1,1,0.291,0.354,0.259,72854
depressing,-1.146,128,5833,1,1,0.146,0.559,0.216,5961
bash,-1.146,33,1537,1,1,0.385,0.546,0.463,1570
sibling,-1.147,22,1040,1,1,0.857,0.34,0.636,1062
dick,-1.148,161,7339,1,1,0.208,0.5,0.462,7500
reunited,-1.148,5,271,1,1,0.708,0.439,0.658,276
damn,-1.149,760,34524,1,1,0.073,0.784,0.431,35284
turtleneck,-1.152,1,90,1,1,0.583,0.398,0.327,91
pouty,-1.152,1,90,1,1,0.333,0.48,0.393,91
penis,-1.152,15,727,1,1,0.354,0.81,0.556,742
uterus,-1.152,1,90,1,1,0.551,0.42,0.51,91
loco,-1.152,1,90,1,1,0.306,0.774,0.226,91
medley,-1.152,1,90,1,1,0.487,0.352,0.4,91
goo,-1.154,4,227,1,1,0.439,0.396,0.312,231
hating,-1.155,62,2875,1,1,0.083,0.82,0.434,2937
bro,-1.155,261,11960,1,1,0.794,0.349,0.684,12221
tucker,-1.157,3,182,1,1,0.475,0.558,0.429,185
prank,-1.157,3,182,1,1,0.571,0.69,0.389,185
hurting,-1.158,97,4487,1,1,0.153,0.778,0.221,4584
demographic,-1.159,4,228,1,1,0.459,0.356,0.594,232
millionaire,-1.16,8,412,1,1,0.917,0.755,0.85,420
fake,-1.162,377,17366,1,1,0.073,0.554,0.268,17743
profile,-1.163,58,2712,1,1,0.689,0.293,0.529,2770
gull,-1.163,0,45,1,1,0.594,0.317,0.378,45
kisser,-1.163,0,45,1,1,0.844,0.682,0.618,45
receptionist,-1.163,0,45,1,1,0.677,0.43,0.385,45
croc,-1.163,0,45,1,1,0.327,0.452,0.451,45
negro,-1.163,2,137,1,1,0.354,0.368,0.461,139
yodel,-1.163,0,45,1,1,0.51,0.454,0.389,45
prevalence,-1.163,0,45,1,1,0.618,0.52,0.815,45
coupe,-1.163,0,45,1,1,0.479,0.46,0.482,45
lesbianism,-1.163,0,45,1,1,0.327,0.725,0.44,45
felt,-1.165,1442,66488,1,1,0.643,0.417,0.566,67930
hearted,-1.165,23,1105,1,1,0.823,0.41,0.805,1128
send,-1.165,315,14567,1,1,0.663,0.48,0.537,14882
lame,-1.165,53,2489,1,1,0.145,0.41,0.217,2542
talk,-1.166,2002,92428,1,1,0.833,0.346,0.594,94430
unfollow,-1.167,14,692,1,1,0.281,0.337,0.293,706
haw,-1.168,3,184,1,1,0.406,0.426,0.431,187
billy,-1.17,25,1204,1,1,0.49,0.397,0.375,1229
bitter,-1.171,238,11088,1,1,0.218,0.627,0.411,11326
pimp,-1.172,4,231,1,1,0.146,0.7,0.536,235
flex,-1.172,18,881,1,1,0.604,0.378,0.33,899
tweet,-1.173,436,20309,1,1,0.659,0.49,0.537,20745
pimple,-1.174,1,92,1,1,0.245,0.37,0.274,93
invalidate,-1.174,1,92,1,1,0.315,0.48,0.397,93
bias,-1.175,25,1209,1,1,0.4,0.37,0.541,1234
broken,-1.175,477,22256,1,1,0.062,0.5,0.293,22733
bigoted,-1.176,4,232,1,1,0.153,0.76,0.462,236
whiny,-1.176,7,372,1,1,0.208,0.548,0.375,379
parody,-1.18,8,420,1,1,0.561,0.651,0.375,428
road,-1.182,559,26246,1,1,0.656,0.404,0.404,26805
fuck,-1.184,1365,64169,1,1,0.198,0.93,0.446,65534
trifling,-1.184,0,46,1,1,0.375,0.418,0.183,46
impairment,-1.184,0,46,1,1,0.17,0.571,0.22,46
palsy,-1.184,0,46,1,1,0.083,0.446,0.221,46
fricking,-1.184,2,140,1,1,0.333,0.642,0.357,142
waddle,-1.184,0,46,1,1,0.49,0.453,0.388,46
impotent,-1.184,2,140,1,1,0.146,0.587,0.333,142
gerbil,-1.184,0,46,1,1,0.453,0.306,0.398,46
parrot,-1.184,3,187,1,1,0.588,0.333,0.292,190
initiative,-1.184,13,657,1,1,0.833,0.615,0.768,670
snuggle,-1.184,20,986,1,1,0.781,0.39,0.35,1006
hit,-1.187,444,20962,1,1,0.235,0.931,0.679,21406
soy,-1.187,6,329,1,1,0.438,0.25,0.286,335
carpenter,-1.189,4,235,1,1,0.521,0.55,0.519,239
waitress,-1.19,6,330,1,1,0.646,0.531,0.352,336
litter,-1.19,6,330,1,1,0.255,0.551,0.11,336
rag,-1.191,2,141,1,1,0.255,0.226,0.18,143
miscarriage,-1.191,2,141,1,1,0.042,0.781,0.312,143
clothe,-1.195,1,94,1,1,0.797,0.33,0.481,95
whipped,-1.195,5,284,1,1,0.198,0.804,0.361,289
skyscraper,-1.195,1,94,1,1,0.622,0.696,0.798,95
rodeo,-1.195,1,94,1,1,0.49,0.676,0.588,95
clap,-1.196,21,1045,1,1,0.779,0.731,0.529,1066
stud,-1.198,2,142,1,1,0.564,0.531,0.509,144
feminism,-1.2,11,572,1,1,0.541,0.57,0.636,583
overreact,-1.2,3,190,1,1,0.306,0.912,0.471,193
hunter,-1.201,50,2435,1,1,0.292,0.817,0.817,2485
smash,-1.201,29,1432,1,1,0.195,0.692,0.53,1461
sum,-1.201,45,2197,1,1,0.792,0.34,0.42,2242
bereavement,-1.201,4,238,1,1,0.265,0.677,0.5,242
mama,-1.202,72,3491,1,1,0.86,0.413,0.728,3563
bang,-1.202,41,2009,1,1,0.265,0.951,0.74,2050
sleepover,-1.203,8,430,1,1,0.815,0.519,0.34,438
slab,-1.205,0,47,1,1,0.398,0.265,0.264,47
ballad,-1.205,10,527,1,1,0.792,0.284,0.424,537
downhearted,-1.205,0,47,1,1,0.119,0.461,0.255,47
mozzarella,-1.205,0,47,1,1,0.653,0.265,0.34,47
lethargic,-1.205,4,239,1,1,0.214,0.245,0.375,243
abrasive,-1.205,0,47,1,1,0.392,0.61,0.593,47
hickey,-1.205,0,47,1,1,0.448,0.529,0.345,47
gimp,-1.205,0,47,1,1,0.469,0.442,0.342,47
roundabout,-1.205,1,95,1,1,0.49,0.425,0.495,96
democrat,-1.207,11,576,1,1,0.582,0.4,0.755,587
xmas,-1.209,50,2455,1,1,0.906,0.717,0.615,2505
payment,-1.21,4,240,1,1,0.629,0.452,0.643,244
messy,-1.21,47,2313,1,1,0.26,0.635,0.14,2360
targeting,-1.211,3,192,1,1,0.51,0.42,0.58,195
dial,-1.214,4,241,1,1,0.62,0.427,0.596,245
terrorists,-1.214,4,241,1,1,0.062,0.967,0.688,245
hater,-1.214,11,580,1,1,0.052,0.702,0.422,591
doll,-1.215,24,1211,1,1,0.729,0.321,0.33,1235
velvet,-1.216,23,1163,1,1,0.663,0.226,0.304,1186
pong,-1.216,1,96,1,1,0.5,0.5,0.396,97
teenage,-1.216,30,1503,1,1,0.667,0.673,0.558,1533
grandma,-1.217,42,2086,1,1,0.796,0.208,0.491,2128
mum,-1.219,80,3941,1,1,0.802,0.317,0.698,4021
guy,-1.221,562,27438,1,1,0.583,0.367,0.546,28000
voodoo,-1.221,3,194,1,1,0.188,0.6,0.453,197
reported,-1.221,12,633,1,1,0.418,0.442,0.567,645
shoe,-1.224,10,537,1,1,0.517,0.225,0.288,547
terribly,-1.225,41,2054,1,1,0.061,0.731,0.43,2095
finder,-1.226,0,48,1,1,0.36,0.55,0.63,48
eighteen,-1.226,3,195,1,1,0.523,0.34,0.404,198
mutilated,-1.226,0,48,1,1,0.041,0.841,0.356,48
dole,-1.226,0,48,1,1,0.448,0.402,0.348,48
xenophobia,-1.226,0,48,1,1,0.156,0.771,0.5,48
tripe,-1.226,0,48,1,1,0.312,0.361,0.438,48
cellmate,-1.226,1,97,1,1,0.167,0.684,0.349,98
tabby,-1.226,0,48,1,1,0.51,0.426,0.387,48
lunatic,-1.226,5,293,1,1,0.125,0.792,0.442,298
cockroach,-1.226,1,97,1,1,0.188,0.667,0.196,98
electorate,-1.226,0,48,1,1,0.56,0.38,0.696,48
handsome,-1.228,30,1521,1,1,0.89,0.6,0.682,1551
wont,-1.233,142,7054,1,1,0.24,0.343,0.291,7196
ion,-1.234,81,4049,1,1,0.429,0.33,0.408,4130
besties,-1.234,9,493,1,1,0.888,0.509,0.614,502
homophobic,-1.235,10,543,1,1,0.13,0.736,0.464,553
consultant,-1.236,1,98,1,1,0.77,0.344,0.808,99
stinky,-1.241,3,198,1,1,0.092,0.558,0.176,201
hopeless,-1.242,75,3784,1,1,0.094,0.298,0.112,3859
wig,-1.243,6,348,1,1,0.722,0.279,0.18,354
erection,-1.246,0,49,1,1,0.64,0.856,0.695,49
lotion,-1.246,3,199,1,1,0.724,0.261,0.188,202
trampoline,-1.246,0,49,1,1,0.604,0.69,0.391,49
mamma,-1.246,4,249,1,1,0.6,0.358,0.449,253
snoopy,-1.246,0,49,1,1,0.573,0.534,0.291,49
wen,-1.248,19,1001,1,1,0.438,0.431,0.38,1020
virgin,-1.251,53,2712,1,1,0.622,0.433,0.462,2765
escort,-1.251,11,602,1,1,0.729,0.48,0.608,613
sympathy,-1.251,61,3115,1,1,0.827,0.497,0.634,3176
dab,-1.252,6,351,1,1,0.51,0.337,0.34,357
mannequin,-1.253,2,150,1,1,0.427,0.302,0.295,152
coed,-1.256,1,100,1,1,0.469,0.531,0.481,101
reduction,-1.256,1,100,1,1,0.365,0.382,0.24,101
intimidate,-1.256,1,100,1,1,0.21,0.804,0.632,101
snuggles,-1.256,7,403,1,1,0.67,0.34,0.287,410
sitter,-1.256,1,100,1,1,0.656,0.429,0.404,101
horrid,-1.256,7,403,1,1,0.052,0.765,0.419,410
esteem,-1.257,23,1212,1,1,0.745,0.38,0.679,1235
slogan,-1.259,2,151,1,1,0.55,0.216,0.564,153
racist,-1.26,53,2736,1,1,0.061,0.673,0.482,2789
adopt,-1.26,48,2484,1,1,0.694,0.612,0.701,2532
lip,-1.26,20,1064,1,1,0.541,0.348,0.443,1084
boner,-1.26,6,354,1,1,0.344,0.612,0.393,360
stoned,-1.261,10,557,1,1,0.177,0.796,0.375,567
ransom,-1.261,3,202,1,1,0.582,0.8,0.565,205
stalk,-1.262,9,507,1,1,0.436,0.272,0.395,516
scam,-1.265,17,916,1,1,0.042,0.745,0.418,933
alleyway,-1.266,0,50,1,1,0.357,0.471,0.382,50
hinge,-1.266,1,101,1,1,0.458,0.292,0.417,102
squeezing,-1.266,2,152,1,1,0.26,0.598,0.557,154
magpie,-1.266,0,50,1,1,0.5,0.458,0.327,50
mailman,-1.266,0,50,1,1,0.659,0.418,0.462,50
tummy,-1.266,5,305,1,1,0.427,0.365,0.23,310
specialize,-1.266,0,50,1,1,0.776,0.54,0.861,50
kennel,-1.266,1,101,1,1,0.43,0.48,0.406,102
buddy,-1.267,95,4902,1,1,0.884,0.585,0.655,4997
fucking,-1.268,1119,57227,1,1,0.229,0.812,0.39,58346
kiss,-1.269,148,7617,1,1,0.967,0.813,0.63,7765
widow,-1.27,15,818,1,1,0.25,0.45,0.265,833
paste,-1.273,2,153,1,1,0.5,0.556,0.5,155
unopened,-1.273,2,153,1,1,0.542,0.34,0.265,155
llama,-1.273,2,153,1,1,0.49,0.59,0.519,155
highway,-1.274,30,1592,1,1,0.64,0.583,0.425,1622
booty,-1.275,14,771,1,1,0.663,0.587,0.784,785
pan,-1.277,23,1237,1,1,0.734,0.182,0.364,1260
bloodline,-1.279,5,309,1,1,0.51,0.657,0.604,314
granny,-1.284,9,518,1,1,0.796,0.24,0.452,527
reply,-1.285,136,7120,1,1,0.762,0.29,0.596,7256
spank,-1.285,1,103,1,1,0.112,0.882,0.642,104
squeaky,-1.285,0,51,1,1,0.229,0.771,0.367,51
indemnity,-1.285,0,51,1,1,0.47,0.607,0.692,51
mammy,-1.285,0,51,1,1,0.68,0.415,0.436,51
fetish,-1.285,7,415,1,1,0.307,0.706,0.5,422
buck,-1.287,9,520,1,1,0.677,0.577,0.72,529
inactive,-1.29,8,469,1,1,0.271,0.167,0.159,477
army,-1.295,87,4617,1,1,0.417,0.759,0.902,4704
darling,-1.295,65,3463,1,1,0.885,0.37,0.608,3528
hurry,-1.296,39,2100,1,1,0.422,0.735,0.481,2139
lewd,-1.296,6,367,1,1,0.188,0.673,0.412,373
scheme,-1.297,9,525,1,1,0.521,0.269,0.577,534
anon,-1.299,10,579,1,1,0.479,0.354,0.298,589
sperm,-1.3,3,210,1,1,0.396,0.706,0.453,213
castaway,-1.3,11,632,1,1,0.208,0.646,0.422,643
bunny,-1.302,23,1268,1,1,0.74,0.325,0.194,1291
grader,-1.305,2,158,1,1,0.583,0.317,0.42,160
aphrodisiac,-1.305,0,52,1,1,0.75,0.846,0.667,52
yak,-1.305,0,52,1,1,0.469,0.422,0.422,52
autobiographical,-1.305,0,52,1,1,0.909,0.462,0.582,52
nationwide,-1.305,0,52,1,1,0.684,0.217,0.672,52
christmas,-1.305,516,27417,1,1,0.959,0.52,0.741,27933
frustrated,-1.307,55,2975,1,1,0.08,0.651,0.255,3030
tomato,-1.31,6,372,1,1,0.55,0.183,0.275,378
kook,-1.311,2,159,1,1,0.417,0.471,0.398,161
neutron,-1.317,2,160,1,1,0.469,0.44,0.679,162
blowjob,-1.319,3,214,1,1,0.46,0.784,0.387,217
jealous,-1.319,96,5213,1,1,0.173,0.855,0.345,5309
plush,-1.32,5,322,1,1,0.625,0.265,0.318,327
sick,-1.323,373,20189,1,1,0.104,0.431,0.136,20562
overplayed,-1.323,0,53,1,1,0.224,0.798,0.586,53
cougar,-1.323,3,215,1,1,0.438,0.588,0.538,218
hypnotize,-1.323,0,53,1,1,0.469,0.507,0.508,53
flustered,-1.323,1,107,1,1,0.316,0.903,0.283,108
unattractive,-1.323,8,485,1,1,0.177,0.307,0.208,493
bully,-1.329,23,1302,1,1,0.257,0.755,0.564,1325
hee,-1.329,5,325,1,1,0.43,0.433,0.312,330
clout,-1.33,13,760,1,1,0.584,0.636,0.704,773
cashier,-1.331,4,271,1,1,0.615,0.413,0.484,275
meow,-1.331,6,380,1,1,0.51,0.51,0.412,386
combat,-1.331,48,2667,1,1,0.302,0.846,0.833,2715
lettuce,-1.332,1,108,1,1,0.594,0.163,0.291,109
hank,-1.332,9,544,1,1,0.51,0.375,0.339,553
dreadfully,-1.332,1,108,1,1,0.246,0.806,0.306,109
ledger,-1.332,1,108,1,1,0.51,0.362,0.609,109
top,-1.335,542,29662,1,1,0.76,0.4,0.554,30204
teen,-1.335,86,4753,1,1,0.729,0.531,0.568,4839
demented,-1.337,3,218,1,1,0.088,0.787,0.309,221
wiz,-1.342,1,109,1,1,0.467,0.545,0.441,110
mistletoe,-1.342,2,164,1,1,0.542,0.47,0.324,166
uninformed,-1.342,1,109,1,1,0.156,0.37,0.182,110
streamer,-1.345,5,330,1,1,0.615,0.53,0.429,335
fool,-1.345,117,6510,1,1,0.16,0.56,0.148,6627
dam,-1.346,17,993,1,1,0.25,0.553,0.394,1010
smut,-1.348,2,165,1,1,0.357,0.36,0.349,167
childless,-1.348,10,608,1,1,0.31,0.4,0.396,618
cause,-1.35,1187,65883,1,1,0.469,0.373,0.486,67070
mistreated,-1.351,5,332,1,1,0.01,0.792,0.2,337
dweeb,-1.351,1,110,1,1,0.354,0.446,0.327,111
hormonal,-1.351,3,221,1,1,0.5,0.62,0.551,224
hugs,-1.352,93,5224,1,1,0.98,0.422,0.6,5317
prostitute,-1.355,3,222,1,1,0.167,0.86,0.427,225
pothole,-1.36,0,55,1,1,0.344,0.294,0.283,55
toot,-1.36,0,55,1,1,0.5,0.481,0.373,55
flattering,-1.36,0,55,1,1,0.755,0.686,0.5,55
bastard,-1.361,34,1962,1,1,0.094,0.692,0.289,1996
dumb,-1.361,154,8693,1,1,0.188,0.33,0.151,8847
wallet,-1.363,9,561,1,1,0.68,0.432,0.5,570
cheat,-1.365,24,1406,1,1,0.125,0.776,0.4,1430
bulletproof,-1.366,2,168,1,1,0.75,0.721,0.779,170
brighten,-1.366,10,619,1,1,0.76,0.547,0.649,629
balding,-1.368,1,112,1,1,0.302,0.363,0.368,113
mop,-1.368,1,112,1,1,0.396,0.442,0.296,113
reek,-1.368,1,112,1,1,0.177,0.48,0.311,113
fudge,-1.368,1,112,1,1,0.853,0.418,0.407,113
spooky,-1.37,15,904,1,1,0.104,0.858,0.38,919
pedestal,-1.37,6,395,1,1,0.735,0.284,0.579,401
stupid,-1.373,236,13456,1,1,0.133,0.51,0.2,13692
sweetie,-1.377,18,1082,1,1,0.99,0.549,0.56,1100
pickup,-1.377,3,227,1,1,0.561,0.529,0.42,230
firework,-1.377,0,56,1,1,0.786,0.904,0.593,56
caller,-1.377,1,113,1,1,0.646,0.615,0.472,114
nursing,-1.378,15,912,1,1,0.552,0.549,0.653,927
curved,-1.381,4,285,1,1,0.542,0.407,0.337,289
teens,-1.383,56,3268,1,1,0.653,0.66,0.44,3324
twitch,-1.385,18,1090,1,1,0.51,0.74,0.548,1108
euro,-1.386,3,229,1,1,0.68,0.441,0.521,232
dehydrated,-1.386,1,114,1,1,0.31,0.685,0.212,115
obese,-1.386,5,344,1,1,0.133,0.427,0.25,349
crying,-1.386,364,20996,1,1,0.153,0.704,0.208,21360
bean,-1.388,24,1439,1,1,0.667,0.269,0.264,1463
candy,-1.388,26,1555,1,1,0.93,0.425,0.384,1581
queer,-1.39,27,1616,1,1,0.286,0.61,0.304,1643
avenue,-1.393,22,1331,1,1,0.677,0.36,0.377,1353
analyst,-1.395,0,57,1,1,0.604,0.415,0.755,57
bomber,-1.395,1,115,1,1,0.125,0.837,0.81,116
robotics,-1.395,0,57,1,1,0.592,0.6,0.763,57
feel,-1.398,7980,464320,1,1,0.802,0.602,0.596,472300
tired,-1.398,818,47675,1,1,0.125,0.317,0.191,48493
vibrator,-1.402,4,291,1,1,0.479,0.798,0.5,295
twat,-1.405,9,585,1,1,0.292,0.459,0.404,594
suicidal,-1.407,48,2876,1,1,0.021,0.867,0.382,2924
pony,-1.41,7,470,1,1,0.812,0.413,0.315,477
postal,-1.412,0,58,1,1,0.765,0.245,0.411,58
verified,-1.412,1,117,1,1,0.781,0.367,0.677,118
midland,-1.412,1,117,1,1,0.521,0.402,0.456,118
douchebags,-1.412,0,58,1,1,0.327,0.587,0.366,58
kitten,-1.412,22,1356,1,1,0.816,0.343,0.26,1378
congressman,-1.412,0,58,1,1,0.438,0.471,0.877,58
unfulfilled,-1.413,10,649,1,1,0.184,0.426,0.268,659
chick,-1.414,25,1536,1,1,0.771,0.602,0.387,1561
hetero,-1.417,2,177,1,1,0.589,0.405,0.435,179
gaga,-1.419,8,534,1,1,0.479,0.396,0.26,542
hook,-1.42,25,1546,1,1,0.418,0.444,0.395,1571
accounts,-1.421,44,2678,1,1,0.592,0.34,0.471,2722
titty,-1.422,4,297,1,1,0.561,0.548,0.294,301
bestfriends,-1.422,7,476,1,1,0.934,0.662,0.647,483
pussy,-1.428,70,4255,1,1,0.323,0.759,0.409,4325
retarded,-1.441,7,485,1,1,0.302,0.462,0.161,492
homesick,-1.443,18,1156,1,1,0.436,0.304,0.347,1174
rawr,-1.445,0,60,1,1,0.457,0.635,0.406,60
chipmunk,-1.445,0,60,1,1,0.573,0.562,0.409,60
hangry,-1.445,0,60,1,1,0.219,0.794,0.279,60
unsupported,-1.453,1,122,1,1,0.26,0.45,0.221,123
volunteer,-1.455,21,1354,1,1,0.888,0.422,0.596,1375
brad,-1.457,3,246,1,1,0.49,0.385,0.402,249
whore,-1.458,22,1420,1,1,0.135,0.88,0.333,1442
cleavage,-1.461,0,61,1,1,0.542,0.602,0.454,61
angry,-1.467,193,12099,1,1,0.122,0.83,0.604,12292
text,-1.468,217,13600,1,1,0.604,0.157,0.402,13817
sock,-1.468,11,748,1,1,0.5,0.167,0.29,759
account,-1.469,160,10061,1,1,0.531,0.347,0.472,10221
bile,-1.469,1,124,1,1,0.157,0.461,0.324,125
seventeen,-1.47,22,1437,1,1,0.585,0.296,0.321,1459
tackle,-1.472,29,1878,1,1,0.365,0.686,0.569,1907
discord,-1.473,46,2946,1,1,0.115,0.882,0.465,2992
fussy,-1.477,0,62,1,1,0.417,0.643,0.519,62
hamburger,-1.477,0,62,1,1,0.809,0.551,0.387,62
shanghai,-1.477,0,62,1,1,0.551,0.45,0.509,62
frisbee,-1.477,0,62,1,1,0.706,0.543,0.364,62
kidney,-1.481,3,252,1,1,0.448,0.363,0.38,255
poor,-1.483,287,18237,1,1,0.156,0.358,0.087,18524
erotica,-1.485,1,126,1,1,0.781,0.87,0.579,127
ballroom,-1.489,3,254,1,1,0.847,0.635,0.448,257
sup,-1.493,3,255,1,1,0.551,0.358,0.385,258
sappy,-1.493,6,447,1,1,0.583,0.469,0.33,453
punctuation,-1.493,0,63,1,1,0.561,0.385,0.592,63
bout,-1.497,159,10278,1,1,0.208,0.808,0.679,10437
grandpa,-1.498,11,771,1,1,0.806,0.296,0.466,782
hotline,-1.502,4,322,1,1,0.592,0.565,0.663,326
atheist,-1.502,4,322,1,1,0.225,0.447,0.377,326
spinster,-1.505,7,517,1,1,0.357,0.368,0.345,524
cam,-1.506,19,1295,1,1,0.448,0.363,0.355,1314
homely,-1.509,2,194,1,1,0.745,0.157,0.399,196
weenie,-1.509,0,64,1,1,0.406,0.451,0.284,64
shutup,-1.516,1,130,1,1,0.333,0.56,0.491,131
reduce,-1.518,26,1771,1,1,0.219,0.304,0.336,1797
complain,-1.521,100,6644,1,1,0.143,0.682,0.36,6744
enlist,-1.524,1,131,1,1,0.51,0.37,0.483,132
dodger,-1.524,0,65,1,1,0.427,0.454,0.49,65
hangout,-1.524,48,3233,1,1,0.573,0.5,0.462,3281
jingle,-1.524,1,131,1,1,0.635,0.5,0.424,132
moron,-1.525,11,792,1,1,0.133,0.587,0.183,803
worthless,-1.529,45,3050,1,1,0.083,0.42,0.153,3095
gaping,-1.529,2,198,1,1,0.408,0.668,0.242,200
stuffing,-1.531,1,132,1,1,0.417,0.324,0.304,133
slide,-1.534,38,2599,1,1,0.615,0.435,0.432,2637
teeny,-1.539,2,200,1,1,0.427,0.418,0.216,202
fucktard,-1.539,0,66,1,1,0.214,0.643,0.364,66
ex,-1.543,103,6994,1,1,0.25,0.52,0.306,7097
flirty,-1.544,2,201,1,1,0.714,0.721,0.491,203
republican,-1.544,11,807,1,1,0.398,0.551,0.664,818
drunk,-1.551,171,11662,1,1,0.194,0.8,0.25,11833
friendless,-1.552,33,2308,1,1,0.102,0.36,0.204,2341
feeling,-1.553,3139,213462,1,1,0.806,0.329,0.531,216601
coalition,-1.554,0,67,1,1,0.49,0.73,0.673,67
crush,-1.559,81,5607,1,1,0.271,0.676,0.582,5688
hateful,-1.56,24,1709,1,1,0.071,0.819,0.43,1733
babe,-1.567,56,3926,1,1,0.86,0.536,0.424,3982
fucker,-1.567,14,1033,1,1,0.094,0.788,0.357,1047
amino,-1.568,0,68,1,1,0.551,0.402,0.433,68
buttercup,-1.568,0,68,1,1,0.562,0.482,0.422,68
nonce,-1.568,1,137,1,1,0.422,0.37,0.377,138
soppy,-1.568,0,68,1,1,0.51,0.355,0.297,68
spoil,-1.571,40,2835,1,1,0.146,0.723,0.328,2875
stfu,-1.571,24,1729,1,1,0.292,0.5,0.39,1753
untrue,-1.574,9,693,1,1,0.031,0.5,0.188,702
funding,-1.577,7,556,1,1,0.729,0.48,0.827,563
skinny,-1.583,11,839,1,1,0.333,0.333,0.298,850
guinea,-1.583,7,559,1,1,0.521,0.44,0.396,566
desperate,-1.587,193,13635,1,1,0.083,0.842,0.337,13828
slut,-1.589,11,844,1,1,0.071,0.808,0.309,855
broke,-1.595,249,17716,1,1,0.245,0.59,0.37,17965
beta,-1.595,9,708,1,1,0.71,0.37,0.439,717
homeless,-1.596,40,2906,1,1,0.042,0.45,0.188,2946
hearts,-1.598,279,19898,1,1,0.948,0.592,0.634,20177
sucks,-1.6,268,19159,1,1,0.115,0.683,0.302,19427
afflicted,-1.6,3,284,1,1,0.271,0.5,0.167,287
flirt,-1.608,20,1507,1,1,0.792,0.79,0.538,1527
mommy,-1.608,22,1651,1,1,0.854,0.353,0.422,1673
fig,-1.611,0,71,1,1,0.573,0.39,0.339,71
slime,-1.611,2,215,1,1,0.3,0.37,0.183,217
catfish,-1.613,5,432,1,1,0.458,0.337,0.296,437
prick,-1.614,9,721,1,1,0.323,0.764,0.269,730
sack,-1.615,9,722,1,1,0.385,0.337,0.264,731
puppy,-1.616,46,3401,1,1,0.908,0.461,0.324,3447
satellite,-1.619,4,362,1,1,0.562,0.409,0.764,366
smooch,-1.62,2,217,1,1,0.796,0.731,0.491,219
hustler,-1.625,0,72,1,1,0.26,0.821,0.627,72
hug,-1.627,187,13752,1,1,0.908,0.427,0.548,13939
kris,-1.627,4,365,1,1,0.427,0.417,0.407,369
volunteers,-1.633,10,809,1,1,0.82,0.448,0.63,819
fag,-1.634,2,220,1,1,0.122,0.653,0.331,222
cuff,-1.635,7,589,1,1,0.469,0.453,0.387,596
revolver,-1.638,3,295,1,1,0.194,0.796,0.75,298
dyke,-1.638,2,221,1,1,0.438,0.396,0.566,223
hag,-1.644,8,669,1,1,0.188,0.695,0.411,677
weekly,-1.649,46,3515,1,1,0.622,0.288,0.38,3561
rocker,-1.652,0,74,1,1,0.615,0.704,0.625,74
mansions,-1.652,0,74,1,1,0.735,0.529,0.777,74
wingman,-1.652,0,74,1,1,0.573,0.578,0.582,74
crippling,-1.652,64,4877,1,1,0.156,0.598,0.391,4941
ghetto,-1.655,3,300,1,1,0.302,0.63,0.482,303
club,-1.656,246,18600,1,1,0.646,0.618,0.393,18846
twats,-1.658,1,150,1,1,0.406,0.588,0.383,151
chump,-1.665,0,75,1,1,0.375,0.451,0.304,75
dashboard,-1.665,1,151,1,1,0.51,0.371,0.595,152
shifty,-1.665,1,151,1,1,0.365,0.687,0.483,152
raffle,-1.665,0,75,1,1,0.64,0.51,0.454,75
sandman,-1.665,2,227,1,1,0.479,0.469,0.388,229
premature,-1.665,1,151,1,1,0.281,0.416,0.277,152
begging,-1.668,46,3583,1,1,0.292,0.461,0.202,3629
thirsty,-1.668,22,1753,1,1,0.281,0.66,0.31,1775
muffin,-1.672,1,152,1,1,0.684,0.43,0.306,153
inadmissible,-1.672,1,152,1,1,0.188,0.636,0.389,153
foreigner,-1.672,1,152,1,1,0.5,0.519,0.48,153
trainee,-1.674,2,229,1,1,0.627,0.408,0.352,231
unhappy,-1.676,77,5995,1,1,0.112,0.5,0.155,6072
reprise,-1.678,1,153,1,1,0.459,0.5,0.464,154
shittest,-1.678,0,76,1,1,0.076,0.673,0.232,76
killing,-1.685,171,13338,1,1,0.08,0.959,0.696,13509
bigot,-1.694,3,312,1,1,0.479,0.745,0.517,315
goblin,-1.696,13,1096,1,1,0.333,0.542,0.377,1109
lodge,-1.696,39,3134,1,1,0.656,0.356,0.474,3173
cuddling,-1.698,25,2042,1,1,0.917,0.562,0.433,2067
gal,-1.7,16,1337,1,1,0.5,0.469,0.337,1353
needy,-1.702,49,3943,1,1,0.36,0.451,0.245,3992
bravado,-1.704,0,78,1,1,0.479,0.51,0.527,78
minister,-1.709,23,1906,1,1,0.547,0.441,0.892,1929
wanker,-1.712,2,238,1,1,0.29,0.569,0.446,240
divorcee,-1.716,0,79,1,1,0.153,0.61,0.481,79
snitch,-1.716,1,159,1,1,0.3,0.598,0.333,160
girl,-1.72,903,72573,1,1,0.74,0.572,0.443,73476
turd,-1.722,3,321,1,1,0.24,0.519,0.383,324
band,-1.727,135,10997,1,1,0.648,0.552,0.525,11132
chubby,-1.732,3,324,1,1,0.531,0.427,0.304,327
fee,-1.733,5,487,1,1,0.354,0.386,0.556,492
honeymoon,-1.734,13,1139,1,1,0.979,0.678,0.526,1152
guidebook,-1.741,0,81,1,1,0.677,0.26,0.427,81
spelling,-1.741,2,245,1,1,0.594,0.357,0.398,247
cock,-1.742,18,1559,1,1,0.418,0.562,0.392,1577
miserable,-1.744,201,16615,1,1,0.062,0.461,0.188,16816
dough,-1.747,1,164,1,1,0.588,0.229,0.391,165
ugly,-1.752,152,12679,1,1,0.167,0.63,0.254,12831
furrow,-1.759,3,333,1,1,0.408,0.42,0.345,336
parliament,-1.759,3,333,1,1,0.573,0.54,0.858,336
notification,-1.761,8,752,1,1,0.604,0.461,0.671,760
helpless,-1.762,30,2595,1,1,0.104,0.42,0.214,2625
fundraising,-1.765,0,83,1,1,0.76,0.62,0.544,83
promiscuous,-1.765,0,83,1,1,0.214,0.8,0.436,83
cleanliness,-1.768,6,589,1,1,0.816,0.363,0.609,595
cunt,-1.77,22,1941,1,1,0.135,0.673,0.377,1963
thigh,-1.771,1,168,1,1,0.469,0.433,0.588,169
unemployed,-1.777,8,764,1,1,0.094,0.481,0.23,772
insulting,-1.779,4,425,1,1,0.094,0.84,0.412,429
volunteering,-1.782,6,597,1,1,0.844,0.614,0.603,603
drake,-1.783,18,1624,1,1,0.467,0.411,0.452,1642
cute,-1.79,217,18778,1,1,0.92,0.528,0.579,18995
horribly,-1.801,8,783,1,1,0.05,0.631,0.454,791
insecure,-1.802,49,4355,1,1,0.114,0.538,0.132,4404
xoxo,-1.809,18,1666,1,1,0.729,0.52,0.4,1684
auntie,-1.809,3,350,1,1,0.643,0.275,0.447,353
dementia,-1.811,10,966,1,1,0.092,0.779,0.337,976
lollipop,-1.812,0,87,1,1,0.628,0.483,0.357,87
ass,-1.812,766,67535,1,1,0.323,0.75,0.345,68301
sparrow,-1.813,10,968,1,1,0.583,0.46,0.327,978
sux,-1.823,2,266,1,1,0.406,0.531,0.331,268
accessory,-1.823,0,88,1,1,0.562,0.292,0.445,88
housewife,-1.834,7,719,1,1,0.656,0.361,0.449,726
boa,-1.84,1,180,1,1,0.255,0.569,0.542,181
amnesty,-1.845,0,90,1,1,0.551,0.451,0.814,90
greedy,-1.847,25,2370,1,1,0.125,0.66,0.476,2395
pregnant,-1.85,23,2193,1,1,0.765,0.773,0.537,2216
chat,-1.856,131,12143,1,1,0.729,0.4,0.346,12274
dot,-1.857,15,1473,1,1,0.434,0.29,0.391,1488
thankless,-1.861,1,184,1,1,0.146,0.5,0.497,185
heartbroken,-1.863,26,2501,1,1,0.082,0.551,0.235,2527
codeine,-1.867,0,92,1,1,0.375,0.582,0.436,92
widower,-1.872,3,373,1,1,0.184,0.406,0.325,376
fat,-1.873,78,7388,1,1,0.198,0.353,0.237,7466
boo,-1.873,72,6828,1,1,0.153,0.676,0.309,6900
boy,-1.875,418,39287,1,1,0.646,0.392,0.445,39705
raisin,-1.888,0,94,1,1,0.594,0.235,0.246,94
wrecker,-1.888,1,189,1,1,0.229,0.716,0.474,190
enforcement,-1.888,0,94,1,1,0.594,0.571,0.736,94
heartbreaker,-1.893,1,190,1,1,0.265,0.685,0.58,191
potato,-1.895,22,2199,1,1,0.541,0.235,0.265,2221
cuddled,-1.895,9,956,1,1,0.906,0.547,0.567,965
hooker,-1.899,1,191,1,1,0.214,0.889,0.373,192
matchmaker,-1.899,0,95,1,1,0.615,0.509,0.519,95
giggles,-1.899,2,287,1,1,0.865,0.684,0.346,289
toad,-1.919,1,195,1,1,0.302,0.452,0.196,196
gay,-1.922,149,14742,1,1,0.388,0.587,0.429,14891
stalker,-1.923,7,786,1,1,0.177,0.93,0.639,793
toy,-1.924,16,1673,1,1,0.878,0.42,0.275,1689
overweight,-1.934,3,397,1,1,0.052,0.5,0.389,400
underage,-1.934,1,198,1,1,0.469,0.461,0.3,199
flirting,-1.935,13,1393,1,1,0.59,0.773,0.491,1406
stallion,-1.939,0,99,1,1,0.628,0.596,0.779,99
prom,-1.946,10,1106,1,1,0.527,0.44,0.404,1116
hippo,-1.949,0,100,1,1,0.49,0.404,0.477,100
sorority,-1.949,0,100,1,1,0.635,0.637,0.627,100
swipe,-1.951,4,505,1,1,0.573,0.45,0.266,509
pedophile,-1.954,1,202,1,1,0.051,0.724,0.43,203
hoe,-1.956,47,4877,1,1,0.302,0.48,0.418,4924
fronting,-1.959,1,203,1,1,0.5,0.48,0.509,204
tit,-1.969,2,308,1,1,0.402,0.539,0.388,310
squirt,-1.969,1,205,1,1,0.406,0.46,0.255,206
mummy,-1.969,3,411,1,1,0.4,0.588,0.415,414
businessman,-1.969,0,102,1,1,0.653,0.51,0.802,102
bisexual,-1.974,8,931,1,1,0.438,0.765,0.459,939
cuddles,-1.976,31,3317,1,1,0.847,0.382,0.5,3348
bop,-1.979,14,1559,1,1,0.429,0.49,0.426,1573
foxy,-1.988,0,104,1,1,0.552,0.642,0.679,104
lipstick,-1.991,3,420,1,1,0.653,0.429,0.306,423
daddy,-1.993,48,5167,1,1,0.795,0.4,0.736,5215
karaoke,-2.003,4,532,1,1,0.763,0.649,0.342,536
toby,-2.007,1,213,1,1,0.427,0.375,0.33,214
owner,-2.007,42,4600,1,1,0.776,0.449,0.92,4642
twit,-2.007,2,320,1,1,0.194,0.653,0.198,322
scared,-2.01,370,39819,1,1,0.146,0.828,0.185,40189
woo,-2.029,11,1311,1,1,0.646,0.729,0.43,1322
confess,-2.033,29,3292,1,1,0.36,0.712,0.431,3321
bitch,-2.036,446,49224,1,1,0.276,0.74,0.343,49670
crybaby,-2.038,2,330,1,1,0.375,0.702,0.311,332
hungry,-2.039,91,10165,1,1,0.083,0.69,0.254,10256
bing,-2.044,0,110,1,1,0.573,0.453,0.415,110
tissue,-2.05,2,334,1,1,0.558,0.236,0.345,336
whale,-2.051,41,4694,1,1,0.582,0.398,0.509,4735
petunia,-2.053,0,111,1,1,0.583,0.26,0.356,111
evermore,-2.053,0,111,1,1,0.677,0.45,0.403,111
tuna,-2.053,0,111,1,1,0.531,0.386,0.304,111
breakable,-2.062,0,112,1,1,0.194,0.667,0.408,112
penniless,-2.062,0,112,1,1,0.062,0.316,0.083,112
striker,-2.079,0,114,1,1,0.5,0.589,0.696,114
momma,-2.083,19,2307,1,1,0.833,0.412,0.527,2326
infertility,-2.088,0,115,1,1,0.17,0.664,0.328,115
valentine,-2.092,83,9787,1,1,0.888,0.615,0.51,9870
pathetic,-2.095,99,11682,1,1,0.088,0.464,0.139,11781
carat,-2.096,1,233,1,1,0.823,0.604,0.676,234
pantyhose,-2.105,0,117,1,1,0.57,0.539,0.25,117
puss,-2.105,0,117,1,1,0.306,0.582,0.236,117
voicemail,-2.105,0,117,1,1,0.458,0.453,0.406,117
doggy,-2.113,1,237,1,1,0.646,0.491,0.404,238
supermodel,-2.13,0,120,1,1,0.88,0.663,0.698,120
gullible,-2.133,2,363,1,1,0.44,0.442,0.318,365
dildo,-2.134,3,485,1,1,0.536,0.587,0.491,488
playmate,-2.171,0,125,1,1,0.878,0.509,0.398,125
hardcore,-2.185,15,2045,1,1,0.25,0.721,0.585,2060
loser,-2.186,57,7418,1,1,0.083,0.51,0.155,7475
hertz,-2.194,0,128,1,1,0.396,0.417,0.506,128
troll,-2.2,27,3633,1,1,0.378,0.627,0.327,3660
epidemic,-2.201,13,1817,1,1,0.092,0.83,0.611,1830
porno,-2.201,15,2078,1,1,0.302,0.923,0.519,2093
girlfriend,-2.206,90,11880,1,1,0.712,0.763,0.604,11970
phony,-2.214,7,1052,1,1,0.115,0.592,0.202,1059
depressed,-2.214,284,37516,1,1,0.024,0.445,0.136,37800
ringer,-2.225,0,132,1,1,0.573,0.604,0.347,132
faggot,-2.254,1,273,1,1,0.219,0.643,0.292,274
uneducated,-2.259,2,412,1,1,0.177,0.35,0.246,414
brokenhearted,-2.261,2,413,1,1,0.13,0.598,0.227,415
supernova,-2.261,0,137,1,1,0.729,0.673,0.827,137
lesbian,-2.271,38,5431,1,1,0.385,0.66,0.415,5469
mister,-2.272,9,1393,1,1,0.604,0.406,0.663,1402
adverts,-2.29,0,141,1,1,0.551,0.5,0.595,141
stockings,-2.297,0,142,1,1,0.458,0.365,0.382,142
superstar,-2.318,1,291,1,1,0.885,0.86,0.88,292
boyfriend,-2.327,125,18564,1,1,0.781,0.604,0.547,18689
elderly,-2.329,30,4577,1,1,0.615,0.212,0.283,4607
hookup,-2.338,2,446,1,1,0.625,0.529,0.683,448
sad,-2.35,1386,209131,1,1,0.225,0.333,0.149,210517
spam,-2.365,6,1070,1,1,0.188,0.354,0.304,1076
swinger,-2.371,0,153,1,1,0.459,0.778,0.482,153
depress,-2.381,3,621,1,1,0.219,0.635,0.528,624
bored,-2.384,339,53039,1,1,0.153,0.167,0.196,53378
baby,-2.413,403,64893,1,1,0.837,0.365,0.455,65296
growl,-2.423,4,810,1,1,0.194,0.764,0.482,814
tackling,-2.426,7,1301,1,1,0.48,0.694,0.613,1308
drummer,-2.434,0,163,1,1,0.646,0.7,0.564,163
lefty,-2.434,0,163,1,1,0.49,0.406,0.379,163
cuddle,-2.486,57,10016,1,1,0.885,0.559,0.475,10073
contentious,-2.491,2,520,1,1,0.422,0.573,0.637,522
turnaround,-2.493,0,173,1,1,0.56,0.654,0.407,173
obesity,-2.529,3,720,1,1,0.215,0.37,0.328,723
sugar,-2.539,37,6921,1,1,0.896,0.382,0.402,6958
sweetener,-2.545,3,732,1,1,0.67,0.333,0.33,735
thug,-2.549,8,1655,1,1,0.24,0.882,0.667,1663
flop,-2.574,4,942,1,1,0.081,0.642,0.196,946
pepper,-2.682,20,4411,1,1,0.4,0.539,0.328,4431
pretender,-2.71,0,215,1,1,0.5,0.683,0.574,215
kidnap,-2.719,0,217,1,1,0.032,0.923,0.535,217
nigger,-2.721,4,1091,1,1,0.24,0.347,0.398,1095
sergeant,-2.728,3,879,1,1,0.408,0.6,0.833,882
pentagon,-2.86,0,250,1,1,0.49,0.636,0.774,250
incidental,-2.92,1,532,1,1,0.281,0.61,0.404,533
unauthorized,-3.087,0,314,1,1,0.26,0.448,0.259,314
tun,-3.154,0,336,1,1,0.386,0.413,0.364,336
horny,-3.236,39,14621,1,1,0.49,0.908,0.56,14660
allowance,-3.257,7,2988,1,1,0.673,0.382,0.591,2995
abracadabra,-3.504,0,477,1,1,0.673,0.632,0.434,477
